my,geoid,br_2020,se_traf,pt_traf,total_traf,borough,shape_area,nta_nam
19-May,36061000100,1000100,8006,108079,116085,Manhattan,1843004.522,The Battery-Governors Island-Ellis Island-Liberty Island
21-May,36061000100,1000100,11585,18824,30409,Manhattan,1843004.522,The Battery-Governors Island-Ellis Island-Liberty Island
19-Jun,36061000100,1000100,1117,29497,30614,Manhattan,1843004.522,The Battery-Governors Island-Ellis Island-Liberty Island
21-Jun,36061000100,1000100,6443,103367,109810,Manhattan,1843004.522,The Battery-Governors Island-Ellis Island-Liberty Island
19-Jul,36061000100,1000100,0,71,71,Manhattan,1843004.522,The Battery-Governors Island-Ellis Island-Liberty Island
21-Jul,36061000100,1000100,11437,79202,90639,Manhattan,1843004.522,The Battery-Governors Island-Ellis Island-Liberty Island
19-Aug,36061000100,1000100,7418,134700,142118,Manhattan,1843004.522,The Battery-Governors Island-Ellis Island-Liberty Island
21-Aug,36061000100,1000100,10118,53982,64100,Manhattan,1843004.522,The Battery-Governors Island-Ellis Island-Liberty Island
19-May,36061000201,1000201,2944,93919,96863,Manhattan,972312.1404,Chinatown-Two Bridges
21-May,36061000201,1000201,5187,51242,56429,Manhattan,972312.1404,Chinatown-Two Bridges
19-Jun,36061000201,1000201,13699,107221,120920,Manhattan,972312.1404,Chinatown-Two Bridges
21-Jun,36061000201,1000201,8139,29183,37322,Manhattan,972312.1404,Chinatown-Two Bridges
19-Jul,36061000201,1000201,11402,27491,38893,Manhattan,972312.1404,Chinatown-Two Bridges
21-Jul,36061000201,1000201,6218,86141,92359,Manhattan,972312.1404,Chinatown-Two Bridges
19-Aug,36061000201,1000201,13579,119219,132798,Manhattan,972312.1404,Chinatown-Two Bridges
21-Aug,36061000201,1000201,764,47742,48506,Manhattan,972312.1404,Chinatown-Two Bridges
19-May,36061000600,1000600,5980,78510,84490,Manhattan,2582705.157,Chinatown-Two Bridges
21-May,36061000600,1000600,7360,73061,80421,Manhattan,2582705.157,Chinatown-Two Bridges
19-Jun,36061000600,1000600,11104,54466,65570,Manhattan,2582705.157,Chinatown-Two Bridges
21-Jun,36061000600,1000600,8273,57703,65976,Manhattan,2582705.157,Chinatown-Two Bridges
19-Jul,36061000600,1000600,6828,60606,67434,Manhattan,2582705.157,Chinatown-Two Bridges
21-Jul,36061000600,1000600,9170,154046,163216,Manhattan,2582705.157,Chinatown-Two Bridges
19-Aug,36061000600,1000600,14452,87893,102345,Manhattan,2582705.157,Chinatown-Two Bridges
21-Aug,36061000600,1000600,5064,108758,113822,Manhattan,2582705.157,Chinatown-Two Bridges
19-May,36061001401,1001401,12745,46280,59025,Manhattan,1006116.584,Lower East Side
21-May,36061001401,1001401,14398,83177,97575,Manhattan,1006116.584,Lower East Side
19-Jun,36061001401,1001401,6738,100126,106864,Manhattan,1006116.584,Lower East Side
21-Jun,36061001401,1001401,14872,82775,97647,Manhattan,1006116.584,Lower East Side
19-Jul,36061001401,1001401,11063,72597,83660,Manhattan,1006116.584,Lower East Side
21-Jul,36061001401,1001401,0,56198,56198,Manhattan,1006116.584,Lower East Side
19-Aug,36061001401,1001401,1519,31834,33353,Manhattan,1006116.584,Lower East Side
21-Aug,36061001401,1001401,5970,32510,38480,Manhattan,1006116.584,Lower East Side
19-May,36061001402,1001402,7538,35622,43160,Manhattan,1226206.247,Lower East Side
21-May,36061001402,1001402,11463,23663,35126,Manhattan,1226206.247,Lower East Side
19-Jun,36061001402,1001402,11011,85341,96352,Manhattan,1226206.247,Lower East Side
21-Jun,36061001402,1001402,2324,78845,81169,Manhattan,1226206.247,Lower East Side
19-Jul,36061001402,1001402,5752,34887,40639,Manhattan,1226206.247,Lower East Side
21-Jul,36061001402,1001402,11023,70827,81850,Manhattan,1226206.247,Lower East Side
19-Aug,36061001402,1001402,6881,71,6952,Manhattan,1226206.247,Lower East Side
21-Aug,36061001402,1001402,9210,128538,137748,Manhattan,1226206.247,Lower East Side
19-May,36061001800,1001800,8929,99074,108003,Manhattan,2399276.864,Lower East Side
21-May,36061001800,1001800,9624,80973,90597,Manhattan,2399276.864,Lower East Side
19-Jun,36061001800,1001800,12283,11994,24277,Manhattan,2399276.864,Lower East Side
21-Jun,36061001800,1001800,7503,24452,31955,Manhattan,2399276.864,Lower East Side
19-Jul,36061001800,1001800,11559,106659,118218,Manhattan,2399276.864,Lower East Side
21-Jul,36061001800,1001800,6992,81097,88089,Manhattan,2399276.864,Lower East Side
19-Aug,36061001800,1001800,13510,64959,78469,Manhattan,2399276.864,Lower East Side
21-Aug,36061001800,1001800,11036,18662,29698,Manhattan,2399276.864,Lower East Side
19-May,36061002201,1002201,14112,58782,72894,Manhattan,1740173.876,Lower East Side
21-May,36061002201,1002201,13129,126093,139222,Manhattan,1740173.876,Lower East Side
19-Jun,36061002201,1002201,5263,60271,65534,Manhattan,1740173.876,Lower East Side
21-Jun,36061002201,1002201,7185,66232,73417,Manhattan,1740173.876,Lower East Side
19-Jul,36061002201,1002201,15395,34811,50206,Manhattan,1740173.876,Lower East Side
21-Jul,36061002201,1002201,8054,75614,83668,Manhattan,1740173.876,Lower East Side
19-Aug,36061002201,1002201,10709,103159,113868,Manhattan,1740173.876,Lower East Side
21-Aug,36061002201,1002201,11817,63032,74849,Manhattan,1740173.876,Lower East Side
19-May,36061002601,1002601,0,149430,149430,Manhattan,1141217.527,East Village
21-May,36061002601,1002601,8622,95838,104460,Manhattan,1141217.527,East Village
19-Jun,36061002601,1002601,11939,61866,73805,Manhattan,1141217.527,East Village
21-Jun,36061002601,1002601,0,43939,43939,Manhattan,1141217.527,East Village
19-Jul,36061002601,1002601,2210,80694,82904,Manhattan,1141217.527,East Village
21-Jul,36061002601,1002601,7331,135245,142576,Manhattan,1141217.527,East Village
19-Aug,36061002601,1002601,6661,78411,85072,Manhattan,1141217.527,East Village
21-Aug,36061002601,1002601,6518,29181,35699,Manhattan,1141217.527,East Village
19-May,36061002602,1002602,12152,45222,57374,Manhattan,1114857.118,East Village
21-May,36061002602,1002602,8001,43948,51949,Manhattan,1114857.118,East Village
19-Jun,36061002602,1002602,1833,66386,68219,Manhattan,1114857.118,East Village
21-Jun,36061002602,1002602,10367,39169,49536,Manhattan,1114857.118,East Village
19-Jul,36061002602,1002602,11804,39377,51181,Manhattan,1114857.118,East Village
21-Jul,36061002602,1002602,6780,42336,49116,Manhattan,1114857.118,East Village
19-Aug,36061002602,1002602,14308,52023,66331,Manhattan,1114857.118,East Village
21-Aug,36061002602,1002602,14868,53343,68211,Manhattan,1114857.118,East Village
19-May,36061002800,1002800,9053,137586,146639,Manhattan,1973678.468,East Village
21-May,36061002800,1002800,8281,71368,79649,Manhattan,1973678.468,East Village
19-Jun,36061002800,1002800,13204,61406,74610,Manhattan,1973678.468,East Village
21-Jun,36061002800,1002800,10033,62761,72794,Manhattan,1973678.468,East Village
19-Jul,36061002800,1002800,14385,62237,76622,Manhattan,1973678.468,East Village
21-Jul,36061002800,1002800,5360,46715,52075,Manhattan,1973678.468,East Village
19-Aug,36061002800,1002800,5191,71,5262,Manhattan,1973678.468,East Village
21-Aug,36061002800,1002800,2765,33767,36532,Manhattan,1973678.468,East Village
19-May,36061003100,1003100,3475,84269,87744,Manhattan,2207015.175,Tribeca-Civic Center
21-May,36061003100,1003100,12789,82436,95225,Manhattan,2207015.175,Tribeca-Civic Center
19-Jun,36061003100,1003100,11796,37328,49124,Manhattan,2207015.175,Tribeca-Civic Center
21-Jun,36061003100,1003100,7504,57807,65311,Manhattan,2207015.175,Tribeca-Civic Center
19-Jul,36061003100,1003100,0,14845,14845,Manhattan,2207015.175,Tribeca-Civic Center
21-Jul,36061003100,1003100,4388,83059,87447,Manhattan,2207015.175,Tribeca-Civic Center
19-Aug,36061003100,1003100,5342,50915,56257,Manhattan,2207015.175,Tribeca-Civic Center
21-Aug,36061003100,1003100,0,43783,43783,Manhattan,2207015.175,Tribeca-Civic Center
19-May,36061003200,1003200,13513,41862,55375,Manhattan,2335526.622,East Village
21-May,36061003200,1003200,5487,100367,105854,Manhattan,2335526.622,East Village
19-Jun,36061003200,1003200,9141,13857,22998,Manhattan,2335526.622,East Village
21-Jun,36061003200,1003200,6923,97642,104565,Manhattan,2335526.622,East Village
19-Jul,36061003200,1003200,15431,37513,52944,Manhattan,2335526.622,East Village
21-Jul,36061003200,1003200,12929,63683,76612,Manhattan,2335526.622,East Village
19-Aug,36061003200,1003200,7550,3554,11104,Manhattan,2335526.622,East Village
21-Aug,36061003200,1003200,9362,43786,53148,Manhattan,2335526.622,East Village
19-May,36061003300,1003300,11665,76947,88612,Manhattan,3677727.618,Tribeca-Civic Center
21-May,36061003300,1003300,79,134289,134368,Manhattan,3677727.618,Tribeca-Civic Center
19-Jun,36061003300,1003300,7443,69215,76658,Manhattan,3677727.618,Tribeca-Civic Center
21-Jun,36061003300,1003300,14510,9919,24429,Manhattan,3677727.618,Tribeca-Civic Center
19-Jul,36061003300,1003300,10801,57738,68539,Manhattan,3677727.618,Tribeca-Civic Center
21-Jul,36061003300,1003300,249,65191,65440,Manhattan,3677727.618,Tribeca-Civic Center
19-Aug,36061003300,1003300,10002,71,10073,Manhattan,3677727.618,Tribeca-Civic Center
21-Aug,36061003300,1003300,4084,76231,80315,Manhattan,3677727.618,Tribeca-Civic Center
19-May,36061003400,1003400,8810,91667,100477,Manhattan,1718451.586,East Village
21-May,36061003400,1003400,11710,157674,169384,Manhattan,1718451.586,East Village
19-Jun,36061003400,1003400,10978,144954,155932,Manhattan,1718451.586,East Village
21-Jun,36061003400,1003400,9699,46637,56336,Manhattan,1718451.586,East Village
19-Jul,36061003400,1003400,9707,81265,90972,Manhattan,1718451.586,East Village
21-Jul,36061003400,1003400,0,85818,85818,Manhattan,1718451.586,East Village
19-Aug,36061003400,1003400,3309,55949,59258,Manhattan,1718451.586,East Village
21-Aug,36061003400,1003400,3208,22133,25341,Manhattan,1718451.586,East Village
19-May,36061003601,1003601,12352,73801,86153,Manhattan,1082296.166,Lower East Side
21-May,36061003601,1003601,6656,93071,99727,Manhattan,1082296.166,Lower East Side
19-Jun,36061003601,1003601,7743,123408,131151,Manhattan,1082296.166,Lower East Side
21-Jun,36061003601,1003601,8536,113399,121935,Manhattan,1082296.166,Lower East Side
19-Jul,36061003601,1003601,18644,31033,49677,Manhattan,1082296.166,Lower East Side
21-Jul,36061003601,1003601,2921,71,2992,Manhattan,1082296.166,Lower East Side
19-Aug,36061003601,1003601,6136,71,6207,Manhattan,1082296.166,Lower East Side
21-Aug,36061003601,1003601,14726,140994,155720,Manhattan,1082296.166,Lower East Side
19-May,36061003602,1003602,9325,83784,93109,Manhattan,961070.5001,East Village
21-May,36061003602,1003602,18747,87818,106565,Manhattan,961070.5001,East Village
19-Jun,36061003602,1003602,12586,81952,94538,Manhattan,961070.5001,East Village
21-Jun,36061003602,1003602,8047,78221,86268,Manhattan,961070.5001,East Village
19-Jul,36061003602,1003602,15247,123961,139208,Manhattan,961070.5001,East Village
21-Jul,36061003602,1003602,0,137724,137724,Manhattan,961070.5001,East Village
19-Aug,36061003602,1003602,11870,40496,52366,Manhattan,961070.5001,East Village
21-Aug,36061003602,1003602,5024,89125,94149,Manhattan,961070.5001,East Village
19-May,36061003700,1003700,9346,126148,135494,Manhattan,4116364.297,SoHo-Little Italy-Hudson Square
21-May,36061003700,1003700,13011,88388,101399,Manhattan,4116364.297,SoHo-Little Italy-Hudson Square
19-Jun,36061003700,1003700,18574,168230,186804,Manhattan,4116364.297,SoHo-Little Italy-Hudson Square
21-Jun,36061003700,1003700,9361,3161,12522,Manhattan,4116364.297,SoHo-Little Italy-Hudson Square
19-Jul,36061003700,1003700,13623,62988,76611,Manhattan,4116364.297,SoHo-Little Italy-Hudson Square
21-Jul,36061003700,1003700,11542,101459,113001,Manhattan,4116364.297,SoHo-Little Italy-Hudson Square
19-Aug,36061003700,1003700,15667,62028,77695,Manhattan,4116364.297,SoHo-Little Italy-Hudson Square
21-Aug,36061003700,1003700,9262,30636,39898,Manhattan,4116364.297,SoHo-Little Italy-Hudson Square
19-May,36061003900,1003900,2703,100322,103025,Manhattan,3571006.257,Tribeca-Civic Center
21-May,36061003900,1003900,7206,46835,54041,Manhattan,3571006.257,Tribeca-Civic Center
19-Jun,36061003900,1003900,2840,73819,76659,Manhattan,3571006.257,Tribeca-Civic Center
21-Jun,36061003900,1003900,10177,139262,149439,Manhattan,3571006.257,Tribeca-Civic Center
19-Jul,36061003900,1003900,0,99114,99114,Manhattan,3571006.257,Tribeca-Civic Center
21-Jul,36061003900,1003900,10393,109662,120055,Manhattan,3571006.257,Tribeca-Civic Center
19-Aug,36061003900,1003900,8912,65176,74088,Manhattan,3571006.257,Tribeca-Civic Center
21-Aug,36061003900,1003900,8673,71,8744,Manhattan,3571006.257,Tribeca-Civic Center
19-May,36061004001,1004001,13864,11767,25631,Manhattan,995026.1373,East Village
21-May,36061004001,1004001,10725,71,10796,Manhattan,995026.1373,East Village
19-Jun,36061004001,1004001,9074,86147,95221,Manhattan,995026.1373,East Village
21-Jun,36061004001,1004001,11830,66679,78509,Manhattan,995026.1373,East Village
19-Jul,36061004001,1004001,8852,59120,67972,Manhattan,995026.1373,East Village
21-Jul,36061004001,1004001,16316,57118,73434,Manhattan,995026.1373,East Village
19-Aug,36061004001,1004001,7111,43373,50484,Manhattan,995026.1373,East Village
21-Aug,36061004001,1004001,0,115277,115277,Manhattan,995026.1373,East Village
19-May,36061004002,1004002,12260,107986,120246,Manhattan,932610.9862,East Village
21-May,36061004002,1004002,5068,107244,112312,Manhattan,932610.9862,East Village
19-Jun,36061004002,1004002,11095,102334,113429,Manhattan,932610.9862,East Village
21-Jun,36061004002,1004002,14202,41285,55487,Manhattan,932610.9862,East Village
19-Jul,36061004002,1004002,8373,102327,110700,Manhattan,932610.9862,East Village
21-Jul,36061004002,1004002,9892,57586,67478,Manhattan,932610.9862,East Village
19-Aug,36061004002,1004002,6078,27901,33979,Manhattan,932610.9862,East Village
21-Aug,36061004002,1004002,10031,71,10102,Manhattan,932610.9862,East Village
19-May,36061004100,1004100,12227,104538,116765,Manhattan,2058611.777,SoHo-Little Italy-Hudson Square
21-May,36061004100,1004100,11454,86429,97883,Manhattan,2058611.777,SoHo-Little Italy-Hudson Square
19-Jun,36061004100,1004100,16424,39040,55464,Manhattan,2058611.777,SoHo-Little Italy-Hudson Square
21-Jun,36061004100,1004100,4208,57770,61978,Manhattan,2058611.777,SoHo-Little Italy-Hudson Square
19-Jul,36061004100,1004100,10950,30325,41275,Manhattan,2058611.777,SoHo-Little Italy-Hudson Square
21-Jul,36061004100,1004100,0,118105,118105,Manhattan,2058611.777,SoHo-Little Italy-Hudson Square
19-Aug,36061004100,1004100,14178,5427,19605,Manhattan,2058611.777,SoHo-Little Italy-Hudson Square
21-Aug,36061004100,1004100,11805,77566,89371,Manhattan,2058611.777,SoHo-Little Italy-Hudson Square
19-May,36061004300,1004300,5567,93142,98709,Manhattan,1605585.008,SoHo-Little Italy-Hudson Square
21-May,36061004300,1004300,9444,80771,90215,Manhattan,1605585.008,SoHo-Little Italy-Hudson Square
19-Jun,36061004300,1004300,11389,93407,104796,Manhattan,1605585.008,SoHo-Little Italy-Hudson Square
21-Jun,36061004300,1004300,17497,18810,36307,Manhattan,1605585.008,SoHo-Little Italy-Hudson Square
19-Jul,36061004300,1004300,20120,100964,121084,Manhattan,1605585.008,SoHo-Little Italy-Hudson Square
21-Jul,36061004300,1004300,10693,76357,87050,Manhattan,1605585.008,SoHo-Little Italy-Hudson Square
19-Aug,36061004300,1004300,7876,130632,138508,Manhattan,1605585.008,SoHo-Little Italy-Hudson Square
21-Aug,36061004300,1004300,5208,39378,44586,Manhattan,1605585.008,SoHo-Little Italy-Hudson Square
19-May,36061004500,1004500,3385,70088,73473,Manhattan,1129524.355,SoHo-Little Italy-Hudson Square
21-May,36061004500,1004500,1894,69675,71569,Manhattan,1129524.355,SoHo-Little Italy-Hudson Square
19-Jun,36061004500,1004500,15566,56724,72290,Manhattan,1129524.355,SoHo-Little Italy-Hudson Square
21-Jun,36061004500,1004500,5636,3457,9093,Manhattan,1129524.355,SoHo-Little Italy-Hudson Square
19-Jul,36061004500,1004500,13486,59906,73392,Manhattan,1129524.355,SoHo-Little Italy-Hudson Square
21-Jul,36061004500,1004500,18148,139268,157416,Manhattan,1129524.355,SoHo-Little Italy-Hudson Square
19-Aug,36061004500,1004500,13466,107877,121343,Manhattan,1129524.355,SoHo-Little Italy-Hudson Square
21-Aug,36061004500,1004500,5524,46428,51952,Manhattan,1129524.355,SoHo-Little Italy-Hudson Square
19-May,36061005200,1005200,10012,108691,118703,Manhattan,1815428.992,Midtown South-Flatiron-Union Square
21-May,36061005200,1005200,9265,23785,33050,Manhattan,1815428.992,Midtown South-Flatiron-Union Square
19-Jun,36061005200,1005200,7458,144714,152172,Manhattan,1815428.992,Midtown South-Flatiron-Union Square
21-Jun,36061005200,1005200,12761,33942,46703,Manhattan,1815428.992,Midtown South-Flatiron-Union Square
19-Jul,36061005200,1005200,10967,50819,61786,Manhattan,1815428.992,Midtown South-Flatiron-Union Square
21-Jul,36061005200,1005200,5643,71,5714,Manhattan,1815428.992,Midtown South-Flatiron-Union Square
19-Aug,36061005200,1005200,5667,72565,78232,Manhattan,1815428.992,Midtown South-Flatiron-Union Square
21-Aug,36061005200,1005200,3432,50480,53912,Manhattan,1815428.992,Midtown South-Flatiron-Union Square
19-May,36061005400,1005400,7816,115454,123270,Manhattan,1809255.658,Midtown South-Flatiron-Union Square
21-May,36061005400,1005400,8142,52726,60868,Manhattan,1809255.658,Midtown South-Flatiron-Union Square
19-Jun,36061005400,1005400,10288,28444,38732,Manhattan,1809255.658,Midtown South-Flatiron-Union Square
21-Jun,36061005400,1005400,12637,92816,105453,Manhattan,1809255.658,Midtown South-Flatiron-Union Square
19-Jul,36061005400,1005400,12405,104443,116848,Manhattan,1809255.658,Midtown South-Flatiron-Union Square
21-Jul,36061005400,1005400,4736,46256,50992,Manhattan,1809255.658,Midtown South-Flatiron-Union Square
19-Aug,36061005400,1005400,2673,25428,28101,Manhattan,1809255.658,Midtown South-Flatiron-Union Square
21-Aug,36061005400,1005400,9667,108177,117844,Manhattan,1809255.658,Midtown South-Flatiron-Union Square
19-May,36061005501,1005501,6814,52284,59098,Manhattan,1338496.768,Greenwich Village
21-May,36061005501,1005501,12899,71136,84035,Manhattan,1338496.768,Greenwich Village
19-Jun,36061005501,1005501,11348,61151,72499,Manhattan,1338496.768,Greenwich Village
21-Jun,36061005501,1005501,11386,71,11457,Manhattan,1338496.768,Greenwich Village
19-Jul,36061005501,1005501,15545,49749,65294,Manhattan,1338496.768,Greenwich Village
21-Jul,36061005501,1005501,1948,25146,27094,Manhattan,1338496.768,Greenwich Village
19-Aug,36061005501,1005501,13135,76630,89765,Manhattan,1338496.768,Greenwich Village
21-Aug,36061005501,1005501,8373,45100,53473,Manhattan,1338496.768,Greenwich Village
19-May,36061005502,1005502,9685,20797,30482,Manhattan,1243017.228,Greenwich Village
21-May,36061005502,1005502,0,24374,24374,Manhattan,1243017.228,Greenwich Village
19-Jun,36061005502,1005502,17499,57010,74509,Manhattan,1243017.228,Greenwich Village
21-Jun,36061005502,1005502,7622,78426,86048,Manhattan,1243017.228,Greenwich Village
19-Jul,36061005502,1005502,10224,36980,47204,Manhattan,1243017.228,Greenwich Village
21-Jul,36061005502,1005502,5425,65837,71262,Manhattan,1243017.228,Greenwich Village
19-Aug,36061005502,1005502,5794,64976,70770,Manhattan,1243017.228,Greenwich Village
21-Aug,36061005502,1005502,6581,96748,103329,Manhattan,1243017.228,Greenwich Village
19-May,36061005800,1005800,3131,68627,71758,Manhattan,1879679.389,Midtown South-Flatiron-Union Square
21-May,36061005800,1005800,7383,61510,68893,Manhattan,1879679.389,Midtown South-Flatiron-Union Square
19-Jun,36061005800,1005800,12361,108016,120377,Manhattan,1879679.389,Midtown South-Flatiron-Union Square
21-Jun,36061005800,1005800,1424,28774,30198,Manhattan,1879679.389,Midtown South-Flatiron-Union Square
19-Jul,36061005800,1005800,11905,50532,62437,Manhattan,1879679.389,Midtown South-Flatiron-Union Square
21-Jul,36061005800,1005800,11950,92752,104702,Manhattan,1879679.389,Midtown South-Flatiron-Union Square
19-Aug,36061005800,1005800,5180,107440,112620,Manhattan,1879679.389,Midtown South-Flatiron-Union Square
21-Aug,36061005800,1005800,4483,10923,15406,Manhattan,1879679.389,Midtown South-Flatiron-Union Square
19-May,36061006300,1006300,7160,42423,49583,Manhattan,1918265.478,Greenwich Village
21-May,36061006300,1006300,8947,75166,84113,Manhattan,1918265.478,Greenwich Village
19-Jun,36061006300,1006300,3012,39770,42782,Manhattan,1918265.478,Greenwich Village
21-Jun,36061006300,1006300,6994,97733,104727,Manhattan,1918265.478,Greenwich Village
19-Jul,36061006300,1006300,5370,74678,80048,Manhattan,1918265.478,Greenwich Village
21-Jul,36061006300,1006300,3360,90648,94008,Manhattan,1918265.478,Greenwich Village
19-Aug,36061006300,1006300,3910,55083,58993,Manhattan,1918265.478,Greenwich Village
21-Aug,36061006300,1006300,9132,63026,72158,Manhattan,1918265.478,Greenwich Village
19-May,36061006500,1006500,0,70337,70337,Manhattan,2167367.115,Greenwich Village
21-May,36061006500,1006500,8839,102356,111195,Manhattan,2167367.115,Greenwich Village
19-Jun,36061006500,1006500,13372,35338,48710,Manhattan,2167367.115,Greenwich Village
21-Jun,36061006500,1006500,4798,37984,42782,Manhattan,2167367.115,Greenwich Village
19-Jul,36061006500,1006500,0,83397,83397,Manhattan,2167367.115,Greenwich Village
21-Jul,36061006500,1006500,10482,39625,50107,Manhattan,2167367.115,Greenwich Village
19-Aug,36061006500,1006500,15001,63406,78407,Manhattan,2167367.115,Greenwich Village
21-Aug,36061006500,1006500,5590,72411,78001,Manhattan,2167367.115,Greenwich Village
19-May,36061006700,1006700,2528,90573,93101,Manhattan,1812883.023,West Village
21-May,36061006700,1006700,6086,32954,39040,Manhattan,1812883.023,West Village
19-Jun,36061006700,1006700,14157,95368,109525,Manhattan,1812883.023,West Village
21-Jun,36061006700,1006700,10794,88432,99226,Manhattan,1812883.023,West Village
19-Jul,36061006700,1006700,0,51038,51038,Manhattan,1812883.023,West Village
21-Jul,36061006700,1006700,12667,65044,77711,Manhattan,1812883.023,West Village
19-Aug,36061006700,1006700,6281,39914,46195,Manhattan,1812883.023,West Village
21-Aug,36061006700,1006700,9457,51550,61007,Manhattan,1812883.023,West Village
19-May,36061006800,1006800,13638,71,13709,Manhattan,1877720.935,Gramercy
21-May,36061006800,1006800,5963,72009,77972,Manhattan,1877720.935,Gramercy
19-Jun,36061006800,1006800,15909,93435,109344,Manhattan,1877720.935,Gramercy
21-Jun,36061006800,1006800,9612,39212,48824,Manhattan,1877720.935,Gramercy
19-Jul,36061006800,1006800,6774,56508,63282,Manhattan,1877720.935,Gramercy
21-Jul,36061006800,1006800,14687,85101,99788,Manhattan,1877720.935,Gramercy
19-Aug,36061006800,1006800,4514,123507,128021,Manhattan,1877720.935,Gramercy
21-Aug,36061006800,1006800,13298,97226,110524,Manhattan,1877720.935,Gramercy
19-May,36061007001,1007001,6628,96492,103120,Manhattan,967528.0636,Murray Hill-Kips Bay
21-May,36061007001,1007001,6967,46554,53521,Manhattan,967528.0636,Murray Hill-Kips Bay
19-Jun,36061007001,1007001,4455,40316,44771,Manhattan,967528.0636,Murray Hill-Kips Bay
21-Jun,36061007001,1007001,14938,65880,80818,Manhattan,967528.0636,Murray Hill-Kips Bay
19-Jul,36061007001,1007001,11334,82229,93563,Manhattan,967528.0636,Murray Hill-Kips Bay
21-Jul,36061007001,1007001,5684,71,5755,Manhattan,967528.0636,Murray Hill-Kips Bay
19-Aug,36061007001,1007001,9909,68562,78471,Manhattan,967528.0636,Murray Hill-Kips Bay
21-Aug,36061007001,1007001,10887,28925,39812,Manhattan,967528.0636,Murray Hill-Kips Bay
19-May,36061007002,1007002,4132,90525,94657,Manhattan,941181.2664,Murray Hill-Kips Bay
21-May,36061007002,1007002,12443,50363,62806,Manhattan,941181.2664,Murray Hill-Kips Bay
19-Jun,36061007002,1007002,7963,107654,115617,Manhattan,941181.2664,Murray Hill-Kips Bay
21-Jun,36061007002,1007002,4565,4237,8802,Manhattan,941181.2664,Murray Hill-Kips Bay
19-Jul,36061007002,1007002,15299,79900,95199,Manhattan,941181.2664,Murray Hill-Kips Bay
21-Jul,36061007002,1007002,18973,43299,62272,Manhattan,941181.2664,Murray Hill-Kips Bay
19-Aug,36061007002,1007002,10848,94096,104944,Manhattan,941181.2664,Murray Hill-Kips Bay
21-Aug,36061007002,1007002,10428,72447,82875,Manhattan,941181.2664,Murray Hill-Kips Bay
19-May,36061007100,1007100,16556,76883,93439,Manhattan,1774264.342,West Village
21-May,36061007100,1007100,8914,52310,61224,Manhattan,1774264.342,West Village
19-Jun,36061007100,1007100,5468,106400,111868,Manhattan,1774264.342,West Village
21-Jun,36061007100,1007100,6226,23239,29465,Manhattan,1774264.342,West Village
19-Jul,36061007100,1007100,8095,50712,58807,Manhattan,1774264.342,West Village
21-Jul,36061007100,1007100,6526,65405,71931,Manhattan,1774264.342,West Village
19-Aug,36061007100,1007100,7356,94871,102227,Manhattan,1774264.342,West Village
21-Aug,36061007100,1007100,3130,61185,64315,Manhattan,1774264.342,West Village
19-May,36061007200,1007200,6680,69503,76183,Manhattan,1877428.796,Murray Hill-Kips Bay
21-May,36061007200,1007200,9374,13429,22803,Manhattan,1877428.796,Murray Hill-Kips Bay
19-Jun,36061007200,1007200,15862,41581,57443,Manhattan,1877428.796,Murray Hill-Kips Bay
21-Jun,36061007200,1007200,7207,67571,74778,Manhattan,1877428.796,Murray Hill-Kips Bay
19-Jul,36061007200,1007200,18413,54813,73226,Manhattan,1877428.796,Murray Hill-Kips Bay
21-Jul,36061007200,1007200,5496,127356,132852,Manhattan,1877428.796,Murray Hill-Kips Bay
19-Aug,36061007200,1007200,6962,78797,85759,Manhattan,1877428.796,Murray Hill-Kips Bay
21-Aug,36061007200,1007200,8399,3200,11599,Manhattan,1877428.796,Murray Hill-Kips Bay
19-May,36061007300,1007300,0,117284,117284,Manhattan,1778587.974,West Village
21-May,36061007300,1007300,3730,71,3801,Manhattan,1778587.974,West Village
19-Jun,36061007300,1007300,17801,106850,124651,Manhattan,1778587.974,West Village
21-Jun,36061007300,1007300,5815,74610,80425,Manhattan,1778587.974,West Village
19-Jul,36061007300,1007300,8946,13911,22857,Manhattan,1778587.974,West Village
21-Jul,36061007300,1007300,8247,101598,109845,Manhattan,1778587.974,West Village
19-Aug,36061007300,1007300,13076,76900,89976,Manhattan,1778587.974,West Village
21-Aug,36061007300,1007300,3272,60211,63483,Manhattan,1778587.974,West Village
19-May,36061007600,1007600,5025,84831,89856,Manhattan,1873518.146,Midtown South-Flatiron-Union Square
21-May,36061007600,1007600,6863,71,6934,Manhattan,1873518.146,Midtown South-Flatiron-Union Square
19-Jun,36061007600,1007600,7239,91544,98783,Manhattan,1873518.146,Midtown South-Flatiron-Union Square
21-Jun,36061007600,1007600,11024,75273,86297,Manhattan,1873518.146,Midtown South-Flatiron-Union Square
19-Jul,36061007600,1007600,4200,108908,113108,Manhattan,1873518.146,Midtown South-Flatiron-Union Square
21-Jul,36061007600,1007600,7128,63923,71051,Manhattan,1873518.146,Midtown South-Flatiron-Union Square
19-Aug,36061007600,1007600,0,97593,97593,Manhattan,1873518.146,Midtown South-Flatiron-Union Square
21-Aug,36061007600,1007600,6862,83893,90755,Manhattan,1873518.146,Midtown South-Flatiron-Union Square
19-May,36061007700,1007700,5168,96987,102155,Manhattan,1924995.855,West Village
21-May,36061007700,1007700,3305,98331,101636,Manhattan,1924995.855,West Village
19-Jun,36061007700,1007700,16842,141664,158506,Manhattan,1924995.855,West Village
21-Jun,36061007700,1007700,7708,102647,110355,Manhattan,1924995.855,West Village
19-Jul,36061007700,1007700,13203,46238,59441,Manhattan,1924995.855,West Village
21-Jul,36061007700,1007700,9143,76251,85394,Manhattan,1924995.855,West Village
19-Aug,36061007700,1007700,9280,153410,162690,Manhattan,1924995.855,West Village
21-Aug,36061007700,1007700,1825,29774,31599,Manhattan,1924995.855,West Village
19-May,36061007800,1007800,4415,112785,117200,Manhattan,1912109.897,Murray Hill-Kips Bay
21-May,36061007800,1007800,194,48803,48997,Manhattan,1912109.897,Murray Hill-Kips Bay
19-Jun,36061007800,1007800,7523,66972,74495,Manhattan,1912109.897,Murray Hill-Kips Bay
21-Jun,36061007800,1007800,0,14966,14966,Manhattan,1912109.897,Murray Hill-Kips Bay
19-Jul,36061007800,1007800,11724,12892,24616,Manhattan,1912109.897,Murray Hill-Kips Bay
21-Jul,36061007800,1007800,0,85530,85530,Manhattan,1912109.897,Murray Hill-Kips Bay
19-Aug,36061007800,1007800,10791,27689,38480,Manhattan,1912109.897,Murray Hill-Kips Bay
21-Aug,36061007800,1007800,14042,94813,108855,Manhattan,1912109.897,Murray Hill-Kips Bay
19-May,36061008000,1008000,7196,52518,59714,Manhattan,1855976.699,Murray Hill-Kips Bay
21-May,36061008000,1008000,13978,71286,85264,Manhattan,1855976.699,Murray Hill-Kips Bay
19-Jun,36061008000,1008000,19452,112808,132260,Manhattan,1855976.699,Murray Hill-Kips Bay
21-Jun,36061008000,1008000,6865,133105,139970,Manhattan,1855976.699,Murray Hill-Kips Bay
19-Jul,36061008000,1008000,1661,107682,109343,Manhattan,1855976.699,Murray Hill-Kips Bay
21-Jul,36061008000,1008000,11603,85408,97011,Manhattan,1855976.699,Murray Hill-Kips Bay
19-Aug,36061008000,1008000,1452,78139,79591,Manhattan,1855976.699,Murray Hill-Kips Bay
21-Aug,36061008000,1008000,19215,66940,86155,Manhattan,1855976.699,Murray Hill-Kips Bay
19-May,36061008100,1008100,3500,76788,80288,Manhattan,1875912.499,Chelsea-Hudson Yards
21-May,36061008100,1008100,8895,62560,71455,Manhattan,1875912.499,Chelsea-Hudson Yards
19-Jun,36061008100,1008100,11557,96717,108274,Manhattan,1875912.499,Chelsea-Hudson Yards
21-Jun,36061008100,1008100,6817,87689,94506,Manhattan,1875912.499,Chelsea-Hudson Yards
19-Jul,36061008100,1008100,0,97960,97960,Manhattan,1875912.499,Chelsea-Hudson Yards
21-Jul,36061008100,1008100,24,75450,75474,Manhattan,1875912.499,Chelsea-Hudson Yards
19-Aug,36061008100,1008100,6491,77676,84167,Manhattan,1875912.499,Chelsea-Hudson Yards
21-Aug,36061008100,1008100,10443,87726,98169,Manhattan,1875912.499,Chelsea-Hudson Yards
19-May,36061008200,1008200,10403,94690,105093,Manhattan,1856719.42,Midtown-Times Square
21-May,36061008200,1008200,8202,137164,145366,Manhattan,1856719.42,Midtown-Times Square
19-Jun,36061008200,1008200,3258,29954,33212,Manhattan,1856719.42,Midtown-Times Square
21-Jun,36061008200,1008200,4187,96482,100669,Manhattan,1856719.42,Midtown-Times Square
19-Jul,36061008200,1008200,4270,84568,88838,Manhattan,1856719.42,Midtown-Times Square
21-Jul,36061008200,1008200,13003,70995,83998,Manhattan,1856719.42,Midtown-Times Square
19-Aug,36061008200,1008200,7687,106382,114069,Manhattan,1856719.42,Midtown-Times Square
21-Aug,36061008200,1008200,0,125512,125512,Manhattan,1856719.42,Midtown-Times Square
19-May,36061008300,1008300,7826,61225,69051,Manhattan,1873011.556,Chelsea-Hudson Yards
21-May,36061008300,1008300,13696,76332,90028,Manhattan,1873011.556,Chelsea-Hudson Yards
19-Jun,36061008300,1008300,7536,81411,88947,Manhattan,1873011.556,Chelsea-Hudson Yards
21-Jun,36061008300,1008300,12987,33057,46044,Manhattan,1873011.556,Chelsea-Hudson Yards
19-Jul,36061008300,1008300,9720,61477,71197,Manhattan,1873011.556,Chelsea-Hudson Yards
21-Jul,36061008300,1008300,5646,116096,121742,Manhattan,1873011.556,Chelsea-Hudson Yards
19-Aug,36061008300,1008300,13270,33422,46692,Manhattan,1873011.556,Chelsea-Hudson Yards
21-Aug,36061008300,1008300,5008,19589,24597,Manhattan,1873011.556,Chelsea-Hudson Yards
19-May,36061008400,1008400,10780,105457,116237,Manhattan,1862741.798,Midtown-Times Square
21-May,36061008400,1008400,2326,59689,62015,Manhattan,1862741.798,Midtown-Times Square
19-Jun,36061008400,1008400,10723,41643,52366,Manhattan,1862741.798,Midtown-Times Square
21-Jun,36061008400,1008400,4106,71,4177,Manhattan,1862741.798,Midtown-Times Square
19-Jul,36061008400,1008400,13534,124251,137785,Manhattan,1862741.798,Midtown-Times Square
21-Jul,36061008400,1008400,10046,55618,65664,Manhattan,1862741.798,Midtown-Times Square
19-Aug,36061008400,1008400,12102,103834,115936,Manhattan,1862741.798,Midtown-Times Square
21-Aug,36061008400,1008400,13630,71,13701,Manhattan,1862741.798,Midtown-Times Square
19-May,36061008700,1008700,8080,71,8151,Manhattan,1780834.065,Chelsea-Hudson Yards
21-May,36061008700,1008700,2759,76992,79751,Manhattan,1780834.065,Chelsea-Hudson Yards
19-Jun,36061008700,1008700,5436,79442,84878,Manhattan,1780834.065,Chelsea-Hudson Yards
21-Jun,36061008700,1008700,10533,18597,29130,Manhattan,1780834.065,Chelsea-Hudson Yards
19-Jul,36061008700,1008700,0,21964,21964,Manhattan,1780834.065,Chelsea-Hudson Yards
21-Jul,36061008700,1008700,4317,71,4388,Manhattan,1780834.065,Chelsea-Hudson Yards
19-Aug,36061008700,1008700,18111,72586,90697,Manhattan,1780834.065,Chelsea-Hudson Yards
21-Aug,36061008700,1008700,4137,97159,101296,Manhattan,1780834.065,Chelsea-Hudson Yards
19-May,36061008900,1008900,13754,86237,99991,Manhattan,1782674.051,Chelsea-Hudson Yards
21-May,36061008900,1008900,5217,62875,68092,Manhattan,1782674.051,Chelsea-Hudson Yards
19-Jun,36061008900,1008900,2811,33179,35990,Manhattan,1782674.051,Chelsea-Hudson Yards
21-Jun,36061008900,1008900,9069,121897,130966,Manhattan,1782674.051,Chelsea-Hudson Yards
19-Jul,36061008900,1008900,11449,37010,48459,Manhattan,1782674.051,Chelsea-Hudson Yards
21-Jul,36061008900,1008900,8967,22227,31194,Manhattan,1782674.051,Chelsea-Hudson Yards
19-Aug,36061008900,1008900,19546,32099,51645,Manhattan,1782674.051,Chelsea-Hudson Yards
21-Aug,36061008900,1008900,12812,48060,60872,Manhattan,1782674.051,Chelsea-Hudson Yards
19-May,36061009100,1009100,12605,113154,125759,Manhattan,1927040.126,Chelsea-Hudson Yards
21-May,36061009100,1009100,0,68178,68178,Manhattan,1927040.126,Chelsea-Hudson Yards
19-Jun,36061009100,1009100,11371,183578,194949,Manhattan,1927040.126,Chelsea-Hudson Yards
21-Jun,36061009100,1009100,12103,15473,27576,Manhattan,1927040.126,Chelsea-Hudson Yards
19-Jul,36061009100,1009100,0,20372,20372,Manhattan,1927040.126,Chelsea-Hudson Yards
21-Jul,36061009100,1009100,11563,145076,156639,Manhattan,1927040.126,Chelsea-Hudson Yards
19-Aug,36061009100,1009100,6979,88994,95973,Manhattan,1927040.126,Chelsea-Hudson Yards
21-Aug,36061009100,1009100,6177,71209,77386,Manhattan,1927040.126,Chelsea-Hudson Yards
19-May,36061009200,1009200,7240,91910,99150,Manhattan,2118430.844,East Midtown-Turtle Bay
21-May,36061009200,1009200,5377,126732,132109,Manhattan,2118430.844,East Midtown-Turtle Bay
19-Jun,36061009200,1009200,12651,98474,111125,Manhattan,2118430.844,East Midtown-Turtle Bay
21-Jun,36061009200,1009200,2307,129327,131634,Manhattan,2118430.844,East Midtown-Turtle Bay
19-Jul,36061009200,1009200,8455,77852,86307,Manhattan,2118430.844,East Midtown-Turtle Bay
21-Jul,36061009200,1009200,12127,57514,69641,Manhattan,2118430.844,East Midtown-Turtle Bay
19-Aug,36061009200,1009200,15855,69972,85827,Manhattan,2118430.844,East Midtown-Turtle Bay
21-Aug,36061009200,1009200,11527,92959,104486,Manhattan,2118430.844,East Midtown-Turtle Bay
19-May,36061009300,1009300,4282,94596,98878,Manhattan,1929422.575,Chelsea-Hudson Yards
21-May,36061009300,1009300,6790,115908,122698,Manhattan,1929422.575,Chelsea-Hudson Yards
19-Jun,36061009300,1009300,11148,80712,91860,Manhattan,1929422.575,Chelsea-Hudson Yards
21-Jun,36061009300,1009300,3446,100563,104009,Manhattan,1929422.575,Chelsea-Hudson Yards
19-Jul,36061009300,1009300,5305,26025,31330,Manhattan,1929422.575,Chelsea-Hudson Yards
21-Jul,36061009300,1009300,7466,8300,15766,Manhattan,1929422.575,Chelsea-Hudson Yards
19-Aug,36061009300,1009300,11618,45611,57229,Manhattan,1929422.575,Chelsea-Hudson Yards
21-Aug,36061009300,1009300,3042,38965,42007,Manhattan,1929422.575,Chelsea-Hudson Yards
19-May,36061009400,1009400,3356,571,3927,Manhattan,1646379.211,Midtown-Times Square
21-May,36061009400,1009400,13111,99033,112144,Manhattan,1646379.211,Midtown-Times Square
19-Jun,36061009400,1009400,22706,68631,91337,Manhattan,1646379.211,Midtown-Times Square
21-Jun,36061009400,1009400,8642,47878,56520,Manhattan,1646379.211,Midtown-Times Square
19-Jul,36061009400,1009400,8393,71,8464,Manhattan,1646379.211,Midtown-Times Square
21-Jul,36061009400,1009400,4340,34204,38544,Manhattan,1646379.211,Midtown-Times Square
19-Aug,36061009400,1009400,13033,90939,103972,Manhattan,1646379.211,Midtown-Times Square
21-Aug,36061009400,1009400,13418,46075,59493,Manhattan,1646379.211,Midtown-Times Square
19-May,36061009500,1009500,15359,62185,77544,Manhattan,1851171.249,Midtown South-Flatiron-Union Square
21-May,36061009500,1009500,1310,127622,128932,Manhattan,1851171.249,Midtown South-Flatiron-Union Square
19-Jun,36061009500,1009500,0,24062,24062,Manhattan,1851171.249,Midtown South-Flatiron-Union Square
21-Jun,36061009500,1009500,9657,117623,127280,Manhattan,1851171.249,Midtown South-Flatiron-Union Square
19-Jul,36061009500,1009500,11159,109539,120698,Manhattan,1851171.249,Midtown South-Flatiron-Union Square
21-Jul,36061009500,1009500,0,34936,34936,Manhattan,1851171.249,Midtown South-Flatiron-Union Square
19-Aug,36061009500,1009500,5525,61290,66815,Manhattan,1851171.249,Midtown South-Flatiron-Union Square
21-Aug,36061009500,1009500,9718,83712,93430,Manhattan,1851171.249,Midtown South-Flatiron-Union Square
19-May,36061009600,1009600,7896,37107,45003,Manhattan,1887288.386,Midtown-Times Square
21-May,36061009600,1009600,4495,70352,74847,Manhattan,1887288.386,Midtown-Times Square
19-Jun,36061009600,1009600,0,95113,95113,Manhattan,1887288.386,Midtown-Times Square
21-Jun,36061009600,1009600,14684,46731,61415,Manhattan,1887288.386,Midtown-Times Square
19-Jul,36061009600,1009600,3530,79654,83184,Manhattan,1887288.386,Midtown-Times Square
21-Jul,36061009600,1009600,8730,65286,74016,Manhattan,1887288.386,Midtown-Times Square
19-Aug,36061009600,1009600,10106,70644,80750,Manhattan,1887288.386,Midtown-Times Square
21-Aug,36061009600,1009600,8779,53338,62117,Manhattan,1887288.386,Midtown-Times Square
19-May,36061009700,1009700,3769,113669,117438,Manhattan,1860581.094,Chelsea-Hudson Yards
21-May,36061009700,1009700,11174,97993,109167,Manhattan,1860581.094,Chelsea-Hudson Yards
19-Jun,36061009700,1009700,17677,33692,51369,Manhattan,1860581.094,Chelsea-Hudson Yards
21-Jun,36061009700,1009700,8032,72856,80888,Manhattan,1860581.094,Chelsea-Hudson Yards
19-Jul,36061009700,1009700,5367,75651,81018,Manhattan,1860581.094,Chelsea-Hudson Yards
21-Jul,36061009700,1009700,4643,62676,67319,Manhattan,1860581.094,Chelsea-Hudson Yards
19-Aug,36061009700,1009700,1109,23225,24334,Manhattan,1860581.094,Chelsea-Hudson Yards
21-Aug,36061009700,1009700,8671,81693,90364,Manhattan,1860581.094,Chelsea-Hudson Yards
19-May,36061009902,1009902,2320,94765,97085,Manhattan,2006894.843,Chelsea-Hudson Yards
21-May,36061009902,1009902,6673,90935,97608,Manhattan,2006894.843,Chelsea-Hudson Yards
19-Jun,36061009902,1009902,13563,130286,143849,Manhattan,2006894.843,Chelsea-Hudson Yards
21-Jun,36061009902,1009902,5994,89263,95257,Manhattan,2006894.843,Chelsea-Hudson Yards
19-Jul,36061009902,1009902,5311,28203,33514,Manhattan,2006894.843,Chelsea-Hudson Yards
21-Jul,36061009902,1009902,13092,85789,98881,Manhattan,2006894.843,Chelsea-Hudson Yards
19-Aug,36061009902,1009902,5353,88788,94141,Manhattan,2006894.843,Chelsea-Hudson Yards
21-Aug,36061009902,1009902,7047,19718,26765,Manhattan,2006894.843,Chelsea-Hudson Yards
19-May,36061010000,1010000,7842,11793,19635,Manhattan,1859881.005,East Midtown-Turtle Bay
21-May,36061010000,1010000,6884,118165,125049,Manhattan,1859881.005,East Midtown-Turtle Bay
19-Jun,36061010000,1010000,5947,8642,14589,Manhattan,1859881.005,East Midtown-Turtle Bay
21-Jun,36061010000,1010000,7286,112402,119688,Manhattan,1859881.005,East Midtown-Turtle Bay
19-Jul,36061010000,1010000,6038,77516,83554,Manhattan,1859881.005,East Midtown-Turtle Bay
21-Jul,36061010000,1010000,3910,78286,82196,Manhattan,1859881.005,East Midtown-Turtle Bay
19-Aug,36061010000,1010000,15884,14062,29946,Manhattan,1859881.005,East Midtown-Turtle Bay
21-Aug,36061010000,1010000,7172,111167,118339,Manhattan,1859881.005,East Midtown-Turtle Bay
19-May,36061010100,1010100,11550,75888,87438,Manhattan,1891377.987,Midtown South-Flatiron-Union Square
21-May,36061010100,1010100,2858,45268,48126,Manhattan,1891377.987,Midtown South-Flatiron-Union Square
19-Jun,36061010100,1010100,8623,66600,75223,Manhattan,1891377.987,Midtown South-Flatiron-Union Square
21-Jun,36061010100,1010100,0,43529,43529,Manhattan,1891377.987,Midtown South-Flatiron-Union Square
19-Jul,36061010100,1010100,12583,16626,29209,Manhattan,1891377.987,Midtown South-Flatiron-Union Square
21-Jul,36061010100,1010100,21987,30326,52313,Manhattan,1891377.987,Midtown South-Flatiron-Union Square
19-Aug,36061010100,1010100,5746,125726,131472,Manhattan,1891377.987,Midtown South-Flatiron-Union Square
21-Aug,36061010100,1010100,7708,158616,166324,Manhattan,1891377.987,Midtown South-Flatiron-Union Square
19-May,36061010200,1010200,19294,32793,52087,Manhattan,1860992.689,Midtown-Times Square
21-May,36061010200,1010200,2141,35876,38017,Manhattan,1860992.689,Midtown-Times Square
19-Jun,36061010200,1010200,343,22204,22547,Manhattan,1860992.689,Midtown-Times Square
21-Jun,36061010200,1010200,13306,64459,77765,Manhattan,1860992.689,Midtown-Times Square
19-Jul,36061010200,1010200,8858,73335,82193,Manhattan,1860992.689,Midtown-Times Square
21-Jul,36061010200,1010200,6379,198274,204653,Manhattan,1860992.689,Midtown-Times Square
19-Aug,36061010200,1010200,3845,83159,87004,Manhattan,1860992.689,Midtown-Times Square
21-Aug,36061010200,1010200,9952,43585,53537,Manhattan,1860992.689,Midtown-Times Square
19-May,36061010400,1010400,13725,118074,131799,Manhattan,1864600.369,Midtown-Times Square
21-May,36061010400,1010400,2825,81381,84206,Manhattan,1864600.369,Midtown-Times Square
19-Jun,36061010400,1010400,2850,49828,52678,Manhattan,1864600.369,Midtown-Times Square
21-Jun,36061010400,1010400,8963,69239,78202,Manhattan,1864600.369,Midtown-Times Square
19-Jul,36061010400,1010400,9581,56237,65818,Manhattan,1864600.369,Midtown-Times Square
21-Jul,36061010400,1010400,6253,78165,84418,Manhattan,1864600.369,Midtown-Times Square
19-Aug,36061010400,1010400,5079,94080,99159,Manhattan,1864600.369,Midtown-Times Square
21-Aug,36061010400,1010400,7853,103423,111276,Manhattan,1864600.369,Midtown-Times Square
19-May,36061010801,1010801,18004,72597,90601,Manhattan,763140.6382,East Midtown-Turtle Bay
21-May,36061010801,1010801,841,134242,135083,Manhattan,763140.6382,East Midtown-Turtle Bay
19-Jun,36061010801,1010801,5628,73704,79332,Manhattan,763140.6382,East Midtown-Turtle Bay
21-Jun,36061010801,1010801,11710,65319,77029,Manhattan,763140.6382,East Midtown-Turtle Bay
19-Jul,36061010801,1010801,7100,104093,111193,Manhattan,763140.6382,East Midtown-Turtle Bay
21-Jul,36061010801,1010801,8479,71605,80084,Manhattan,763140.6382,East Midtown-Turtle Bay
19-Aug,36061010801,1010801,15807,69824,85631,Manhattan,763140.6382,East Midtown-Turtle Bay
21-Aug,36061010801,1010801,4273,91741,96014,Manhattan,763140.6382,East Midtown-Turtle Bay
19-May,36061010802,1010802,6056,124855,130911,Manhattan,617743.7549,East Midtown-Turtle Bay
21-May,36061010802,1010802,2231,132315,134546,Manhattan,617743.7549,East Midtown-Turtle Bay
19-Jun,36061010802,1010802,14071,129865,143936,Manhattan,617743.7549,East Midtown-Turtle Bay
21-Jun,36061010802,1010802,11657,31244,42901,Manhattan,617743.7549,East Midtown-Turtle Bay
19-Jul,36061010802,1010802,9528,55975,65503,Manhattan,617743.7549,East Midtown-Turtle Bay
21-Jul,36061010802,1010802,10571,73155,83726,Manhattan,617743.7549,East Midtown-Turtle Bay
19-Aug,36061010802,1010802,9787,115241,125028,Manhattan,617743.7549,East Midtown-Turtle Bay
21-Aug,36061010802,1010802,2637,33693,36330,Manhattan,617743.7549,East Midtown-Turtle Bay
19-May,36061010803,1010803,4291,106224,110515,Manhattan,583083.6865,East Midtown-Turtle Bay
21-May,36061010803,1010803,13403,71,13474,Manhattan,583083.6865,East Midtown-Turtle Bay
19-Jun,36061010803,1010803,13470,74011,87481,Manhattan,583083.6865,East Midtown-Turtle Bay
21-Jun,36061010803,1010803,9243,24812,34055,Manhattan,583083.6865,East Midtown-Turtle Bay
19-Jul,36061010803,1010803,6694,16126,22820,Manhattan,583083.6865,East Midtown-Turtle Bay
21-Jul,36061010803,1010803,13590,39831,53421,Manhattan,583083.6865,East Midtown-Turtle Bay
19-Aug,36061010803,1010803,9002,109749,118751,Manhattan,583083.6865,East Midtown-Turtle Bay
21-Aug,36061010803,1010803,3794,75036,78830,Manhattan,583083.6865,East Midtown-Turtle Bay
19-May,36061010900,1010900,2193,71868,74061,Manhattan,1891364.513,Midtown-Times Square
21-May,36061010900,1010900,1661,65813,67474,Manhattan,1891364.513,Midtown-Times Square
19-Jun,36061010900,1010900,15096,70418,85514,Manhattan,1891364.513,Midtown-Times Square
21-Jun,36061010900,1010900,2787,84212,86999,Manhattan,1891364.513,Midtown-Times Square
19-Jul,36061010900,1010900,7263,131480,138743,Manhattan,1891364.513,Midtown-Times Square
21-Jul,36061010900,1010900,16725,130835,147560,Manhattan,1891364.513,Midtown-Times Square
19-Aug,36061010900,1010900,1393,80802,82195,Manhattan,1891364.513,Midtown-Times Square
21-Aug,36061010900,1010900,10453,84314,94767,Manhattan,1891364.513,Midtown-Times Square
19-May,36061011201,1011201,7429,32889,40318,Manhattan,856164.2783,Midtown-Times Square
21-May,36061011201,1011201,4324,82562,86886,Manhattan,856164.2783,Midtown-Times Square
19-Jun,36061011201,1011201,2109,69332,71441,Manhattan,856164.2783,Midtown-Times Square
21-Jun,36061011201,1011201,8029,71,8100,Manhattan,856164.2783,Midtown-Times Square
19-Jul,36061011201,1011201,10357,136581,146938,Manhattan,856164.2783,Midtown-Times Square
21-Jul,36061011201,1011201,15945,139034,154979,Manhattan,856164.2783,Midtown-Times Square
19-Aug,36061011201,1011201,17500,75742,93242,Manhattan,856164.2783,Midtown-Times Square
21-Aug,36061011201,1011201,5068,100305,105373,Manhattan,856164.2783,Midtown-Times Square
19-May,36061011202,1011202,4444,98412,102856,Manhattan,839525.673,Midtown-Times Square
21-May,36061011202,1011202,5495,71,5566,Manhattan,839525.673,Midtown-Times Square
19-Jun,36061011202,1011202,7297,52802,60099,Manhattan,839525.673,Midtown-Times Square
21-Jun,36061011202,1011202,2660,77908,80568,Manhattan,839525.673,Midtown-Times Square
19-Jul,36061011202,1011202,11758,88737,100495,Manhattan,839525.673,Midtown-Times Square
21-Jul,36061011202,1011202,5847,59349,65196,Manhattan,839525.673,Midtown-Times Square
19-Aug,36061011202,1011202,12799,126205,139004,Manhattan,839525.673,Midtown-Times Square
21-Aug,36061011202,1011202,7666,62580,70246,Manhattan,839525.673,Midtown-Times Square
19-May,36061011203,1011203,10561,58355,68916,Manhattan,841193.0101,East Midtown-Turtle Bay
21-May,36061011203,1011203,8159,45236,53395,Manhattan,841193.0101,East Midtown-Turtle Bay
19-Jun,36061011203,1011203,2308,82052,84360,Manhattan,841193.0101,East Midtown-Turtle Bay
21-Jun,36061011203,1011203,7860,74575,82435,Manhattan,841193.0101,East Midtown-Turtle Bay
19-Jul,36061011203,1011203,13218,38668,51886,Manhattan,841193.0101,East Midtown-Turtle Bay
21-Jul,36061011203,1011203,2553,71,2624,Manhattan,841193.0101,East Midtown-Turtle Bay
19-Aug,36061011203,1011203,13144,45119,58263,Manhattan,841193.0101,East Midtown-Turtle Bay
21-Aug,36061011203,1011203,9809,93003,102812,Manhattan,841193.0101,East Midtown-Turtle Bay
19-May,36061011300,1011300,4139,66255,70394,Manhattan,1890907.268,Midtown-Times Square
21-May,36061011300,1011300,8384,75330,83714,Manhattan,1890907.268,Midtown-Times Square
19-Jun,36061011300,1011300,11658,137594,149252,Manhattan,1890907.268,Midtown-Times Square
21-Jun,36061011300,1011300,7591,8951,16542,Manhattan,1890907.268,Midtown-Times Square
19-Jul,36061011300,1011300,19222,63131,82353,Manhattan,1890907.268,Midtown-Times Square
21-Jul,36061011300,1011300,15640,90102,105742,Manhattan,1890907.268,Midtown-Times Square
19-Aug,36061011300,1011300,1034,38776,39810,Manhattan,1890907.268,Midtown-Times Square
21-Aug,36061011300,1011300,403,62971,63374,Manhattan,1890907.268,Midtown-Times Square
19-May,36061011402,1011402,1866,71,1937,Manhattan,1063547.353,Upper East Side-Carnegie Hill
21-May,36061011402,1011402,8068,43183,51251,Manhattan,1063547.353,Upper East Side-Carnegie Hill
19-Jun,36061011402,1011402,10952,14545,25497,Manhattan,1063547.353,Upper East Side-Carnegie Hill
21-Jun,36061011402,1011402,7029,195035,202064,Manhattan,1063547.353,Upper East Side-Carnegie Hill
19-Jul,36061011402,1011402,7520,57176,64696,Manhattan,1063547.353,Upper East Side-Carnegie Hill
21-Jul,36061011402,1011402,9368,99660,109028,Manhattan,1063547.353,Upper East Side-Carnegie Hill
19-Aug,36061011402,1011402,7894,46402,54296,Manhattan,1063547.353,Upper East Side-Carnegie Hill
21-Aug,36061011402,1011402,14103,34741,48844,Manhattan,1063547.353,Upper East Side-Carnegie Hill
19-May,36061011800,1011800,15674,88959,104633,Manhattan,1903276.166,Upper East Side-Lenox Hill-Roosevelt Island
21-May,36061011800,1011800,4578,101454,106032,Manhattan,1903276.166,Upper East Side-Lenox Hill-Roosevelt Island
19-Jun,36061011800,1011800,9437,52040,61477,Manhattan,1903276.166,Upper East Side-Lenox Hill-Roosevelt Island
21-Jun,36061011800,1011800,9788,17683,27471,Manhattan,1903276.166,Upper East Side-Lenox Hill-Roosevelt Island
19-Jul,36061011800,1011800,13550,82391,95941,Manhattan,1903276.166,Upper East Side-Lenox Hill-Roosevelt Island
21-Jul,36061011800,1011800,945,59277,60222,Manhattan,1903276.166,Upper East Side-Lenox Hill-Roosevelt Island
19-Aug,36061011800,1011800,3658,101005,104663,Manhattan,1903276.166,Upper East Side-Lenox Hill-Roosevelt Island
21-Aug,36061011800,1011800,4561,96132,100693,Manhattan,1903276.166,Upper East Side-Lenox Hill-Roosevelt Island
19-May,36061011900,1011900,5175,79849,85024,Manhattan,1911310.687,Midtown-Times Square
21-May,36061011900,1011900,7340,62076,69416,Manhattan,1911310.687,Midtown-Times Square
19-Jun,36061011900,1011900,871,143294,144165,Manhattan,1911310.687,Midtown-Times Square
21-Jun,36061011900,1011900,13346,121573,134919,Manhattan,1911310.687,Midtown-Times Square
19-Jul,36061011900,1011900,8046,21281,29327,Manhattan,1911310.687,Midtown-Times Square
21-Jul,36061011900,1011900,7874,104725,112599,Manhattan,1911310.687,Midtown-Times Square
19-Aug,36061011900,1011900,11489,50477,61966,Manhattan,1911310.687,Midtown-Times Square
21-Aug,36061011900,1011900,12141,86121,98262,Manhattan,1911310.687,Midtown-Times Square
19-May,36061012000,1012000,6547,40866,47413,Manhattan,1862415.511,Upper East Side-Carnegie Hill
21-May,36061012000,1012000,13822,40468,54290,Manhattan,1862415.511,Upper East Side-Carnegie Hill
19-Jun,36061012000,1012000,10707,104494,115201,Manhattan,1862415.511,Upper East Side-Carnegie Hill
21-Jun,36061012000,1012000,4020,102167,106187,Manhattan,1862415.511,Upper East Side-Carnegie Hill
19-Jul,36061012000,1012000,18508,63688,82196,Manhattan,1862415.511,Upper East Side-Carnegie Hill
21-Jul,36061012000,1012000,0,32559,32559,Manhattan,1862415.511,Upper East Side-Carnegie Hill
19-Aug,36061012000,1012000,9068,72290,81358,Manhattan,1862415.511,Upper East Side-Carnegie Hill
21-Aug,36061012000,1012000,13694,67788,81482,Manhattan,1862415.511,Upper East Side-Carnegie Hill
19-May,36061012101,1012101,14560,18802,33362,Manhattan,959570.576,Hell's Kitchen
21-May,36061012101,1012101,5527,19175,24702,Manhattan,959570.576,Hell's Kitchen
19-Jun,36061012101,1012101,4564,60332,64896,Manhattan,959570.576,Hell's Kitchen
21-Jun,36061012101,1012101,12667,81835,94502,Manhattan,959570.576,Hell's Kitchen
19-Jul,36061012101,1012101,0,37871,37871,Manhattan,959570.576,Hell's Kitchen
21-Jul,36061012101,1012101,14753,78766,93519,Manhattan,959570.576,Hell's Kitchen
19-Aug,36061012101,1012101,8501,138090,146591,Manhattan,959570.576,Hell's Kitchen
21-Aug,36061012101,1012101,3239,52669,55908,Manhattan,959570.576,Hell's Kitchen
19-May,36061012102,1012102,16475,99072,115547,Manhattan,959890.0593,Hell's Kitchen
21-May,36061012102,1012102,2002,33038,35040,Manhattan,959890.0593,Hell's Kitchen
19-Jun,36061012102,1012102,5069,74514,79583,Manhattan,959890.0593,Hell's Kitchen
21-Jun,36061012102,1012102,1376,101287,102663,Manhattan,959890.0593,Hell's Kitchen
19-Jul,36061012102,1012102,0,73060,73060,Manhattan,959890.0593,Hell's Kitchen
21-Jul,36061012102,1012102,4780,58285,63065,Manhattan,959890.0593,Hell's Kitchen
19-Aug,36061012102,1012102,2745,83704,86449,Manhattan,959890.0593,Hell's Kitchen
21-Aug,36061012102,1012102,14344,14264,28608,Manhattan,959890.0593,Hell's Kitchen
19-May,36061012200,1012200,10250,100166,110416,Manhattan,1857829.444,Upper East Side-Carnegie Hill
21-May,36061012200,1012200,16471,51059,67530,Manhattan,1857829.444,Upper East Side-Carnegie Hill
19-Jun,36061012200,1012200,9354,27427,36781,Manhattan,1857829.444,Upper East Side-Carnegie Hill
21-Jun,36061012200,1012200,10601,107160,117761,Manhattan,1857829.444,Upper East Side-Carnegie Hill
19-Jul,36061012200,1012200,2666,57452,60118,Manhattan,1857829.444,Upper East Side-Carnegie Hill
21-Jul,36061012200,1012200,8242,72436,80678,Manhattan,1857829.444,Upper East Side-Carnegie Hill
19-Aug,36061012200,1012200,14128,70403,84531,Manhattan,1857829.444,Upper East Side-Carnegie Hill
21-Aug,36061012200,1012200,5855,16028,21883,Manhattan,1857829.444,Upper East Side-Carnegie Hill
19-May,36061012500,1012500,16740,39888,56628,Manhattan,1875481.303,Midtown-Times Square
21-May,36061012500,1012500,11390,134131,145521,Manhattan,1875481.303,Midtown-Times Square
19-Jun,36061012500,1012500,8744,117745,126489,Manhattan,1875481.303,Midtown-Times Square
21-Jun,36061012500,1012500,3706,74266,77972,Manhattan,1875481.303,Midtown-Times Square
19-Jul,36061012500,1012500,3143,86516,89659,Manhattan,1875481.303,Midtown-Times Square
21-Jul,36061012500,1012500,10548,69281,79829,Manhattan,1875481.303,Midtown-Times Square
19-Aug,36061012500,1012500,9597,84223,93820,Manhattan,1875481.303,Midtown-Times Square
21-Aug,36061012500,1012500,5793,36644,42437,Manhattan,1875481.303,Midtown-Times Square
19-May,36061012601,1012601,13155,99059,112214,Manhattan,1015522.495,Upper East Side-Lenox Hill-Roosevelt Island
21-May,36061012601,1012601,5789,121993,127782,Manhattan,1015522.495,Upper East Side-Lenox Hill-Roosevelt Island
19-Jun,36061012601,1012601,3900,143625,147525,Manhattan,1015522.495,Upper East Side-Lenox Hill-Roosevelt Island
21-Jun,36061012601,1012601,9401,88473,97874,Manhattan,1015522.495,Upper East Side-Lenox Hill-Roosevelt Island
19-Jul,36061012601,1012601,10081,116401,126482,Manhattan,1015522.495,Upper East Side-Lenox Hill-Roosevelt Island
21-Jul,36061012601,1012601,8509,86900,95409,Manhattan,1015522.495,Upper East Side-Lenox Hill-Roosevelt Island
19-Aug,36061012601,1012601,15966,23414,39380,Manhattan,1015522.495,Upper East Side-Lenox Hill-Roosevelt Island
21-Aug,36061012601,1012601,11557,71,11628,Manhattan,1015522.495,Upper East Side-Lenox Hill-Roosevelt Island
19-May,36061012602,1012602,14666,121027,135693,Manhattan,960965.252,Upper East Side-Lenox Hill-Roosevelt Island
21-May,36061012602,1012602,9456,24643,34099,Manhattan,960965.252,Upper East Side-Lenox Hill-Roosevelt Island
19-Jun,36061012602,1012602,8749,33432,42181,Manhattan,960965.252,Upper East Side-Lenox Hill-Roosevelt Island
21-Jun,36061012602,1012602,3076,101994,105070,Manhattan,960965.252,Upper East Side-Lenox Hill-Roosevelt Island
19-Jul,36061012602,1012602,15350,58566,73916,Manhattan,960965.252,Upper East Side-Lenox Hill-Roosevelt Island
21-Jul,36061012602,1012602,11862,169830,181692,Manhattan,960965.252,Upper East Side-Lenox Hill-Roosevelt Island
19-Aug,36061012602,1012602,7377,88255,95632,Manhattan,960965.252,Upper East Side-Lenox Hill-Roosevelt Island
21-Aug,36061012602,1012602,3727,113942,117669,Manhattan,960965.252,Upper East Side-Lenox Hill-Roosevelt Island
19-May,36061012700,1012700,15292,69132,84424,Manhattan,1872371.16,Hell's Kitchen
21-May,36061012700,1012700,8470,129673,138143,Manhattan,1872371.16,Hell's Kitchen
19-Jun,36061012700,1012700,3113,56869,59982,Manhattan,1872371.16,Hell's Kitchen
21-Jun,36061012700,1012700,6931,48810,55741,Manhattan,1872371.16,Hell's Kitchen
19-Jul,36061012700,1012700,8322,103531,111853,Manhattan,1872371.16,Hell's Kitchen
21-Jul,36061012700,1012700,22805,44993,67798,Manhattan,1872371.16,Hell's Kitchen
19-Aug,36061012700,1012700,307,18767,19074,Manhattan,1872371.16,Hell's Kitchen
21-Aug,36061012700,1012700,7165,132048,139213,Manhattan,1872371.16,Hell's Kitchen
19-May,36061013000,1013000,4759,22333,27092,Manhattan,1918144.606,Upper East Side-Carnegie Hill
21-May,36061013000,1013000,4827,12569,17396,Manhattan,1918144.606,Upper East Side-Carnegie Hill
19-Jun,36061013000,1013000,6655,65474,72129,Manhattan,1918144.606,Upper East Side-Carnegie Hill
21-Jun,36061013000,1013000,9389,75812,85201,Manhattan,1918144.606,Upper East Side-Carnegie Hill
19-Jul,36061013000,1013000,4595,6573,11168,Manhattan,1918144.606,Upper East Side-Carnegie Hill
21-Jul,36061013000,1013000,0,70202,70202,Manhattan,1918144.606,Upper East Side-Carnegie Hill
19-Aug,36061013000,1013000,3362,30478,33840,Manhattan,1918144.606,Upper East Side-Carnegie Hill
21-Aug,36061013000,1013000,5348,110301,115649,Manhattan,1918144.606,Upper East Side-Carnegie Hill
19-May,36061013100,1013100,9100,2131,11231,Manhattan,1874645.766,Midtown-Times Square
21-May,36061013100,1013100,4207,111738,115945,Manhattan,1874645.766,Midtown-Times Square
19-Jun,36061013100,1013100,0,35284,35284,Manhattan,1874645.766,Midtown-Times Square
21-Jun,36061013100,1013100,9783,47060,56843,Manhattan,1874645.766,Midtown-Times Square
19-Jul,36061013100,1013100,6557,82315,88872,Manhattan,1874645.766,Midtown-Times Square
21-Jul,36061013100,1013100,3683,109602,113285,Manhattan,1874645.766,Midtown-Times Square
19-Aug,36061013100,1013100,12690,58024,70714,Manhattan,1874645.766,Midtown-Times Square
21-Aug,36061013100,1013100,11815,101781,113596,Manhattan,1874645.766,Midtown-Times Square
19-May,36061013201,1013201,5347,57989,63336,Manhattan,839787.9745,Upper East Side-Lenox Hill-Roosevelt Island
21-May,36061013201,1013201,75,52499,52574,Manhattan,839787.9745,Upper East Side-Lenox Hill-Roosevelt Island
19-Jun,36061013201,1013201,3719,149752,153471,Manhattan,839787.9745,Upper East Side-Lenox Hill-Roosevelt Island
21-Jun,36061013201,1013201,8011,59439,67450,Manhattan,839787.9745,Upper East Side-Lenox Hill-Roosevelt Island
19-Jul,36061013201,1013201,11617,30040,41657,Manhattan,839787.9745,Upper East Side-Lenox Hill-Roosevelt Island
21-Jul,36061013201,1013201,16383,61486,77869,Manhattan,839787.9745,Upper East Side-Lenox Hill-Roosevelt Island
19-Aug,36061013201,1013201,12576,60317,72893,Manhattan,839787.9745,Upper East Side-Lenox Hill-Roosevelt Island
21-Aug,36061013201,1013201,0,51990,51990,Manhattan,839787.9745,Upper East Side-Lenox Hill-Roosevelt Island
19-May,36061013202,1013202,9046,71,9117,Manhattan,727876.7049,Upper East Side-Lenox Hill-Roosevelt Island
21-May,36061013202,1013202,8606,61248,69854,Manhattan,727876.7049,Upper East Side-Lenox Hill-Roosevelt Island
19-Jun,36061013202,1013202,8372,71,8443,Manhattan,727876.7049,Upper East Side-Lenox Hill-Roosevelt Island
21-Jun,36061013202,1013202,7562,85984,93546,Manhattan,727876.7049,Upper East Side-Lenox Hill-Roosevelt Island
19-Jul,36061013202,1013202,11632,74290,85922,Manhattan,727876.7049,Upper East Side-Lenox Hill-Roosevelt Island
21-Jul,36061013202,1013202,7190,29823,37013,Manhattan,727876.7049,Upper East Side-Lenox Hill-Roosevelt Island
19-Aug,36061013202,1013202,15304,73078,88382,Manhattan,727876.7049,Upper East Side-Lenox Hill-Roosevelt Island
21-Aug,36061013202,1013202,7090,71,7161,Manhattan,727876.7049,Upper East Side-Lenox Hill-Roosevelt Island
19-May,36061013300,1013300,7588,42462,50050,Manhattan,1876670.072,Hell's Kitchen
21-May,36061013300,1013300,6460,95629,102089,Manhattan,1876670.072,Hell's Kitchen
19-Jun,36061013300,1013300,10839,4129,14968,Manhattan,1876670.072,Hell's Kitchen
21-Jun,36061013300,1013300,16351,59242,75593,Manhattan,1876670.072,Hell's Kitchen
19-Jul,36061013300,1013300,8104,119943,128047,Manhattan,1876670.072,Hell's Kitchen
21-Jul,36061013300,1013300,8778,64206,72984,Manhattan,1876670.072,Hell's Kitchen
19-Aug,36061013300,1013300,7783,81232,89015,Manhattan,1876670.072,Hell's Kitchen
21-Aug,36061013300,1013300,2400,88709,91109,Manhattan,1876670.072,Hell's Kitchen
19-May,36061013601,1013601,4858,75066,79924,Manhattan,400550.3163,Upper East Side-Yorkville
21-May,36061013601,1013601,7910,64594,72504,Manhattan,400550.3163,Upper East Side-Yorkville
19-Jun,36061013601,1013601,3075,70970,74045,Manhattan,400550.3163,Upper East Side-Yorkville
21-Jun,36061013601,1013601,13784,48123,61907,Manhattan,400550.3163,Upper East Side-Yorkville
19-Jul,36061013601,1013601,6691,37769,44460,Manhattan,400550.3163,Upper East Side-Yorkville
21-Jul,36061013601,1013601,7237,38077,45314,Manhattan,400550.3163,Upper East Side-Yorkville
19-Aug,36061013601,1013601,12665,60823,73488,Manhattan,400550.3163,Upper East Side-Yorkville
21-Aug,36061013601,1013601,12748,103974,116722,Manhattan,400550.3163,Upper East Side-Yorkville
19-May,36061013602,1013602,14077,5181,19258,Manhattan,607002.7552,Upper East Side-Yorkville
21-May,36061013602,1013602,3725,48960,52685,Manhattan,607002.7552,Upper East Side-Yorkville
19-Jun,36061013602,1013602,13540,35848,49388,Manhattan,607002.7552,Upper East Side-Yorkville
21-Jun,36061013602,1013602,13179,93752,106931,Manhattan,607002.7552,Upper East Side-Yorkville
19-Jul,36061013602,1013602,8342,99078,107420,Manhattan,607002.7552,Upper East Side-Yorkville
21-Jul,36061013602,1013602,2484,41668,44152,Manhattan,607002.7552,Upper East Side-Yorkville
19-Aug,36061013602,1013602,14717,36325,51042,Manhattan,607002.7552,Upper East Side-Yorkville
21-Aug,36061013602,1013602,8624,123132,131756,Manhattan,607002.7552,Upper East Side-Yorkville
19-May,36061014801,1014801,4232,33129,37361,Manhattan,559215.9796,Upper East Side-Carnegie Hill
21-May,36061014801,1014801,6018,97123,103141,Manhattan,559215.9796,Upper East Side-Carnegie Hill
19-Jun,36061014801,1014801,9549,97747,107296,Manhattan,559215.9796,Upper East Side-Carnegie Hill
21-Jun,36061014801,1014801,15392,40337,55729,Manhattan,559215.9796,Upper East Side-Carnegie Hill
19-Jul,36061014801,1014801,8565,52180,60745,Manhattan,559215.9796,Upper East Side-Carnegie Hill
21-Jul,36061014801,1014801,11895,45028,56923,Manhattan,559215.9796,Upper East Side-Carnegie Hill
19-Aug,36061014801,1014801,25296,121661,146957,Manhattan,559215.9796,Upper East Side-Carnegie Hill
21-Aug,36061014801,1014801,7304,135120,142424,Manhattan,559215.9796,Upper East Side-Carnegie Hill
19-May,36061014900,1014900,3297,114868,118165,Manhattan,1880350.197,Upper West Side-Lincoln Square
21-May,36061014900,1014900,16270,85008,101278,Manhattan,1880350.197,Upper West Side-Lincoln Square
19-Jun,36061014900,1014900,9585,42337,51922,Manhattan,1880350.197,Upper West Side-Lincoln Square
21-Jun,36061014900,1014900,3452,103610,107062,Manhattan,1880350.197,Upper West Side-Lincoln Square
19-Jul,36061014900,1014900,2451,65947,68398,Manhattan,1880350.197,Upper West Side-Lincoln Square
21-Jul,36061014900,1014900,9304,13970,23274,Manhattan,1880350.197,Upper West Side-Lincoln Square
19-Aug,36061014900,1014900,4115,56166,60281,Manhattan,1880350.197,Upper West Side-Lincoln Square
21-Aug,36061014900,1014900,4754,53991,58745,Manhattan,1880350.197,Upper West Side-Lincoln Square
19-May,36061015001,1015001,16554,103288,119842,Manhattan,556354.4604,Upper East Side-Carnegie Hill
21-May,36061015001,1015001,12497,48848,61345,Manhattan,556354.4604,Upper East Side-Carnegie Hill
19-Jun,36061015001,1015001,4047,59900,63947,Manhattan,556354.4604,Upper East Side-Carnegie Hill
21-Jun,36061015001,1015001,0,10738,10738,Manhattan,556354.4604,Upper East Side-Carnegie Hill
19-Jul,36061015001,1015001,11540,85899,97439,Manhattan,556354.4604,Upper East Side-Carnegie Hill
21-Jul,36061015001,1015001,12629,74910,87539,Manhattan,556354.4604,Upper East Side-Carnegie Hill
19-Aug,36061015001,1015001,9931,44115,54046,Manhattan,556354.4604,Upper East Side-Carnegie Hill
21-Aug,36061015001,1015001,1346,124974,126320,Manhattan,556354.4604,Upper East Side-Carnegie Hill
19-May,36061015002,1015002,14127,80838,94965,Manhattan,1352304.146,Upper East Side-Carnegie Hill
21-May,36061015002,1015002,15017,82489,97506,Manhattan,1352304.146,Upper East Side-Carnegie Hill
19-Jun,36061015002,1015002,6594,112780,119374,Manhattan,1352304.146,Upper East Side-Carnegie Hill
21-Jun,36061015002,1015002,9289,62651,71940,Manhattan,1352304.146,Upper East Side-Carnegie Hill
19-Jul,36061015002,1015002,11670,111625,123295,Manhattan,1352304.146,Upper East Side-Carnegie Hill
21-Jul,36061015002,1015002,5939,121988,127927,Manhattan,1352304.146,Upper East Side-Carnegie Hill
19-Aug,36061015002,1015002,9390,50118,59508,Manhattan,1352304.146,Upper East Side-Carnegie Hill
21-Aug,36061015002,1015002,6694,105086,111780,Manhattan,1352304.146,Upper East Side-Carnegie Hill
19-May,36061015101,1015101,2688,57209,59897,Manhattan,1179802.657,Upper West Side-Lincoln Square
21-May,36061015101,1015101,19341,135377,154718,Manhattan,1179802.657,Upper West Side-Lincoln Square
19-Jun,36061015101,1015101,14622,32400,47022,Manhattan,1179802.657,Upper West Side-Lincoln Square
21-Jun,36061015101,1015101,15865,77964,93829,Manhattan,1179802.657,Upper West Side-Lincoln Square
19-Jul,36061015101,1015101,2765,91380,94145,Manhattan,1179802.657,Upper West Side-Lincoln Square
21-Jul,36061015101,1015101,13585,73482,87067,Manhattan,1179802.657,Upper West Side-Lincoln Square
19-Aug,36061015101,1015101,10626,71,10697,Manhattan,1179802.657,Upper West Side-Lincoln Square
21-Aug,36061015101,1015101,8593,87299,95892,Manhattan,1179802.657,Upper West Side-Lincoln Square
19-May,36061015301,1015301,4653,22731,27384,Manhattan,934986.5519,Upper West Side-Lincoln Square
21-May,36061015301,1015301,778,70727,71505,Manhattan,934986.5519,Upper West Side-Lincoln Square
19-Jun,36061015301,1015301,3790,91427,95217,Manhattan,934986.5519,Upper West Side-Lincoln Square
21-Jun,36061015301,1015301,12794,102727,115521,Manhattan,934986.5519,Upper West Side-Lincoln Square
19-Jul,36061015301,1015301,12192,107095,119287,Manhattan,934986.5519,Upper West Side-Lincoln Square
21-Jul,36061015301,1015301,6381,86590,92971,Manhattan,934986.5519,Upper West Side-Lincoln Square
19-Aug,36061015301,1015301,16676,43097,59773,Manhattan,934986.5519,Upper West Side-Lincoln Square
21-Aug,36061015301,1015301,9788,71,9859,Manhattan,934986.5519,Upper West Side-Lincoln Square
19-May,36061015302,1015302,5280,56255,61535,Manhattan,938455.1675,Upper West Side-Lincoln Square
21-May,36061015302,1015302,10237,61209,71446,Manhattan,938455.1675,Upper West Side-Lincoln Square
19-Jun,36061015302,1015302,7528,129659,137187,Manhattan,938455.1675,Upper West Side-Lincoln Square
21-Jun,36061015302,1015302,0,85922,85922,Manhattan,938455.1675,Upper West Side-Lincoln Square
19-Jul,36061015302,1015302,11661,29028,40689,Manhattan,938455.1675,Upper West Side-Lincoln Square
21-Jul,36061015302,1015302,8110,84111,92221,Manhattan,938455.1675,Upper West Side-Lincoln Square
19-Aug,36061015302,1015302,7456,46793,54249,Manhattan,938455.1675,Upper West Side-Lincoln Square
21-Aug,36061015302,1015302,17558,55509,73067,Manhattan,938455.1675,Upper West Side-Lincoln Square
19-May,36061015401,1015401,8033,51886,59919,Manhattan,763019.6869,Upper East Side-Yorkville
21-May,36061015401,1015401,4115,88809,92924,Manhattan,763019.6869,Upper East Side-Yorkville
19-Jun,36061015401,1015401,6605,72020,78625,Manhattan,763019.6869,Upper East Side-Yorkville
21-Jun,36061015401,1015401,3886,47865,51751,Manhattan,763019.6869,Upper East Side-Yorkville
19-Jul,36061015401,1015401,171,44122,44293,Manhattan,763019.6869,Upper East Side-Yorkville
21-Jul,36061015401,1015401,3555,23144,26699,Manhattan,763019.6869,Upper East Side-Yorkville
19-Aug,36061015401,1015401,12091,86543,98634,Manhattan,763019.6869,Upper East Side-Yorkville
21-Aug,36061015401,1015401,1980,58048,60028,Manhattan,763019.6869,Upper East Side-Yorkville
19-May,36061015402,1015402,14010,58559,72569,Manhattan,590439.3481,Upper East Side-Yorkville
21-May,36061015402,1015402,9348,61007,70355,Manhattan,590439.3481,Upper East Side-Yorkville
19-Jun,36061015402,1015402,3351,63672,67023,Manhattan,590439.3481,Upper East Side-Yorkville
21-Jun,36061015402,1015402,8165,39537,47702,Manhattan,590439.3481,Upper East Side-Yorkville
19-Jul,36061015402,1015402,9298,43949,53247,Manhattan,590439.3481,Upper East Side-Yorkville
21-Jul,36061015402,1015402,7551,98852,106403,Manhattan,590439.3481,Upper East Side-Yorkville
19-Aug,36061015402,1015402,5360,49407,54767,Manhattan,590439.3481,Upper East Side-Yorkville
21-Aug,36061015402,1015402,2355,68677,71032,Manhattan,590439.3481,Upper East Side-Yorkville
19-May,36061015403,1015403,7078,75016,82094,Manhattan,555763.3132,Upper East Side-Yorkville
21-May,36061015403,1015403,8667,44997,53664,Manhattan,555763.3132,Upper East Side-Yorkville
19-Jun,36061015403,1015403,7596,43975,51571,Manhattan,555763.3132,Upper East Side-Yorkville
21-Jun,36061015403,1015403,8100,60144,68244,Manhattan,555763.3132,Upper East Side-Yorkville
19-Jul,36061015403,1015403,11572,86417,97989,Manhattan,555763.3132,Upper East Side-Yorkville
21-Jul,36061015403,1015403,1402,83997,85399,Manhattan,555763.3132,Upper East Side-Yorkville
19-Aug,36061015403,1015403,12386,76751,89137,Manhattan,555763.3132,Upper East Side-Yorkville
21-Aug,36061015403,1015403,22801,85521,108322,Manhattan,555763.3132,Upper East Side-Yorkville
19-May,36061015501,1015501,17292,45044,62336,Manhattan,928265.5383,Upper West Side-Lincoln Square
21-May,36061015501,1015501,4419,23063,27482,Manhattan,928265.5383,Upper West Side-Lincoln Square
19-Jun,36061015501,1015501,9849,122931,132780,Manhattan,928265.5383,Upper West Side-Lincoln Square
21-Jun,36061015501,1015501,9706,99688,109394,Manhattan,928265.5383,Upper West Side-Lincoln Square
19-Jul,36061015501,1015501,9753,65440,75193,Manhattan,928265.5383,Upper West Side-Lincoln Square
21-Jul,36061015501,1015501,11956,74131,86087,Manhattan,928265.5383,Upper West Side-Lincoln Square
19-Aug,36061015501,1015501,3090,65970,69060,Manhattan,928265.5383,Upper West Side-Lincoln Square
21-Aug,36061015501,1015501,5419,43259,48678,Manhattan,928265.5383,Upper West Side-Lincoln Square
19-May,36061015601,1015601,76,33464,33540,Manhattan,791936.9649,Upper East Side-Yorkville
21-May,36061015601,1015601,5769,38194,43963,Manhattan,791936.9649,Upper East Side-Yorkville
19-Jun,36061015601,1015601,9542,55758,65300,Manhattan,791936.9649,Upper East Side-Yorkville
21-Jun,36061015601,1015601,13402,41129,54531,Manhattan,791936.9649,Upper East Side-Yorkville
19-Jul,36061015601,1015601,11927,139183,151110,Manhattan,791936.9649,Upper East Side-Yorkville
21-Jul,36061015601,1015601,3319,37051,40370,Manhattan,791936.9649,Upper East Side-Yorkville
19-Aug,36061015601,1015601,8773,71,8844,Manhattan,791936.9649,Upper East Side-Yorkville
21-Aug,36061015601,1015601,7369,83612,90981,Manhattan,791936.9649,Upper East Side-Yorkville
19-May,36061015602,1015602,12273,61099,73372,Manhattan,1169910.016,East Harlem (South)
21-May,36061015602,1015602,8618,134568,143186,Manhattan,1169910.016,East Harlem (South)
19-Jun,36061015602,1015602,13856,71,13927,Manhattan,1169910.016,East Harlem (South)
21-Jun,36061015602,1015602,20454,95809,116263,Manhattan,1169910.016,East Harlem (South)
19-Jul,36061015602,1015602,12127,58845,70972,Manhattan,1169910.016,East Harlem (South)
21-Jul,36061015602,1015602,8127,158787,166914,Manhattan,1169910.016,East Harlem (South)
19-Aug,36061015602,1015602,11706,67371,79077,Manhattan,1169910.016,East Harlem (South)
21-Aug,36061015602,1015602,9512,117126,126638,Manhattan,1169910.016,East Harlem (South)
19-May,36061015700,1015700,3235,79958,83193,Manhattan,1958586.74,Upper West Side-Lincoln Square
21-May,36061015700,1015700,16038,71,16109,Manhattan,1958586.74,Upper West Side-Lincoln Square
19-Jun,36061015700,1015700,10760,27831,38591,Manhattan,1958586.74,Upper West Side-Lincoln Square
21-Jun,36061015700,1015700,13399,34836,48235,Manhattan,1958586.74,Upper West Side-Lincoln Square
19-Jul,36061015700,1015700,13863,66760,80623,Manhattan,1958586.74,Upper West Side-Lincoln Square
21-Jul,36061015700,1015700,4150,29369,33519,Manhattan,1958586.74,Upper West Side-Lincoln Square
19-Aug,36061015700,1015700,2436,78418,80854,Manhattan,1958586.74,Upper West Side-Lincoln Square
21-Aug,36061015700,1015700,22077,76394,98471,Manhattan,1958586.74,Upper West Side-Lincoln Square
19-May,36061015801,1015801,2214,111524,113738,Manhattan,1353075.762,Upper East Side-Carnegie Hill
21-May,36061015801,1015801,2875,71,2946,Manhattan,1353075.762,Upper East Side-Carnegie Hill
19-Jun,36061015801,1015801,11875,80352,92227,Manhattan,1353075.762,Upper East Side-Carnegie Hill
21-Jun,36061015801,1015801,4916,40696,45612,Manhattan,1353075.762,Upper East Side-Carnegie Hill
19-Jul,36061015801,1015801,8021,92591,100612,Manhattan,1353075.762,Upper East Side-Carnegie Hill
21-Jul,36061015801,1015801,10354,15376,25730,Manhattan,1353075.762,Upper East Side-Carnegie Hill
19-Aug,36061015801,1015801,15019,74002,89021,Manhattan,1353075.762,Upper East Side-Carnegie Hill
21-Aug,36061015801,1015801,16020,11228,27248,Manhattan,1353075.762,Upper East Side-Carnegie Hill
19-May,36061015802,1015802,6167,132509,138676,Manhattan,551587.6442,East Harlem (South)
21-May,36061015802,1015802,11350,45991,57341,Manhattan,551587.6442,East Harlem (South)
19-Jun,36061015802,1015802,6405,72749,79154,Manhattan,551587.6442,East Harlem (South)
21-Jun,36061015802,1015802,14175,38469,52644,Manhattan,551587.6442,East Harlem (South)
19-Jul,36061015802,1015802,4256,110411,114667,Manhattan,551587.6442,East Harlem (South)
21-Jul,36061015802,1015802,10448,66004,76452,Manhattan,551587.6442,East Harlem (South)
19-Aug,36061015802,1015802,6099,49911,56010,Manhattan,551587.6442,East Harlem (South)
21-Aug,36061015802,1015802,12782,28808,41590,Manhattan,551587.6442,East Harlem (South)
19-May,36061016001,1016001,12612,73017,85629,Manhattan,1352632.298,Upper East Side-Carnegie Hill
21-May,36061016001,1016001,6284,79424,85708,Manhattan,1352632.298,Upper East Side-Carnegie Hill
19-Jun,36061016001,1016001,6212,75269,81481,Manhattan,1352632.298,Upper East Side-Carnegie Hill
21-Jun,36061016001,1016001,4714,81557,86271,Manhattan,1352632.298,Upper East Side-Carnegie Hill
19-Jul,36061016001,1016001,10346,24558,34904,Manhattan,1352632.298,Upper East Side-Carnegie Hill
21-Jul,36061016001,1016001,12014,69992,82006,Manhattan,1352632.298,Upper East Side-Carnegie Hill
19-Aug,36061016001,1016001,12187,88292,100479,Manhattan,1352632.298,Upper East Side-Carnegie Hill
21-Aug,36061016001,1016001,0,52817,52817,Manhattan,1352632.298,Upper East Side-Carnegie Hill
19-May,36061016100,1016100,7208,80478,87686,Manhattan,1677359.665,Upper West Side (Central)
21-May,36061016100,1016100,5165,82835,88000,Manhattan,1677359.665,Upper West Side (Central)
19-Jun,36061016100,1016100,5598,69566,75164,Manhattan,1677359.665,Upper West Side (Central)
21-Jun,36061016100,1016100,7921,110418,118339,Manhattan,1677359.665,Upper West Side (Central)
19-Jul,36061016100,1016100,7064,40035,47099,Manhattan,1677359.665,Upper West Side (Central)
21-Jul,36061016100,1016100,5431,45108,50539,Manhattan,1677359.665,Upper West Side (Central)
19-Aug,36061016100,1016100,11923,145951,157874,Manhattan,1677359.665,Upper West Side (Central)
21-Aug,36061016100,1016100,8942,97183,106125,Manhattan,1677359.665,Upper West Side (Central)
19-May,36061016200,1016200,9830,62683,72513,Manhattan,2927429.509,East Harlem (South)
21-May,36061016200,1016200,7531,49238,56769,Manhattan,2927429.509,East Harlem (South)
19-Jun,36061016200,1016200,2775,22510,25285,Manhattan,2927429.509,East Harlem (South)
21-Jun,36061016200,1016200,7802,21886,29688,Manhattan,2927429.509,East Harlem (South)
19-Jul,36061016200,1016200,10429,18697,29126,Manhattan,2927429.509,East Harlem (South)
21-Jul,36061016200,1016200,7948,36072,44020,Manhattan,2927429.509,East Harlem (South)
19-Aug,36061016200,1016200,12577,34864,47441,Manhattan,2927429.509,East Harlem (South)
21-Aug,36061016200,1016200,4350,90904,95254,Manhattan,2927429.509,East Harlem (South)
19-May,36061016400,1016400,12701,64428,77129,Manhattan,1911300.531,East Harlem (South)
21-May,36061016400,1016400,3609,81908,85517,Manhattan,1911300.531,East Harlem (South)
19-Jun,36061016400,1016400,10584,33173,43757,Manhattan,1911300.531,East Harlem (South)
21-Jun,36061016400,1016400,3183,55813,58996,Manhattan,1911300.531,East Harlem (South)
19-Jul,36061016400,1016400,15509,123655,139164,Manhattan,1911300.531,East Harlem (South)
21-Jul,36061016400,1016400,0,66755,66755,Manhattan,1911300.531,East Harlem (South)
19-Aug,36061016400,1016400,12624,50571,63195,Manhattan,1911300.531,East Harlem (South)
21-Aug,36061016400,1016400,12281,31278,43559,Manhattan,1911300.531,East Harlem (South)
19-May,36061016500,1016500,9704,78200,87904,Manhattan,2199114.6,Upper West Side (Central)
21-May,36061016500,1016500,4856,49147,54003,Manhattan,2199114.6,Upper West Side (Central)
19-Jun,36061016500,1016500,9426,123373,132799,Manhattan,2199114.6,Upper West Side (Central)
21-Jun,36061016500,1016500,5962,71,6033,Manhattan,2199114.6,Upper West Side (Central)
19-Jul,36061016500,1016500,10139,69445,79584,Manhattan,2199114.6,Upper West Side (Central)
21-Jul,36061016500,1016500,13937,85287,99224,Manhattan,2199114.6,Upper West Side (Central)
19-Aug,36061016500,1016500,17709,12620,30329,Manhattan,2199114.6,Upper West Side (Central)
21-Aug,36061016500,1016500,0,35718,35718,Manhattan,2199114.6,Upper West Side (Central)
19-May,36061016600,1016600,9281,103440,112721,Manhattan,1871913.936,East Harlem (South)
21-May,36061016600,1016600,3553,171281,174834,Manhattan,1871913.936,East Harlem (South)
19-Jun,36061016600,1016600,15559,117255,132814,Manhattan,1871913.936,East Harlem (South)
21-Jun,36061016600,1016600,711,83766,84477,Manhattan,1871913.936,East Harlem (South)
19-Jul,36061016600,1016600,12561,47626,60187,Manhattan,1871913.936,East Harlem (South)
21-Jul,36061016600,1016600,6142,39799,45941,Manhattan,1871913.936,East Harlem (South)
19-Aug,36061016600,1016600,12676,161949,174625,Manhattan,1871913.936,East Harlem (South)
21-Aug,36061016600,1016600,11708,58032,69740,Manhattan,1871913.936,East Harlem (South)
19-May,36061016900,1016900,14773,164734,179507,Manhattan,1937087.88,Upper West Side (Central)
21-May,36061016900,1016900,20512,93945,114457,Manhattan,1937087.88,Upper West Side (Central)
19-Jun,36061016900,1016900,15396,55823,71219,Manhattan,1937087.88,Upper West Side (Central)
21-Jun,36061016900,1016900,1714,108321,110035,Manhattan,1937087.88,Upper West Side (Central)
19-Jul,36061016900,1016900,8885,6330,15215,Manhattan,1937087.88,Upper West Side (Central)
21-Jul,36061016900,1016900,8393,64176,72569,Manhattan,1937087.88,Upper West Side (Central)
19-Aug,36061016900,1016900,7491,98970,106461,Manhattan,1937087.88,Upper West Side (Central)
21-Aug,36061016900,1016900,11199,46734,57933,Manhattan,1937087.88,Upper West Side (Central)
19-May,36061017000,1017000,20507,147655,168162,Manhattan,1969157.887,East Harlem (South)
21-May,36061017000,1017000,15702,59271,74973,Manhattan,1969157.887,East Harlem (South)
19-Jun,36061017000,1017000,0,65210,65210,Manhattan,1969157.887,East Harlem (South)
21-Jun,36061017000,1017000,6080,113918,119998,Manhattan,1969157.887,East Harlem (South)
19-Jul,36061017000,1017000,6893,79633,86526,Manhattan,1969157.887,East Harlem (South)
21-Jul,36061017000,1017000,8888,124102,132990,Manhattan,1969157.887,East Harlem (South)
19-Aug,36061017000,1017000,5057,29541,34598,Manhattan,1969157.887,East Harlem (South)
21-Aug,36061017000,1017000,13246,93195,106441,Manhattan,1969157.887,East Harlem (South)
19-May,36061017100,1017100,11614,65884,77498,Manhattan,2262383.014,Upper West Side (Central)
21-May,36061017100,1017100,11319,68572,79891,Manhattan,2262383.014,Upper West Side (Central)
19-Jun,36061017100,1017100,11630,45125,56755,Manhattan,2262383.014,Upper West Side (Central)
21-Jun,36061017100,1017100,1535,56554,58089,Manhattan,2262383.014,Upper West Side (Central)
19-Jul,36061017100,1017100,10326,71,10397,Manhattan,2262383.014,Upper West Side (Central)
21-Jul,36061017100,1017100,10230,60317,70547,Manhattan,2262383.014,Upper West Side (Central)
19-Aug,36061017100,1017100,15160,86110,101270,Manhattan,2262383.014,Upper West Side (Central)
21-Aug,36061017100,1017100,13470,41609,55079,Manhattan,2262383.014,Upper West Side (Central)
19-May,36061017200,1017200,1011,43666,44677,Manhattan,1912754.756,East Harlem (South)
21-May,36061017200,1017200,4206,138668,142874,Manhattan,1912754.756,East Harlem (South)
19-Jun,36061017200,1017200,14153,89000,103153,Manhattan,1912754.756,East Harlem (South)
21-Jun,36061017200,1017200,14776,119377,134153,Manhattan,1912754.756,East Harlem (South)
19-Jul,36061017200,1017200,1563,77370,78933,Manhattan,1912754.756,East Harlem (South)
21-Jul,36061017200,1017200,4137,106143,110280,Manhattan,1912754.756,East Harlem (South)
19-Aug,36061017200,1017200,3915,95907,99822,Manhattan,1912754.756,East Harlem (South)
21-Aug,36061017200,1017200,7533,49632,57165,Manhattan,1912754.756,East Harlem (South)
19-May,36061017300,1017300,10645,55509,66154,Manhattan,1921881.193,Upper West Side (Central)
21-May,36061017300,1017300,464,82215,82679,Manhattan,1921881.193,Upper West Side (Central)
19-Jun,36061017300,1017300,5035,103693,108728,Manhattan,1921881.193,Upper West Side (Central)
21-Jun,36061017300,1017300,6494,45230,51724,Manhattan,1921881.193,Upper West Side (Central)
19-Jul,36061017300,1017300,9053,8556,17609,Manhattan,1921881.193,Upper West Side (Central)
21-Jul,36061017300,1017300,10795,99872,110667,Manhattan,1921881.193,Upper West Side (Central)
19-Aug,36061017300,1017300,16428,71,16499,Manhattan,1921881.193,Upper West Side (Central)
21-Aug,36061017300,1017300,3292,28494,31786,Manhattan,1921881.193,Upper West Side (Central)
19-May,36061017401,1017401,10309,72807,83116,Manhattan,1086203.709,East Harlem (South)
21-May,36061017401,1017401,8981,80949,89930,Manhattan,1086203.709,East Harlem (South)
19-Jun,36061017401,1017401,17028,56866,73894,Manhattan,1086203.709,East Harlem (South)
21-Jun,36061017401,1017401,9018,87300,96318,Manhattan,1086203.709,East Harlem (South)
19-Jul,36061017401,1017401,2106,10964,13070,Manhattan,1086203.709,East Harlem (South)
21-Jul,36061017401,1017401,4858,150733,155591,Manhattan,1086203.709,East Harlem (South)
19-Aug,36061017401,1017401,12967,42296,55263,Manhattan,1086203.709,East Harlem (South)
21-Aug,36061017401,1017401,8017,106205,114222,Manhattan,1086203.709,East Harlem (South)
19-May,36061017402,1017402,0,32673,32673,Manhattan,547579.1267,East Harlem (South)
21-May,36061017402,1017402,4535,77834,82369,Manhattan,547579.1267,East Harlem (South)
19-Jun,36061017402,1017402,7539,102364,109903,Manhattan,547579.1267,East Harlem (South)
21-Jun,36061017402,1017402,10288,76781,87069,Manhattan,547579.1267,East Harlem (South)
19-Jul,36061017402,1017402,4903,50064,54967,Manhattan,547579.1267,East Harlem (South)
21-Jul,36061017402,1017402,14220,41359,55579,Manhattan,547579.1267,East Harlem (South)
19-Aug,36061017402,1017402,5179,37933,43112,Manhattan,547579.1267,East Harlem (South)
21-Aug,36061017402,1017402,6095,116604,122699,Manhattan,547579.1267,East Harlem (South)
19-May,36061017500,1017500,7850,69349,77199,Manhattan,2318094.023,Upper West Side (Central)
21-May,36061017500,1017500,1809,67581,69390,Manhattan,2318094.023,Upper West Side (Central)
19-Jun,36061017500,1017500,12008,74113,86121,Manhattan,2318094.023,Upper West Side (Central)
21-Jun,36061017500,1017500,5027,52987,58014,Manhattan,2318094.023,Upper West Side (Central)
19-Jul,36061017500,1017500,8820,71331,80151,Manhattan,2318094.023,Upper West Side (Central)
21-Jul,36061017500,1017500,8024,52399,60423,Manhattan,2318094.023,Upper West Side (Central)
19-Aug,36061017500,1017500,9797,83501,93298,Manhattan,2318094.023,Upper West Side (Central)
21-Aug,36061017500,1017500,8327,102050,110377,Manhattan,2318094.023,Upper West Side (Central)
19-May,36061017700,1017700,3372,44650,48022,Manhattan,1878929.747,Upper West Side (Central)
21-May,36061017700,1017700,11529,105187,116716,Manhattan,1878929.747,Upper West Side (Central)
19-Jun,36061017700,1017700,7515,33173,40688,Manhattan,1878929.747,Upper West Side (Central)
21-Jun,36061017700,1017700,3465,68096,71561,Manhattan,1878929.747,Upper West Side (Central)
19-Jul,36061017700,1017700,8543,123525,132068,Manhattan,1878929.747,Upper West Side (Central)
21-Jul,36061017700,1017700,8836,1815,10651,Manhattan,1878929.747,Upper West Side (Central)
19-Aug,36061017700,1017700,7626,32923,40549,Manhattan,1878929.747,Upper West Side (Central)
21-Aug,36061017700,1017700,3990,53903,57893,Manhattan,1878929.747,Upper West Side (Central)
19-May,36061018000,1018000,10578,71,10649,Manhattan,2287541.257,East Harlem (North)
21-May,36061018000,1018000,1926,88160,90086,Manhattan,2287541.257,East Harlem (North)
19-Jun,36061018000,1018000,8404,43685,52089,Manhattan,2287541.257,East Harlem (North)
21-Jun,36061018000,1018000,3087,20250,23337,Manhattan,2287541.257,East Harlem (North)
19-Jul,36061018000,1018000,17394,111533,128927,Manhattan,2287541.257,East Harlem (North)
21-Jul,36061018000,1018000,15016,164967,179983,Manhattan,2287541.257,East Harlem (North)
19-Aug,36061018000,1018000,10531,52758,63289,Manhattan,2287541.257,East Harlem (North)
21-Aug,36061018000,1018000,13777,96540,110317,Manhattan,2287541.257,East Harlem (North)
19-May,36061018100,1018100,13351,55906,69257,Manhattan,1489902.893,Upper West Side (Central)
21-May,36061018100,1018100,9662,101317,110979,Manhattan,1489902.893,Upper West Side (Central)
19-Jun,36061018100,1018100,7766,71,7837,Manhattan,1489902.893,Upper West Side (Central)
21-Jun,36061018100,1018100,7078,62728,69806,Manhattan,1489902.893,Upper West Side (Central)
19-Jul,36061018100,1018100,11718,24515,36233,Manhattan,1489902.893,Upper West Side (Central)
21-Jul,36061018100,1018100,7553,25428,32981,Manhattan,1489902.893,Upper West Side (Central)
19-Aug,36061018100,1018100,12904,82152,95056,Manhattan,1489902.893,Upper West Side (Central)
21-Aug,36061018100,1018100,0,74012,74012,Manhattan,1489902.893,Upper West Side (Central)
19-May,36061018400,1018400,11086,73070,84156,Manhattan,1903568.419,East Harlem (North)
21-May,36061018400,1018400,0,64286,64286,Manhattan,1903568.419,East Harlem (North)
19-Jun,36061018400,1018400,0,71,71,Manhattan,1903568.419,East Harlem (North)
21-Jun,36061018400,1018400,8009,124027,132036,Manhattan,1903568.419,East Harlem (North)
19-Jul,36061018400,1018400,15483,71,15554,Manhattan,1903568.419,East Harlem (North)
21-Jul,36061018400,1018400,14018,27924,41942,Manhattan,1903568.419,East Harlem (North)
19-Aug,36061018400,1018400,9020,31334,40354,Manhattan,1903568.419,East Harlem (North)
21-Aug,36061018400,1018400,3461,63803,67264,Manhattan,1903568.419,East Harlem (North)
19-May,36061018600,1018600,14004,40671,54675,Manhattan,1311722.331,Harlem (South)
21-May,36061018600,1018600,13983,96353,110336,Manhattan,1311722.331,Harlem (South)
19-Jun,36061018600,1018600,8106,112787,120893,Manhattan,1311722.331,Harlem (South)
21-Jun,36061018600,1018600,11792,40290,52082,Manhattan,1311722.331,Harlem (South)
19-Jul,36061018600,1018600,16829,26350,43179,Manhattan,1311722.331,Harlem (South)
21-Jul,36061018600,1018600,11251,74557,85808,Manhattan,1311722.331,Harlem (South)
19-Aug,36061018600,1018600,7335,123569,130904,Manhattan,1311722.331,Harlem (South)
21-Aug,36061018600,1018600,13371,50969,64340,Manhattan,1311722.331,Harlem (South)
19-May,36061018700,1018700,8078,80752,88830,Manhattan,2323892.254,Upper West Side-Manhattan Valley
21-May,36061018700,1018700,9640,117851,127491,Manhattan,2323892.254,Upper West Side-Manhattan Valley
19-Jun,36061018700,1018700,10788,71,10859,Manhattan,2323892.254,Upper West Side-Manhattan Valley
21-Jun,36061018700,1018700,2454,96972,99426,Manhattan,2323892.254,Upper West Side-Manhattan Valley
19-Jul,36061018700,1018700,4473,109342,113815,Manhattan,2323892.254,Upper West Side-Manhattan Valley
21-Jul,36061018700,1018700,15476,118086,133562,Manhattan,2323892.254,Upper West Side-Manhattan Valley
19-Aug,36061018700,1018700,11554,14837,26391,Manhattan,2323892.254,Upper West Side-Manhattan Valley
21-Aug,36061018700,1018700,15692,107943,123635,Manhattan,2323892.254,Upper West Side-Manhattan Valley
19-May,36061019300,1019300,2686,72894,75580,Manhattan,1892879.105,Upper West Side-Manhattan Valley
21-May,36061019300,1019300,2333,79076,81409,Manhattan,1892879.105,Upper West Side-Manhattan Valley
19-Jun,36061019300,1019300,12061,29530,41591,Manhattan,1892879.105,Upper West Side-Manhattan Valley
21-Jun,36061019300,1019300,13832,87098,100930,Manhattan,1892879.105,Upper West Side-Manhattan Valley
19-Jul,36061019300,1019300,6235,138243,144478,Manhattan,1892879.105,Upper West Side-Manhattan Valley
21-Jul,36061019300,1019300,4184,160107,164291,Manhattan,1892879.105,Upper West Side-Manhattan Valley
19-Aug,36061019300,1019300,1025,89261,90286,Manhattan,1892879.105,Upper West Side-Manhattan Valley
21-Aug,36061019300,1019300,12662,50679,63341,Manhattan,1892879.105,Upper West Side-Manhattan Valley
19-May,36061019600,1019600,3165,111558,114723,Manhattan,1902453.312,East Harlem (North)
21-May,36061019600,1019600,11152,135679,146831,Manhattan,1902453.312,East Harlem (North)
19-Jun,36061019600,1019600,0,52687,52687,Manhattan,1902453.312,East Harlem (North)
21-Jun,36061019600,1019600,7899,48805,56704,Manhattan,1902453.312,East Harlem (North)
19-Jul,36061019600,1019600,0,113797,113797,Manhattan,1902453.312,East Harlem (North)
21-Jul,36061019600,1019600,7848,95700,103548,Manhattan,1902453.312,East Harlem (North)
19-Aug,36061019600,1019600,5943,62510,68453,Manhattan,1902453.312,East Harlem (North)
21-Aug,36061019600,1019600,14861,47177,62038,Manhattan,1902453.312,East Harlem (North)
19-May,36061019702,1019702,4328,71,4399,Manhattan,509562.3303,Harlem (South)
21-May,36061019702,1019702,1812,118401,120213,Manhattan,509562.3303,Harlem (South)
19-Jun,36061019702,1019702,9942,80896,90838,Manhattan,509562.3303,Harlem (South)
21-Jun,36061019702,1019702,6776,103225,110001,Manhattan,509562.3303,Harlem (South)
19-Jul,36061019702,1019702,9776,97238,107014,Manhattan,509562.3303,Harlem (South)
21-Jul,36061019702,1019702,8754,98492,107246,Manhattan,509562.3303,Harlem (South)
19-Aug,36061019702,1019702,13466,111495,124961,Manhattan,509562.3303,Harlem (South)
21-Aug,36061019702,1019702,2754,38989,41743,Manhattan,509562.3303,Harlem (South)
19-May,36061019900,1019900,8313,110554,118867,Manhattan,2406577.223,Morningside Heights
21-May,36061019900,1019900,8090,47490,55580,Manhattan,2406577.223,Morningside Heights
19-Jun,36061019900,1019900,8501,86666,95167,Manhattan,2406577.223,Morningside Heights
21-Jun,36061019900,1019900,3722,81745,85467,Manhattan,2406577.223,Morningside Heights
19-Jul,36061019900,1019900,7374,65998,73372,Manhattan,2406577.223,Morningside Heights
21-Jul,36061019900,1019900,4200,53464,57664,Manhattan,2406577.223,Morningside Heights
19-Aug,36061019900,1019900,10295,49219,59514,Manhattan,2406577.223,Morningside Heights
21-Aug,36061019900,1019900,7722,66776,74498,Manhattan,2406577.223,Morningside Heights
19-May,36061020500,1020500,6499,61627,68126,Manhattan,2977095.904,Morningside Heights
21-May,36061020500,1020500,2784,88959,91743,Manhattan,2977095.904,Morningside Heights
19-Jun,36061020500,1020500,8785,119084,127869,Manhattan,2977095.904,Morningside Heights
21-Jun,36061020500,1020500,5888,100931,106819,Manhattan,2977095.904,Morningside Heights
19-Jul,36061020500,1020500,6733,91267,98000,Manhattan,2977095.904,Morningside Heights
21-Jul,36061020500,1020500,7858,60865,68723,Manhattan,2977095.904,Morningside Heights
19-Aug,36061020500,1020500,5234,44818,50052,Manhattan,2977095.904,Morningside Heights
21-Aug,36061020500,1020500,7420,92247,99667,Manhattan,2977095.904,Morningside Heights
19-May,36061020600,1020600,11706,21474,33180,Manhattan,1602693.86,East Harlem (North)
21-May,36061020600,1020600,2258,42337,44595,Manhattan,1602693.86,East Harlem (North)
19-Jun,36061020600,1020600,4607,49880,54487,Manhattan,1602693.86,East Harlem (North)
21-Jun,36061020600,1020600,13522,57355,70877,Manhattan,1602693.86,East Harlem (North)
19-Jul,36061020600,1020600,8500,149853,158353,Manhattan,1602693.86,East Harlem (North)
21-Jul,36061020600,1020600,9719,80584,90303,Manhattan,1602693.86,East Harlem (North)
19-Aug,36061020600,1020600,2012,68974,70986,Manhattan,1602693.86,East Harlem (North)
21-Aug,36061020600,1020600,3186,92906,96092,Manhattan,1602693.86,East Harlem (North)
19-May,36061020701,1020701,7604,22139,29743,Manhattan,508167.8882,Morningside Heights
21-May,36061020701,1020701,2187,75762,77949,Manhattan,508167.8882,Morningside Heights
19-Jun,36061020701,1020701,9819,71,9890,Manhattan,508167.8882,Morningside Heights
21-Jun,36061020701,1020701,4736,105239,109975,Manhattan,508167.8882,Morningside Heights
19-Jul,36061020701,1020701,13736,87134,100870,Manhattan,508167.8882,Morningside Heights
21-Jul,36061020701,1020701,7768,112409,120177,Manhattan,508167.8882,Morningside Heights
19-Aug,36061020701,1020701,15677,83096,98773,Manhattan,508167.8882,Morningside Heights
21-Aug,36061020701,1020701,8384,103101,111485,Manhattan,508167.8882,Morningside Heights
19-May,36061020800,1020800,11376,65259,76635,Manhattan,1599291.601,Harlem (North)
21-May,36061020800,1020800,6719,134138,140857,Manhattan,1599291.601,Harlem (North)
19-Jun,36061020800,1020800,11013,5619,16632,Manhattan,1599291.601,Harlem (North)
21-Jun,36061020800,1020800,3276,18601,21877,Manhattan,1599291.601,Harlem (North)
19-Jul,36061020800,1020800,14339,157988,172327,Manhattan,1599291.601,Harlem (North)
21-Jul,36061020800,1020800,10623,100216,110839,Manhattan,1599291.601,Harlem (North)
19-Aug,36061020800,1020800,16357,86633,102990,Manhattan,1599291.601,Harlem (North)
21-Aug,36061020800,1020800,0,80477,80477,Manhattan,1599291.601,Harlem (North)
19-May,36061021303,1021303,14072,94299,108371,Manhattan,1643103.37,Manhattanville-West Harlem
21-May,36061021303,1021303,2254,67424,69678,Manhattan,1643103.37,Manhattanville-West Harlem
19-Jun,36061021303,1021303,8499,47993,56492,Manhattan,1643103.37,Manhattanville-West Harlem
21-Jun,36061021303,1021303,17148,115717,132865,Manhattan,1643103.37,Manhattanville-West Harlem
19-Jul,36061021303,1021303,4013,680,4693,Manhattan,1643103.37,Manhattanville-West Harlem
21-Jul,36061021303,1021303,858,33349,34207,Manhattan,1643103.37,Manhattanville-West Harlem
19-Aug,36061021303,1021303,8028,32148,40176,Manhattan,1643103.37,Manhattanville-West Harlem
21-Aug,36061021303,1021303,5648,93737,99385,Manhattan,1643103.37,Manhattanville-West Harlem
19-May,36061021500,1021500,4685,72002,76687,Manhattan,750635.0257,Harlem (North)
21-May,36061021500,1021500,14825,107072,121897,Manhattan,750635.0257,Harlem (North)
19-Jun,36061021500,1021500,1918,8202,10120,Manhattan,750635.0257,Harlem (North)
21-Jun,36061021500,1021500,14128,45569,59697,Manhattan,750635.0257,Harlem (North)
19-Jul,36061021500,1021500,11062,30691,41753,Manhattan,750635.0257,Harlem (North)
21-Jul,36061021500,1021500,8528,106918,115446,Manhattan,750635.0257,Harlem (North)
19-Aug,36061021500,1021500,8036,79908,87944,Manhattan,750635.0257,Harlem (North)
21-Aug,36061021500,1021500,4060,87464,91524,Manhattan,750635.0257,Harlem (North)
19-May,36061021600,1021600,16534,109018,125552,Manhattan,1864443.266,Harlem (South)
21-May,36061021600,1021600,0,71023,71023,Manhattan,1864443.266,Harlem (South)
19-Jun,36061021600,1021600,13208,92884,106092,Manhattan,1864443.266,Harlem (South)
21-Jun,36061021600,1021600,7847,35699,43546,Manhattan,1864443.266,Harlem (South)
19-Jul,36061021600,1021600,5603,20142,25745,Manhattan,1864443.266,Harlem (South)
21-Jul,36061021600,1021600,13979,71,14050,Manhattan,1864443.266,Harlem (South)
19-Aug,36061021600,1021600,6620,56264,62884,Manhattan,1864443.266,Harlem (South)
21-Aug,36061021600,1021600,3692,35440,39132,Manhattan,1864443.266,Harlem (South)
19-May,36061021703,1021703,8189,104894,113083,Manhattan,3384698.568,Manhattanville-West Harlem
21-May,36061021703,1021703,4864,92149,97013,Manhattan,3384698.568,Manhattanville-West Harlem
19-Jun,36061021703,1021703,4233,81818,86051,Manhattan,3384698.568,Manhattanville-West Harlem
21-Jun,36061021703,1021703,4493,112835,117328,Manhattan,3384698.568,Manhattanville-West Harlem
19-Jul,36061021703,1021703,1220,93837,95057,Manhattan,3384698.568,Manhattanville-West Harlem
21-Jul,36061021703,1021703,16316,73202,89518,Manhattan,3384698.568,Manhattanville-West Harlem
19-Aug,36061021703,1021703,8523,85739,94262,Manhattan,3384698.568,Manhattanville-West Harlem
21-Aug,36061021703,1021703,13209,40776,53985,Manhattan,3384698.568,Manhattanville-West Harlem
19-May,36061021800,1021800,5111,91906,97017,Manhattan,1958684.888,Harlem (South)
21-May,36061021800,1021800,5573,105382,110955,Manhattan,1958684.888,Harlem (South)
19-Jun,36061021800,1021800,4385,79275,83660,Manhattan,1958684.888,Harlem (South)
21-Jun,36061021800,1021800,9215,50555,59770,Manhattan,1958684.888,Harlem (South)
19-Jul,36061021800,1021800,18630,72877,91507,Manhattan,1958684.888,Harlem (South)
21-Jul,36061021800,1021800,2404,60396,62800,Manhattan,1958684.888,Harlem (South)
19-Aug,36061021800,1021800,6766,86987,93753,Manhattan,1958684.888,Harlem (South)
21-Aug,36061021800,1021800,9983,31544,41527,Manhattan,1958684.888,Harlem (South)
19-May,36061022000,1022000,10328,76107,86435,Manhattan,1882647.555,Harlem (South)
21-May,36061022000,1022000,7806,56401,64207,Manhattan,1882647.555,Harlem (South)
19-Jun,36061022000,1022000,10233,45755,55988,Manhattan,1882647.555,Harlem (South)
21-Jun,36061022000,1022000,6084,57468,63552,Manhattan,1882647.555,Harlem (South)
19-Jul,36061022000,1022000,980,17872,18852,Manhattan,1882647.555,Harlem (South)
21-Jul,36061022000,1022000,6295,149287,155582,Manhattan,1882647.555,Harlem (South)
19-Aug,36061022000,1022000,18692,88911,107603,Manhattan,1882647.555,Harlem (South)
21-Aug,36061022000,1022000,7354,29872,37226,Manhattan,1882647.555,Harlem (South)
19-May,36061022102,1022102,11542,77338,88880,Manhattan,1065533.643,Harlem (North)
21-May,36061022102,1022102,4377,56411,60788,Manhattan,1065533.643,Harlem (North)
19-Jun,36061022102,1022102,6497,41517,48014,Manhattan,1065533.643,Harlem (North)
21-Jun,36061022102,1022102,9446,66113,75559,Manhattan,1065533.643,Harlem (North)
19-Jul,36061022102,1022102,11390,116835,128225,Manhattan,1065533.643,Harlem (North)
21-Jul,36061022102,1022102,5209,11154,16363,Manhattan,1065533.643,Harlem (North)
19-Aug,36061022102,1022102,15712,25104,40816,Manhattan,1065533.643,Harlem (North)
21-Aug,36061022102,1022102,9075,19388,28463,Manhattan,1065533.643,Harlem (North)
19-May,36061022200,1022200,13327,104562,117889,Manhattan,1953119.68,Harlem (South)
21-May,36061022200,1022200,11284,113994,125278,Manhattan,1953119.68,Harlem (South)
19-Jun,36061022200,1022200,7189,102523,109712,Manhattan,1953119.68,Harlem (South)
21-Jun,36061022200,1022200,2051,64097,66148,Manhattan,1953119.68,Harlem (South)
19-Jul,36061022200,1022200,3470,64220,67690,Manhattan,1953119.68,Harlem (South)
21-Jul,36061022200,1022200,15408,38462,53870,Manhattan,1953119.68,Harlem (South)
19-Aug,36061022200,1022200,12437,50995,63432,Manhattan,1953119.68,Harlem (South)
21-Aug,36061022200,1022200,9746,55330,65076,Manhattan,1953119.68,Harlem (South)
19-May,36061022301,1022301,11690,119296,130986,Manhattan,2058402.278,Manhattanville-West Harlem
21-May,36061022301,1022301,5720,75566,81286,Manhattan,2058402.278,Manhattanville-West Harlem
19-Jun,36061022301,1022301,9206,82939,92145,Manhattan,2058402.278,Manhattanville-West Harlem
21-Jun,36061022301,1022301,5699,112903,118602,Manhattan,2058402.278,Manhattanville-West Harlem
19-Jul,36061022301,1022301,4773,42930,47703,Manhattan,2058402.278,Manhattanville-West Harlem
21-Jul,36061022301,1022301,4466,71,4537,Manhattan,2058402.278,Manhattanville-West Harlem
19-Aug,36061022301,1022301,10509,86405,96914,Manhattan,2058402.278,Manhattanville-West Harlem
21-Aug,36061022301,1022301,9861,25194,35055,Manhattan,2058402.278,Manhattanville-West Harlem
19-May,36061022400,1022400,13568,132697,146265,Manhattan,2099457.954,Harlem (North)
21-May,36061022400,1022400,9050,50315,59365,Manhattan,2099457.954,Harlem (North)
19-Jun,36061022400,1022400,11832,92157,103989,Manhattan,2099457.954,Harlem (North)
21-Jun,36061022400,1022400,14489,91492,105981,Manhattan,2099457.954,Harlem (North)
19-Jul,36061022400,1022400,5005,165422,170427,Manhattan,2099457.954,Harlem (North)
21-Jul,36061022400,1022400,13840,58171,72011,Manhattan,2099457.954,Harlem (North)
19-Aug,36061022400,1022400,0,46082,46082,Manhattan,2099457.954,Harlem (North)
21-Aug,36061022400,1022400,9031,71,9102,Manhattan,2099457.954,Harlem (North)
19-May,36061022600,1022600,18840,15829,34669,Manhattan,1642680.487,Harlem (North)
21-May,36061022600,1022600,7511,56613,64124,Manhattan,1642680.487,Harlem (North)
19-Jun,36061022600,1022600,11284,48762,60046,Manhattan,1642680.487,Harlem (North)
21-Jun,36061022600,1022600,5316,99848,105164,Manhattan,1642680.487,Harlem (North)
19-Jul,36061022600,1022600,9021,106326,115347,Manhattan,1642680.487,Harlem (North)
21-Jul,36061022600,1022600,8274,31828,40102,Manhattan,1642680.487,Harlem (North)
19-Aug,36061022600,1022600,14577,119854,134431,Manhattan,1642680.487,Harlem (North)
21-Aug,36061022600,1022600,11941,71,12012,Manhattan,1642680.487,Harlem (North)
19-May,36061022800,1022800,8978,146599,155577,Manhattan,1944083.44,Harlem (North)
21-May,36061022800,1022800,8107,67464,75571,Manhattan,1944083.44,Harlem (North)
19-Jun,36061022800,1022800,17138,94349,111487,Manhattan,1944083.44,Harlem (North)
21-Jun,36061022800,1022800,14648,71,14719,Manhattan,1944083.44,Harlem (North)
19-Jul,36061022800,1022800,8307,72648,80955,Manhattan,1944083.44,Harlem (North)
21-Jul,36061022800,1022800,2017,98286,100303,Manhattan,1944083.44,Harlem (North)
19-Aug,36061022800,1022800,12116,22866,34982,Manhattan,1944083.44,Harlem (North)
21-Aug,36061022800,1022800,10992,72753,83745,Manhattan,1944083.44,Harlem (North)
19-May,36061023100,1023100,4200,108598,112798,Manhattan,1962707.27,Hamilton Heights-Sugar Hill
21-May,36061023100,1023100,8311,35710,44021,Manhattan,1962707.27,Hamilton Heights-Sugar Hill
19-Jun,36061023100,1023100,10422,81378,91800,Manhattan,1962707.27,Hamilton Heights-Sugar Hill
21-Jun,36061023100,1023100,5598,49812,55410,Manhattan,1962707.27,Hamilton Heights-Sugar Hill
19-Jul,36061023100,1023100,15978,61751,77729,Manhattan,1962707.27,Hamilton Heights-Sugar Hill
21-Jul,36061023100,1023100,7550,61061,68611,Manhattan,1962707.27,Hamilton Heights-Sugar Hill
19-Aug,36061023100,1023100,8362,126851,135213,Manhattan,1962707.27,Hamilton Heights-Sugar Hill
21-Aug,36061023100,1023100,15600,125869,141469,Manhattan,1962707.27,Hamilton Heights-Sugar Hill
19-May,36061023400,1023400,12139,111738,123877,Manhattan,1167006.625,Harlem (North)
21-May,36061023400,1023400,7537,98678,106215,Manhattan,1167006.625,Harlem (North)
19-Jun,36061023400,1023400,8593,54818,63411,Manhattan,1167006.625,Harlem (North)
21-Jun,36061023400,1023400,8862,115366,124228,Manhattan,1167006.625,Harlem (North)
19-Jul,36061023400,1023400,14337,38785,53122,Manhattan,1167006.625,Harlem (North)
21-Jul,36061023400,1023400,13101,71,13172,Manhattan,1167006.625,Harlem (North)
19-Aug,36061023400,1023400,4351,60739,65090,Manhattan,1167006.625,Harlem (North)
21-Aug,36061023400,1023400,301,17498,17799,Manhattan,1167006.625,Harlem (North)
19-May,36061023502,1023502,8363,81571,89934,Manhattan,447807.8551,Harlem (North)
21-May,36061023502,1023502,13357,80140,93497,Manhattan,447807.8551,Harlem (North)
19-Jun,36061023502,1023502,9396,54953,64349,Manhattan,447807.8551,Harlem (North)
21-Jun,36061023502,1023502,14111,21669,35780,Manhattan,447807.8551,Harlem (North)
19-Jul,36061023502,1023502,16240,97026,113266,Manhattan,447807.8551,Harlem (North)
21-Jul,36061023502,1023502,0,83052,83052,Manhattan,447807.8551,Harlem (North)
19-Aug,36061023502,1023502,8382,48941,57323,Manhattan,447807.8551,Harlem (North)
21-Aug,36061023502,1023502,6044,158218,164262,Manhattan,447807.8551,Harlem (North)
19-May,36061024301,1024301,4308,141296,145604,Manhattan,1129820.012,Washington Heights (South)
21-May,36061024301,1024301,11397,66167,77564,Manhattan,1129820.012,Washington Heights (South)
19-Jun,36061024301,1024301,14024,40004,54028,Manhattan,1129820.012,Washington Heights (South)
21-Jun,36061024301,1024301,9007,69388,78395,Manhattan,1129820.012,Washington Heights (South)
19-Jul,36061024301,1024301,8071,140137,148208,Manhattan,1129820.012,Washington Heights (South)
21-Jul,36061024301,1024301,2085,69489,71574,Manhattan,1129820.012,Washington Heights (South)
19-Aug,36061024301,1024301,15056,5684,20740,Manhattan,1129820.012,Washington Heights (South)
21-Aug,36061024301,1024301,5702,30719,36421,Manhattan,1129820.012,Washington Heights (South)
19-May,36061024900,1024900,6142,91113,97255,Manhattan,652856.2994,Washington Heights (South)
21-May,36061024900,1024900,9731,71,9802,Manhattan,652856.2994,Washington Heights (South)
19-Jun,36061024900,1024900,14076,39644,53720,Manhattan,652856.2994,Washington Heights (South)
21-Jun,36061024900,1024900,10664,78302,88966,Manhattan,652856.2994,Washington Heights (South)
19-Jul,36061024900,1024900,11558,55465,67023,Manhattan,652856.2994,Washington Heights (South)
21-Jul,36061024900,1024900,14802,28866,43668,Manhattan,652856.2994,Washington Heights (South)
19-Aug,36061024900,1024900,0,18184,18184,Manhattan,652856.2994,Washington Heights (South)
21-Aug,36061024900,1024900,3845,31052,34897,Manhattan,652856.2994,Washington Heights (South)
19-May,36061025500,1025500,5344,78060,83404,Manhattan,4718124.843,Washington Heights (South)
21-May,36061025500,1025500,10315,105439,115754,Manhattan,4718124.843,Washington Heights (South)
19-Jun,36061025500,1025500,3996,35836,39832,Manhattan,4718124.843,Washington Heights (South)
21-Jun,36061025500,1025500,7848,39834,47682,Manhattan,4718124.843,Washington Heights (South)
19-Jul,36061025500,1025500,6147,94347,100494,Manhattan,4718124.843,Washington Heights (South)
21-Jul,36061025500,1025500,13018,13738,26756,Manhattan,4718124.843,Washington Heights (South)
19-Aug,36061025500,1025500,11924,96727,108651,Manhattan,4718124.843,Washington Heights (South)
21-Aug,36061025500,1025500,8801,100257,109058,Manhattan,4718124.843,Washington Heights (South)
19-May,36061026500,1026500,4859,94622,99481,Manhattan,2081505.518,Washington Heights (North)
21-May,36061026500,1026500,6965,82872,89837,Manhattan,2081505.518,Washington Heights (North)
19-Jun,36061026500,1026500,9044,79556,88600,Manhattan,2081505.518,Washington Heights (North)
21-Jun,36061026500,1026500,3442,127594,131036,Manhattan,2081505.518,Washington Heights (North)
19-Jul,36061026500,1026500,4259,127017,131276,Manhattan,2081505.518,Washington Heights (North)
21-Jul,36061026500,1026500,7558,71,7629,Manhattan,2081505.518,Washington Heights (North)
19-Aug,36061026500,1026500,8188,44418,52606,Manhattan,2081505.518,Washington Heights (North)
21-Aug,36061026500,1026500,11826,71777,83603,Manhattan,2081505.518,Washington Heights (North)
19-May,36061026700,1026700,10493,82354,92847,Manhattan,519544.6342,Washington Heights (North)
21-May,36061026700,1026700,0,13070,13070,Manhattan,519544.6342,Washington Heights (North)
19-Jun,36061026700,1026700,8858,98307,107165,Manhattan,519544.6342,Washington Heights (North)
21-Jun,36061026700,1026700,21190,96859,118049,Manhattan,519544.6342,Washington Heights (North)
19-Jul,36061026700,1026700,7394,64733,72127,Manhattan,519544.6342,Washington Heights (North)
21-Jul,36061026700,1026700,11267,18876,30143,Manhattan,519544.6342,Washington Heights (North)
19-Aug,36061026700,1026700,13560,77780,91340,Manhattan,519544.6342,Washington Heights (North)
21-Aug,36061026700,1026700,1169,78697,79866,Manhattan,519544.6342,Washington Heights (North)
19-May,36061026900,1026900,3750,63284,67034,Manhattan,1889655.55,Washington Heights (North)
21-May,36061026900,1026900,4479,116468,120947,Manhattan,1889655.55,Washington Heights (North)
19-Jun,36061026900,1026900,3980,26056,30036,Manhattan,1889655.55,Washington Heights (North)
21-Jun,36061026900,1026900,21790,69515,91305,Manhattan,1889655.55,Washington Heights (North)
19-Jul,36061026900,1026900,10060,119817,129877,Manhattan,1889655.55,Washington Heights (North)
21-Jul,36061026900,1026900,10424,82679,93103,Manhattan,1889655.55,Washington Heights (North)
19-Aug,36061026900,1026900,5513,53629,59142,Manhattan,1889655.55,Washington Heights (North)
21-Aug,36061026900,1026900,6598,49728,56326,Manhattan,1889655.55,Washington Heights (North)
19-May,36061027100,1027100,7159,100924,108083,Manhattan,2075200.784,Washington Heights (North)
21-May,36061027100,1027100,4612,131509,136121,Manhattan,2075200.784,Washington Heights (North)
19-Jun,36061027100,1027100,6642,73273,79915,Manhattan,2075200.784,Washington Heights (North)
21-Jun,36061027100,1027100,13540,51685,65225,Manhattan,2075200.784,Washington Heights (North)
19-Jul,36061027100,1027100,13607,45398,59005,Manhattan,2075200.784,Washington Heights (North)
21-Jul,36061027100,1027100,12895,57368,70263,Manhattan,2075200.784,Washington Heights (North)
19-Aug,36061027100,1027100,9881,84581,94462,Manhattan,2075200.784,Washington Heights (North)
21-Aug,36061027100,1027100,6875,2307,9182,Manhattan,2075200.784,Washington Heights (North)
19-May,36061029300,1029300,8519,122574,131093,Manhattan,1690644.732,Inwood
21-May,36061029300,1029300,18216,71909,90125,Manhattan,1690644.732,Inwood
19-Jun,36061029300,1029300,14420,72338,86758,Manhattan,1690644.732,Inwood
21-Jun,36061029300,1029300,0,58821,58821,Manhattan,1690644.732,Inwood
19-Jul,36061029300,1029300,10888,77242,88130,Manhattan,1690644.732,Inwood
21-Jul,36061029300,1029300,14835,960,15795,Manhattan,1690644.732,Inwood
19-Aug,36061029300,1029300,15169,78043,93212,Manhattan,1690644.732,Inwood
21-Aug,36061029300,1029300,12037,65186,77223,Manhattan,1690644.732,Inwood
19-May,36061029500,1029500,3586,65593,69179,Manhattan,1459956.209,Inwood
21-May,36061029500,1029500,10419,32282,42701,Manhattan,1459956.209,Inwood
19-Jun,36061029500,1029500,4985,68793,73778,Manhattan,1459956.209,Inwood
21-Jun,36061029500,1029500,4206,45787,49993,Manhattan,1459956.209,Inwood
19-Jul,36061029500,1029500,11768,125027,136795,Manhattan,1459956.209,Inwood
21-Jul,36061029500,1029500,16401,131569,147970,Manhattan,1459956.209,Inwood
19-Aug,36061029500,1029500,5465,71,5536,Manhattan,1459956.209,Inwood
21-Aug,36061029500,1029500,0,93903,93903,Manhattan,1459956.209,Inwood
19-May,36005000200,2000200,12990,25953,38943,Bronx,4877012.542,Soundview-Clason Point
21-May,36005000200,2000200,8839,38273,47112,Bronx,4877012.542,Soundview-Clason Point
19-Jun,36005000200,2000200,4357,884,5241,Bronx,4877012.542,Soundview-Clason Point
21-Jun,36005000200,2000200,6660,58259,64919,Bronx,4877012.542,Soundview-Clason Point
19-Jul,36005000200,2000200,8777,76958,85735,Bronx,4877012.542,Soundview-Clason Point
21-Jul,36005000200,2000200,9081,78202,87283,Bronx,4877012.542,Soundview-Clason Point
19-Aug,36005000200,2000200,4854,56436,61290,Bronx,4877012.542,Soundview-Clason Point
21-Aug,36005000200,2000200,11460,51156,62616,Bronx,4877012.542,Soundview-Clason Point
19-May,36005001600,2001600,13111,54204,67315,Bronx,5221330.108,Soundview-Clason Point
21-May,36005001600,2001600,4880,37257,42137,Bronx,5221330.108,Soundview-Clason Point
19-Jun,36005001600,2001600,6046,71,6117,Bronx,5221330.108,Soundview-Clason Point
21-Jun,36005001600,2001600,8545,20072,28617,Bronx,5221330.108,Soundview-Clason Point
19-Jul,36005001600,2001600,12394,58165,70559,Bronx,5221330.108,Soundview-Clason Point
21-Jul,36005001600,2001600,3540,71052,74592,Bronx,5221330.108,Soundview-Clason Point
19-Aug,36005001600,2001600,8505,40645,49150,Bronx,5221330.108,Soundview-Clason Point
21-Aug,36005001600,2001600,0,28231,28231,Bronx,5221330.108,Soundview-Clason Point
19-May,36005001904,2001904,11535,71924,83459,Bronx,930649.1753,North & South Brother Islands
21-May,36005001904,2001904,8067,157477,165544,Bronx,930649.1753,North & South Brother Islands
19-Jun,36005001904,2001904,9602,85317,94919,Bronx,930649.1753,North & South Brother Islands
21-Jun,36005001904,2001904,1266,121166,122432,Bronx,930649.1753,North & South Brother Islands
19-Jul,36005001904,2001904,9099,113662,122761,Bronx,930649.1753,North & South Brother Islands
21-Jul,36005001904,2001904,3457,46631,50088,Bronx,930649.1753,North & South Brother Islands
19-Aug,36005001904,2001904,2155,124805,126960,Bronx,930649.1753,North & South Brother Islands
21-Aug,36005001904,2001904,10242,102973,113215,Bronx,930649.1753,North & South Brother Islands
19-May,36005002002,2002002,10577,100247,110824,Bronx,2205268.55,Soundview-Clason Point
21-May,36005002002,2002002,10183,37371,47554,Bronx,2205268.55,Soundview-Clason Point
19-Jun,36005002002,2002002,10694,111475,122169,Bronx,2205268.55,Soundview-Clason Point
21-Jun,36005002002,2002002,11857,51801,63658,Bronx,2205268.55,Soundview-Clason Point
19-Jul,36005002002,2002002,11646,101229,112875,Bronx,2205268.55,Soundview-Clason Point
21-Jul,36005002002,2002002,23263,90255,113518,Bronx,2205268.55,Soundview-Clason Point
19-Aug,36005002002,2002002,4268,98162,102430,Bronx,2205268.55,Soundview-Clason Point
21-Aug,36005002002,2002002,6883,37963,44846,Bronx,2205268.55,Soundview-Clason Point
19-May,36005002300,2002300,4449,50402,54851,Bronx,1126745.18,Mott Haven-Port Morris
21-May,36005002300,2002300,3807,125524,129331,Bronx,1126745.18,Mott Haven-Port Morris
19-Jun,36005002300,2002300,6855,130104,136959,Bronx,1126745.18,Mott Haven-Port Morris
21-Jun,36005002300,2002300,13743,53375,67118,Bronx,1126745.18,Mott Haven-Port Morris
19-Jul,36005002300,2002300,10633,29624,40257,Bronx,1126745.18,Mott Haven-Port Morris
21-Jul,36005002300,2002300,2156,45140,47296,Bronx,1126745.18,Mott Haven-Port Morris
19-Aug,36005002300,2002300,2974,72510,75484,Bronx,1126745.18,Mott Haven-Port Morris
21-Aug,36005002300,2002300,4005,68870,72875,Bronx,1126745.18,Mott Haven-Port Morris
19-May,36005002500,2002500,5658,52669,58327,Bronx,1372151.257,Mott Haven-Port Morris
21-May,36005002500,2002500,5582,112955,118537,Bronx,1372151.257,Mott Haven-Port Morris
19-Jun,36005002500,2002500,6587,153541,160128,Bronx,1372151.257,Mott Haven-Port Morris
21-Jun,36005002500,2002500,3072,71256,74328,Bronx,1372151.257,Mott Haven-Port Morris
19-Jul,36005002500,2002500,4718,151561,156279,Bronx,1372151.257,Mott Haven-Port Morris
21-Jul,36005002500,2002500,5689,166074,171763,Bronx,1372151.257,Mott Haven-Port Morris
19-Aug,36005002500,2002500,20901,82816,103717,Bronx,1372151.257,Mott Haven-Port Morris
21-Aug,36005002500,2002500,8529,66735,75264,Bronx,1372151.257,Mott Haven-Port Morris
19-May,36005002701,2002701,6825,95385,102210,Bronx,875817.5604,Mott Haven-Port Morris
21-May,36005002701,2002701,8507,65677,74184,Bronx,875817.5604,Mott Haven-Port Morris
19-Jun,36005002701,2002701,0,42548,42548,Bronx,875817.5604,Mott Haven-Port Morris
21-Jun,36005002701,2002701,5281,94730,100011,Bronx,875817.5604,Mott Haven-Port Morris
19-Jul,36005002701,2002701,13163,71573,84736,Bronx,875817.5604,Mott Haven-Port Morris
21-Jul,36005002701,2002701,5436,97263,102699,Bronx,875817.5604,Mott Haven-Port Morris
19-Aug,36005002701,2002701,12104,43416,55520,Bronx,875817.5604,Mott Haven-Port Morris
21-Aug,36005002701,2002701,9400,43667,53067,Bronx,875817.5604,Mott Haven-Port Morris
19-May,36005002702,2002702,10673,71,10744,Bronx,1677797.989,Mott Haven-Port Morris
21-May,36005002702,2002702,9102,133718,142820,Bronx,1677797.989,Mott Haven-Port Morris
19-Jun,36005002702,2002702,4650,104259,108909,Bronx,1677797.989,Mott Haven-Port Morris
21-Jun,36005002702,2002702,7554,41821,49375,Bronx,1677797.989,Mott Haven-Port Morris
19-Jul,36005002702,2002702,12550,128595,141145,Bronx,1677797.989,Mott Haven-Port Morris
21-Jul,36005002702,2002702,10349,108716,119065,Bronx,1677797.989,Mott Haven-Port Morris
19-Aug,36005002702,2002702,9254,76850,86104,Bronx,1677797.989,Mott Haven-Port Morris
21-Aug,36005002702,2002702,0,81244,81244,Bronx,1677797.989,Mott Haven-Port Morris
19-May,36005003800,2003800,11844,23557,35401,Bronx,682166.2702,Soundview-Clason Point
21-May,36005003800,2003800,8839,103747,112586,Bronx,682166.2702,Soundview-Clason Point
19-Jun,36005003800,2003800,10375,15536,25911,Bronx,682166.2702,Soundview-Clason Point
21-Jun,36005003800,2003800,10114,119770,129884,Bronx,682166.2702,Soundview-Clason Point
19-Jul,36005003800,2003800,15715,42948,58663,Bronx,682166.2702,Soundview-Clason Point
21-Jul,36005003800,2003800,10380,59367,69747,Bronx,682166.2702,Soundview-Clason Point
19-Aug,36005003800,2003800,6810,80920,87730,Bronx,682166.2702,Soundview-Clason Point
21-Aug,36005003800,2003800,4670,89523,94193,Bronx,682166.2702,Soundview-Clason Point
19-May,36005003900,2003900,1842,12900,14742,Bronx,2326464.747,Mott Haven-Port Morris
21-May,36005003900,2003900,4022,71,4093,Bronx,2326464.747,Mott Haven-Port Morris
19-Jun,36005003900,2003900,15065,114905,129970,Bronx,2326464.747,Mott Haven-Port Morris
21-Jun,36005003900,2003900,10051,34443,44494,Bronx,2326464.747,Mott Haven-Port Morris
19-Jul,36005003900,2003900,7017,71,7088,Bronx,2326464.747,Mott Haven-Port Morris
21-Jul,36005003900,2003900,8294,14871,23165,Bronx,2326464.747,Mott Haven-Port Morris
19-Aug,36005003900,2003900,5984,132472,138456,Bronx,2326464.747,Mott Haven-Port Morris
21-Aug,36005003900,2003900,8549,55492,64041,Bronx,2326464.747,Mott Haven-Port Morris
19-May,36005004001,2004001,5713,181504,187217,Bronx,1325276.218,Castle Hill-Unionport
21-May,36005004001,2004001,14311,71938,86249,Bronx,1325276.218,Castle Hill-Unionport
19-Jun,36005004001,2004001,11816,92032,103848,Bronx,1325276.218,Castle Hill-Unionport
21-Jun,36005004001,2004001,5888,103291,109179,Bronx,1325276.218,Castle Hill-Unionport
19-Jul,36005004001,2004001,577,73084,73661,Bronx,1325276.218,Castle Hill-Unionport
21-Jul,36005004001,2004001,16039,79722,95761,Bronx,1325276.218,Castle Hill-Unionport
19-Aug,36005004001,2004001,4217,91224,95441,Bronx,1325276.218,Castle Hill-Unionport
21-Aug,36005004001,2004001,9306,122061,131367,Bronx,1325276.218,Castle Hill-Unionport
19-May,36005004200,2004200,11930,49139,61069,Bronx,5209131.533,Soundview-Clason Point
21-May,36005004200,2004200,2199,66838,69037,Bronx,5209131.533,Soundview-Clason Point
19-Jun,36005004200,2004200,17652,54431,72083,Bronx,5209131.533,Soundview-Clason Point
21-Jun,36005004200,2004200,12788,12376,25164,Bronx,5209131.533,Soundview-Clason Point
19-Jul,36005004200,2004200,6115,13376,19491,Bronx,5209131.533,Soundview-Clason Point
21-Jul,36005004200,2004200,7462,160105,167567,Bronx,5209131.533,Soundview-Clason Point
19-Aug,36005004200,2004200,16072,92412,108484,Bronx,5209131.533,Soundview-Clason Point
21-Aug,36005004200,2004200,2210,102734,104944,Bronx,5209131.533,Soundview-Clason Point
19-May,36005004400,2004400,6412,123251,129663,Bronx,2870570.36,Soundview-Bruckner-Bronx River
21-May,36005004400,2004400,0,45997,45997,Bronx,2870570.36,Soundview-Bruckner-Bronx River
19-Jun,36005004400,2004400,11151,82101,93252,Bronx,2870570.36,Soundview-Bruckner-Bronx River
21-Jun,36005004400,2004400,11644,243,11887,Bronx,2870570.36,Soundview-Bruckner-Bronx River
19-Jul,36005004400,2004400,6912,12260,19172,Bronx,2870570.36,Soundview-Bruckner-Bronx River
21-Jul,36005004400,2004400,0,110854,110854,Bronx,2870570.36,Soundview-Bruckner-Bronx River
19-Aug,36005004400,2004400,15527,37320,52847,Bronx,2870570.36,Soundview-Bruckner-Bronx River
21-Aug,36005004400,2004400,2374,66446,68820,Bronx,2870570.36,Soundview-Bruckner-Bronx River
19-May,36005004600,2004600,7398,17230,24628,Bronx,1435084.957,Soundview-Clason Point
21-May,36005004600,2004600,7890,86943,94833,Bronx,1435084.957,Soundview-Clason Point
19-Jun,36005004600,2004600,7895,88298,96193,Bronx,1435084.957,Soundview-Clason Point
21-Jun,36005004600,2004600,8168,27619,35787,Bronx,1435084.957,Soundview-Clason Point
19-Jul,36005004600,2004600,5048,18124,23172,Bronx,1435084.957,Soundview-Clason Point
21-Jul,36005004600,2004600,6915,97734,104649,Bronx,1435084.957,Soundview-Clason Point
19-Aug,36005004600,2004600,8298,67086,75384,Bronx,1435084.957,Soundview-Clason Point
21-Aug,36005004600,2004600,10106,41828,51934,Bronx,1435084.957,Soundview-Clason Point
19-May,36005004800,2004800,13211,145018,158229,Bronx,1600408.896,Soundview-Bruckner-Bronx River
21-May,36005004800,2004800,8724,97450,106174,Bronx,1600408.896,Soundview-Bruckner-Bronx River
19-Jun,36005004800,2004800,547,128852,129399,Bronx,1600408.896,Soundview-Bruckner-Bronx River
21-Jun,36005004800,2004800,0,21570,21570,Bronx,1600408.896,Soundview-Bruckner-Bronx River
19-Jul,36005004800,2004800,7690,18802,26492,Bronx,1600408.896,Soundview-Bruckner-Bronx River
21-Jul,36005004800,2004800,14177,123000,137177,Bronx,1600408.896,Soundview-Bruckner-Bronx River
19-Aug,36005004800,2004800,16162,130629,146791,Bronx,1600408.896,Soundview-Bruckner-Bronx River
21-Aug,36005004800,2004800,9149,68883,78032,Bronx,1600408.896,Soundview-Bruckner-Bronx River
19-May,36005005001,2005001,13996,30284,44280,Bronx,1053604.268,Soundview-Bruckner-Bronx River
21-May,36005005001,2005001,7560,108839,116399,Bronx,1053604.268,Soundview-Bruckner-Bronx River
19-Jun,36005005001,2005001,13958,131564,145522,Bronx,1053604.268,Soundview-Bruckner-Bronx River
21-Jun,36005005001,2005001,11664,127576,139240,Bronx,1053604.268,Soundview-Bruckner-Bronx River
19-Jul,36005005001,2005001,2422,141372,143794,Bronx,1053604.268,Soundview-Bruckner-Bronx River
21-Jul,36005005001,2005001,16102,91616,107718,Bronx,1053604.268,Soundview-Bruckner-Bronx River
19-Aug,36005005001,2005001,2905,92857,95762,Bronx,1053604.268,Soundview-Bruckner-Bronx River
21-Aug,36005005001,2005001,10147,148228,158375,Bronx,1053604.268,Soundview-Bruckner-Bronx River
19-May,36005005002,2005002,8688,88472,97160,Bronx,1226231.425,Soundview-Bruckner-Bronx River
21-May,36005005002,2005002,874,44642,45516,Bronx,1226231.425,Soundview-Bruckner-Bronx River
19-Jun,36005005002,2005002,14688,67940,82628,Bronx,1226231.425,Soundview-Bruckner-Bronx River
21-Jun,36005005002,2005002,8504,112853,121357,Bronx,1226231.425,Soundview-Bruckner-Bronx River
19-Jul,36005005002,2005002,6068,88544,94612,Bronx,1226231.425,Soundview-Bruckner-Bronx River
21-Jul,36005005002,2005002,4549,116309,120858,Bronx,1226231.425,Soundview-Bruckner-Bronx River
19-Aug,36005005002,2005002,12506,149564,162070,Bronx,1226231.425,Soundview-Bruckner-Bronx River
21-Aug,36005005002,2005002,6092,70978,77070,Bronx,1226231.425,Soundview-Bruckner-Bronx River
19-May,36005005400,2005400,10770,131208,141978,Bronx,2133456.894,Soundview-Bruckner-Bronx River
21-May,36005005400,2005400,4528,148120,152648,Bronx,2133456.894,Soundview-Bruckner-Bronx River
19-Jun,36005005400,2005400,8518,31651,40169,Bronx,2133456.894,Soundview-Bruckner-Bronx River
21-Jun,36005005400,2005400,7406,103402,110808,Bronx,2133456.894,Soundview-Bruckner-Bronx River
19-Jul,36005005400,2005400,3338,119246,122584,Bronx,2133456.894,Soundview-Bruckner-Bronx River
21-Jul,36005005400,2005400,20813,37704,58517,Bronx,2133456.894,Soundview-Bruckner-Bronx River
19-Aug,36005005400,2005400,6107,79470,85577,Bronx,2133456.894,Soundview-Bruckner-Bronx River
21-Aug,36005005400,2005400,8623,74888,83511,Bronx,2133456.894,Soundview-Bruckner-Bronx River
19-May,36005006302,2006302,13778,17058,30836,Bronx,2808902.886,Yankee Stadium-Macombs Dam Park
21-May,36005006302,2006302,7690,52246,59936,Bronx,2808902.886,Yankee Stadium-Macombs Dam Park
19-Jun,36005006302,2006302,2997,71,3068,Bronx,2808902.886,Yankee Stadium-Macombs Dam Park
21-Jun,36005006302,2006302,10970,104896,115866,Bronx,2808902.886,Yankee Stadium-Macombs Dam Park
19-Jul,36005006302,2006302,1139,165088,166227,Bronx,2808902.886,Yankee Stadium-Macombs Dam Park
21-Jul,36005006302,2006302,13012,77447,90459,Bronx,2808902.886,Yankee Stadium-Macombs Dam Park
19-Aug,36005006302,2006302,5214,110967,116181,Bronx,2808902.886,Yankee Stadium-Macombs Dam Park
21-Aug,36005006302,2006302,7033,71554,78587,Bronx,2808902.886,Yankee Stadium-Macombs Dam Park
19-May,36005006400,2006400,5716,103377,109093,Bronx,1799541.053,Soundview-Bruckner-Bronx River
21-May,36005006400,2006400,9161,123600,132761,Bronx,1799541.053,Soundview-Bruckner-Bronx River
19-Jun,36005006400,2006400,2351,128704,131055,Bronx,1799541.053,Soundview-Bruckner-Bronx River
21-Jun,36005006400,2006400,8964,105484,114448,Bronx,1799541.053,Soundview-Bruckner-Bronx River
19-Jul,36005006400,2006400,11652,77538,89190,Bronx,1799541.053,Soundview-Bruckner-Bronx River
21-Jul,36005006400,2006400,10545,85454,95999,Bronx,1799541.053,Soundview-Bruckner-Bronx River
19-Aug,36005006400,2006400,2927,60416,63343,Bronx,1799541.053,Soundview-Bruckner-Bronx River
21-Aug,36005006400,2006400,3303,74644,77947,Bronx,1799541.053,Soundview-Bruckner-Bronx River
19-May,36005006500,2006500,9277,20059,29336,Bronx,2816010.812,Melrose
21-May,36005006500,2006500,3356,4199,7555,Bronx,2816010.812,Melrose
19-Jun,36005006500,2006500,19292,107545,126837,Bronx,2816010.812,Melrose
21-Jun,36005006500,2006500,9589,80813,90402,Bronx,2816010.812,Melrose
19-Jul,36005006500,2006500,3296,124520,127816,Bronx,2816010.812,Melrose
21-Jul,36005006500,2006500,4563,53326,57889,Bronx,2816010.812,Melrose
19-Aug,36005006500,2006500,12307,71,12378,Bronx,2816010.812,Melrose
21-Aug,36005006500,2006500,0,130518,130518,Bronx,2816010.812,Melrose
19-May,36005006800,2006800,7980,23544,31524,Bronx,1674049.116,Soundview-Bruckner-Bronx River
21-May,36005006800,2006800,8997,88851,97848,Bronx,1674049.116,Soundview-Bruckner-Bronx River
19-Jun,36005006800,2006800,10131,81173,91304,Bronx,1674049.116,Soundview-Bruckner-Bronx River
21-Jun,36005006800,2006800,13148,34012,47160,Bronx,1674049.116,Soundview-Bruckner-Bronx River
19-Jul,36005006800,2006800,12614,19956,32570,Bronx,1674049.116,Soundview-Bruckner-Bronx River
21-Jul,36005006800,2006800,7144,161521,168665,Bronx,1674049.116,Soundview-Bruckner-Bronx River
19-Aug,36005006800,2006800,3495,110678,114173,Bronx,1674049.116,Soundview-Bruckner-Bronx River
21-Aug,36005006800,2006800,14920,19900,34820,Bronx,1674049.116,Soundview-Bruckner-Bronx River
19-May,36005007000,2007000,10396,105858,116254,Bronx,2207823.351,Soundview-Bruckner-Bronx River
21-May,36005007000,2007000,13933,126520,140453,Bronx,2207823.351,Soundview-Bruckner-Bronx River
19-Jun,36005007000,2007000,8092,88875,96967,Bronx,2207823.351,Soundview-Bruckner-Bronx River
21-Jun,36005007000,2007000,5425,5236,10661,Bronx,2207823.351,Soundview-Bruckner-Bronx River
19-Jul,36005007000,2007000,10238,41673,51911,Bronx,2207823.351,Soundview-Bruckner-Bronx River
21-Jul,36005007000,2007000,10749,46375,57124,Bronx,2207823.351,Soundview-Bruckner-Bronx River
19-Aug,36005007000,2007000,913,19140,20053,Bronx,2207823.351,Soundview-Bruckner-Bronx River
21-Aug,36005007000,2007000,470,95529,95999,Bronx,2207823.351,Soundview-Bruckner-Bronx River
19-May,36005007200,2007200,6631,63266,69897,Bronx,2283208.283,Castle Hill-Unionport
21-May,36005007200,2007200,6051,85984,92035,Bronx,2283208.283,Castle Hill-Unionport
19-Jun,36005007200,2007200,10213,71,10284,Bronx,2283208.283,Castle Hill-Unionport
21-Jun,36005007200,2007200,7023,113013,120036,Bronx,2283208.283,Castle Hill-Unionport
19-Jul,36005007200,2007200,14871,41563,56434,Bronx,2283208.283,Castle Hill-Unionport
21-Jul,36005007200,2007200,2150,129905,132055,Bronx,2283208.283,Castle Hill-Unionport
19-Aug,36005007200,2007200,2959,100113,103072,Bronx,2283208.283,Castle Hill-Unionport
21-Aug,36005007200,2007200,7099,64060,71159,Bronx,2283208.283,Castle Hill-Unionport
19-May,36005007400,2007400,14945,40583,55528,Bronx,2012633.621,Castle Hill-Unionport
21-May,36005007400,2007400,6940,102136,109076,Bronx,2012633.621,Castle Hill-Unionport
19-Jun,36005007400,2007400,11955,55919,67874,Bronx,2012633.621,Castle Hill-Unionport
21-Jun,36005007400,2007400,12338,104788,117126,Bronx,2012633.621,Castle Hill-Unionport
19-Jul,36005007400,2007400,7905,64087,71992,Bronx,2012633.621,Castle Hill-Unionport
21-Jul,36005007400,2007400,5276,76342,81618,Bronx,2012633.621,Castle Hill-Unionport
19-Aug,36005007400,2007400,10724,33876,44600,Bronx,2012633.621,Castle Hill-Unionport
21-Aug,36005007400,2007400,17442,107551,124993,Bronx,2012633.621,Castle Hill-Unionport
19-May,36005007600,2007600,4440,133981,138421,Bronx,2343060.648,Soundview-Bruckner-Bronx River
21-May,36005007600,2007600,11221,28107,39328,Bronx,2343060.648,Soundview-Bruckner-Bronx River
19-Jun,36005007600,2007600,8991,85097,94088,Bronx,2343060.648,Soundview-Bruckner-Bronx River
21-Jun,36005007600,2007600,704,68613,69317,Bronx,2343060.648,Soundview-Bruckner-Bronx River
19-Jul,36005007600,2007600,2522,112599,115121,Bronx,2343060.648,Soundview-Bruckner-Bronx River
21-Jul,36005007600,2007600,10062,64935,74997,Bronx,2343060.648,Soundview-Bruckner-Bronx River
19-Aug,36005007600,2007600,10648,86583,97231,Bronx,2343060.648,Soundview-Bruckner-Bronx River
21-Aug,36005007600,2007600,14593,122217,136810,Bronx,2343060.648,Soundview-Bruckner-Bronx River
19-May,36005007900,2007900,7347,39048,46395,Bronx,2126625.733,Melrose
21-May,36005007900,2007900,17626,93856,111482,Bronx,2126625.733,Melrose
19-Jun,36005007900,2007900,12925,129463,142388,Bronx,2126625.733,Melrose
21-Jun,36005007900,2007900,16537,109426,125963,Bronx,2126625.733,Melrose
19-Jul,36005007900,2007900,7283,50304,57587,Bronx,2126625.733,Melrose
21-Jul,36005007900,2007900,1118,54709,55827,Bronx,2126625.733,Melrose
19-Aug,36005007900,2007900,8350,42489,50839,Bronx,2126625.733,Melrose
21-Aug,36005007900,2007900,5919,47363,53282,Bronx,2126625.733,Melrose
19-May,36005008400,2008400,2458,91277,93735,Bronx,1674998.444,Castle Hill-Unionport
21-May,36005008400,2008400,8864,65366,74230,Bronx,1674998.444,Castle Hill-Unionport
19-Jun,36005008400,2008400,12946,44764,57710,Bronx,1674998.444,Castle Hill-Unionport
21-Jun,36005008400,2008400,16149,83348,99497,Bronx,1674998.444,Castle Hill-Unionport
19-Jul,36005008400,2008400,17819,71331,89150,Bronx,1674998.444,Castle Hill-Unionport
21-Jul,36005008400,2008400,5203,69681,74884,Bronx,1674998.444,Castle Hill-Unionport
19-Aug,36005008400,2008400,4632,78873,83505,Bronx,1674998.444,Castle Hill-Unionport
21-Aug,36005008400,2008400,6243,94946,101189,Bronx,1674998.444,Castle Hill-Unionport
19-May,36005008500,2008500,3006,111531,114537,Bronx,1966131.482,Longwood
21-May,36005008500,2008500,1574,96467,98041,Bronx,1966131.482,Longwood
19-Jun,36005008500,2008500,4781,129321,134102,Bronx,1966131.482,Longwood
21-Jun,36005008500,2008500,9093,71,9164,Bronx,1966131.482,Longwood
19-Jul,36005008500,2008500,12593,71105,83698,Bronx,1966131.482,Longwood
21-Jul,36005008500,2008500,14150,25310,39460,Bronx,1966131.482,Longwood
19-Aug,36005008500,2008500,7133,114959,122092,Bronx,1966131.482,Longwood
21-Aug,36005008500,2008500,11975,61376,73351,Bronx,1966131.482,Longwood
19-May,36005008600,2008600,5548,111467,117015,Bronx,2019879.827,Castle Hill-Unionport
21-May,36005008600,2008600,4698,17140,21838,Bronx,2019879.827,Castle Hill-Unionport
19-Jun,36005008600,2008600,12008,49088,61096,Bronx,2019879.827,Castle Hill-Unionport
21-Jun,36005008600,2008600,11936,71,12007,Bronx,2019879.827,Castle Hill-Unionport
19-Jul,36005008600,2008600,14159,55507,69666,Bronx,2019879.827,Castle Hill-Unionport
21-Jul,36005008600,2008600,5270,90039,95309,Bronx,2019879.827,Castle Hill-Unionport
19-Aug,36005008600,2008600,4456,118394,122850,Bronx,2019879.827,Castle Hill-Unionport
21-Aug,36005008600,2008600,2579,108941,111520,Bronx,2019879.827,Castle Hill-Unionport
19-May,36005008700,2008700,11730,47545,59275,Bronx,2302753.253,Longwood
21-May,36005008700,2008700,10000,71,10071,Bronx,2302753.253,Longwood
19-Jun,36005008700,2008700,12791,11788,24579,Bronx,2302753.253,Longwood
21-Jun,36005008700,2008700,9909,47318,57227,Bronx,2302753.253,Longwood
19-Jul,36005008700,2008700,18213,48254,66467,Bronx,2302753.253,Longwood
21-Jul,36005008700,2008700,10898,71,10969,Bronx,2302753.253,Longwood
19-Aug,36005008700,2008700,9056,109646,118702,Bronx,2302753.253,Longwood
21-Aug,36005008700,2008700,5654,45157,50811,Bronx,2302753.253,Longwood
19-May,36005009200,2009200,541,97733,98274,Bronx,3334997.931,Castle Hill-Unionport
21-May,36005009200,2009200,4935,80456,85391,Bronx,3334997.931,Castle Hill-Unionport
19-Jun,36005009200,2009200,18312,23073,41385,Bronx,3334997.931,Castle Hill-Unionport
21-Jun,36005009200,2009200,20232,82810,103042,Bronx,3334997.931,Castle Hill-Unionport
19-Jul,36005009200,2009200,3872,8062,11934,Bronx,3334997.931,Castle Hill-Unionport
21-Jul,36005009200,2009200,10972,128080,139052,Bronx,3334997.931,Castle Hill-Unionport
19-Aug,36005009200,2009200,10732,88116,98848,Bronx,3334997.931,Castle Hill-Unionport
21-Aug,36005009200,2009200,8920,93285,102205,Bronx,3334997.931,Castle Hill-Unionport
19-May,36005011702,2011702,921,56330,57251,Bronx,12494792.99,Hunts Point
21-May,36005011702,2011702,381,95233,95614,Bronx,12494792.99,Hunts Point
19-Jun,36005011702,2011702,9538,25636,35174,Bronx,12494792.99,Hunts Point
21-Jun,36005011702,2011702,7163,59779,66942,Bronx,12494792.99,Hunts Point
19-Jul,36005011702,2011702,1277,45580,46857,Bronx,12494792.99,Hunts Point
21-Jul,36005011702,2011702,5548,102523,108071,Bronx,12494792.99,Hunts Point
19-Aug,36005011702,2011702,8525,142239,150764,Bronx,12494792.99,Hunts Point
21-Aug,36005011702,2011702,4434,21156,25590,Bronx,12494792.99,Hunts Point
19-May,36005011900,2011900,8567,106119,114686,Bronx,1811090.684,Longwood
21-May,36005011900,2011900,11846,47865,59711,Bronx,1811090.684,Longwood
19-Jun,36005011900,2011900,9372,36692,46064,Bronx,1811090.684,Longwood
21-Jun,36005011900,2011900,19053,76817,95870,Bronx,1811090.684,Longwood
19-Jul,36005011900,2011900,8072,46171,54243,Bronx,1811090.684,Longwood
21-Jul,36005011900,2011900,8607,65293,73900,Bronx,1811090.684,Longwood
19-Aug,36005011900,2011900,5880,93415,99295,Bronx,1811090.684,Longwood
21-Aug,36005011900,2011900,4731,69781,74512,Bronx,1811090.684,Longwood
19-May,36005012101,2012101,14927,35313,50240,Bronx,1251776.202,Crotona Park East
21-May,36005012101,2012101,8660,29877,38537,Bronx,1251776.202,Crotona Park East
19-Jun,36005012101,2012101,6740,69335,76075,Bronx,1251776.202,Crotona Park East
21-Jun,36005012101,2012101,12145,36530,48675,Bronx,1251776.202,Crotona Park East
19-Jul,36005012101,2012101,7848,21850,29698,Bronx,1251776.202,Crotona Park East
21-Jul,36005012101,2012101,5649,67531,73180,Bronx,1251776.202,Crotona Park East
19-Aug,36005012101,2012101,10307,67618,77925,Bronx,1251776.202,Crotona Park East
21-Aug,36005012101,2012101,6536,33867,40403,Bronx,1251776.202,Crotona Park East
19-May,36005012102,2012102,15607,40814,56421,Bronx,555873.8159,Longwood
21-May,36005012102,2012102,18229,110745,128974,Bronx,555873.8159,Longwood
19-Jun,36005012102,2012102,15495,48784,64279,Bronx,555873.8159,Longwood
21-Jun,36005012102,2012102,11379,36243,47622,Bronx,555873.8159,Longwood
19-Jul,36005012102,2012102,4526,93558,98084,Bronx,555873.8159,Longwood
21-Jul,36005012102,2012102,18794,52981,71775,Bronx,555873.8159,Longwood
19-Aug,36005012102,2012102,0,55482,55482,Bronx,555873.8159,Longwood
21-Aug,36005012102,2012102,5598,95723,101321,Bronx,555873.8159,Longwood
19-May,36005012500,2012500,10466,82594,93060,Bronx,1828803.455,Crotona Park East
21-May,36005012500,2012500,5252,82123,87375,Bronx,1828803.455,Crotona Park East
19-Jun,36005012500,2012500,7993,29130,37123,Bronx,1828803.455,Crotona Park East
21-Jun,36005012500,2012500,5239,107468,112707,Bronx,1828803.455,Crotona Park East
19-Jul,36005012500,2012500,11916,26219,38135,Bronx,1828803.455,Crotona Park East
21-Jul,36005012500,2012500,22379,68518,90897,Bronx,1828803.455,Crotona Park East
19-Aug,36005012500,2012500,13614,51823,65437,Bronx,1828803.455,Crotona Park East
21-Aug,36005012500,2012500,12375,20298,32673,Bronx,1828803.455,Crotona Park East
19-May,36005012901,2012901,8441,69742,78183,Bronx,1682640.157,Longwood
21-May,36005012901,2012901,10718,105171,115889,Bronx,1682640.157,Longwood
19-Jun,36005012901,2012901,9007,85287,94294,Bronx,1682640.157,Longwood
21-Jun,36005012901,2012901,2076,108394,110470,Bronx,1682640.157,Longwood
19-Jul,36005012901,2012901,12459,148566,161025,Bronx,1682640.157,Longwood
21-Jul,36005012901,2012901,0,76899,76899,Bronx,1682640.157,Longwood
19-Aug,36005012901,2012901,7785,121014,128799,Bronx,1682640.157,Longwood
21-Aug,36005012901,2012901,4502,78272,82774,Bronx,1682640.157,Longwood
19-May,36005013000,2013000,3612,69166,72778,Bronx,1248461.178,Throgs Neck-Schuylerville
21-May,36005013000,2013000,11,49600,49611,Bronx,1248461.178,Throgs Neck-Schuylerville
19-Jun,36005013000,2013000,9804,71,9875,Bronx,1248461.178,Throgs Neck-Schuylerville
21-Jun,36005013000,2013000,394,57052,57446,Bronx,1248461.178,Throgs Neck-Schuylerville
19-Jul,36005013000,2013000,7010,102420,109430,Bronx,1248461.178,Throgs Neck-Schuylerville
21-Jul,36005013000,2013000,3202,100336,103538,Bronx,1248461.178,Throgs Neck-Schuylerville
19-Aug,36005013000,2013000,10502,74372,84874,Bronx,1248461.178,Throgs Neck-Schuylerville
21-Aug,36005013000,2013000,9345,95849,105194,Bronx,1248461.178,Throgs Neck-Schuylerville
19-May,36005013100,2013100,4122,104075,108197,Bronx,2477239.187,Longwood
21-May,36005013100,2013100,486,9452,9938,Bronx,2477239.187,Longwood
19-Jun,36005013100,2013100,7675,66720,74395,Bronx,2477239.187,Longwood
21-Jun,36005013100,2013100,609,4726,5335,Bronx,2477239.187,Longwood
19-Jul,36005013100,2013100,8933,52708,61641,Bronx,2477239.187,Longwood
21-Jul,36005013100,2013100,12215,121118,133333,Bronx,2477239.187,Longwood
19-Aug,36005013100,2013100,6469,3793,10262,Bronx,2477239.187,Longwood
21-Aug,36005013100,2013100,14476,111565,126041,Bronx,2477239.187,Longwood
19-May,36005013200,2013200,11196,95272,106468,Bronx,6520114.092,Throgs Neck-Schuylerville
21-May,36005013200,2013200,8047,71,8118,Bronx,6520114.092,Throgs Neck-Schuylerville
19-Jun,36005013200,2013200,7450,98266,105716,Bronx,6520114.092,Throgs Neck-Schuylerville
21-Jun,36005013200,2013200,1945,8155,10100,Bronx,6520114.092,Throgs Neck-Schuylerville
19-Jul,36005013200,2013200,10556,59408,69964,Bronx,6520114.092,Throgs Neck-Schuylerville
21-Jul,36005013200,2013200,6391,71,6462,Bronx,6520114.092,Throgs Neck-Schuylerville
19-Aug,36005013200,2013200,15444,126183,141627,Bronx,6520114.092,Throgs Neck-Schuylerville
21-Aug,36005013200,2013200,12822,4380,17202,Bronx,6520114.092,Throgs Neck-Schuylerville
19-May,36005013300,2013300,14807,99293,114100,Bronx,1734820.292,Morrisania
21-May,36005013300,2013300,9765,20034,29799,Bronx,1734820.292,Morrisania
19-Jun,36005013300,2013300,12292,72054,84346,Bronx,1734820.292,Morrisania
21-Jun,36005013300,2013300,11871,116119,127990,Bronx,1734820.292,Morrisania
19-Jul,36005013300,2013300,6212,67753,73965,Bronx,1734820.292,Morrisania
21-Jul,36005013300,2013300,3405,34977,38382,Bronx,1734820.292,Morrisania
19-Aug,36005013300,2013300,9366,106516,115882,Bronx,1734820.292,Morrisania
21-Aug,36005013300,2013300,8431,85657,94088,Bronx,1734820.292,Morrisania
19-May,36005013500,2013500,18076,63747,81823,Bronx,1807152.915,Morrisania
21-May,36005013500,2013500,4834,94911,99745,Bronx,1807152.915,Morrisania
19-Jun,36005013500,2013500,10173,91968,102141,Bronx,1807152.915,Morrisania
21-Jun,36005013500,2013500,12795,42772,55567,Bronx,1807152.915,Morrisania
19-Jul,36005013500,2013500,3138,57906,61044,Bronx,1807152.915,Morrisania
21-Jul,36005013500,2013500,6690,68235,74925,Bronx,1807152.915,Morrisania
19-Aug,36005013500,2013500,2349,14340,16689,Bronx,1807152.915,Morrisania
21-Aug,36005013500,2013500,4236,56153,60389,Bronx,1807152.915,Morrisania
19-May,36005014400,2014400,10880,10396,21276,Bronx,4326450.928,Throgs Neck-Schuylerville
21-May,36005014400,2014400,12611,121924,134535,Bronx,4326450.928,Throgs Neck-Schuylerville
19-Jun,36005014400,2014400,9263,57342,66605,Bronx,4326450.928,Throgs Neck-Schuylerville
21-Jun,36005014400,2014400,8031,57151,65182,Bronx,4326450.928,Throgs Neck-Schuylerville
19-Jul,36005014400,2014400,7205,128332,135537,Bronx,4326450.928,Throgs Neck-Schuylerville
21-Jul,36005014400,2014400,0,18353,18353,Bronx,4326450.928,Throgs Neck-Schuylerville
19-Aug,36005014400,2014400,7050,97344,104394,Bronx,4326450.928,Throgs Neck-Schuylerville
21-Aug,36005014400,2014400,18601,55408,74009,Bronx,4326450.928,Throgs Neck-Schuylerville
19-May,36005014900,2014900,8241,2674,10915,Bronx,1677784.786,Morrisania
21-May,36005014900,2014900,9420,31159,40579,Bronx,1677784.786,Morrisania
19-Jun,36005014900,2014900,5836,58777,64613,Bronx,1677784.786,Morrisania
21-Jun,36005014900,2014900,6701,103437,110138,Bronx,1677784.786,Morrisania
19-Jul,36005014900,2014900,18832,49756,68588,Bronx,1677784.786,Morrisania
21-Jul,36005014900,2014900,0,56292,56292,Bronx,1677784.786,Morrisania
19-Aug,36005014900,2014900,5167,8486,13653,Bronx,1677784.786,Morrisania
21-Aug,36005014900,2014900,4641,63843,68484,Bronx,1677784.786,Morrisania
19-May,36005015200,2015200,6628,116210,122838,Bronx,3050706.492,Throgs Neck-Schuylerville
21-May,36005015200,2015200,7321,49534,56855,Bronx,3050706.492,Throgs Neck-Schuylerville
19-Jun,36005015200,2015200,15826,125569,141395,Bronx,3050706.492,Throgs Neck-Schuylerville
21-Jun,36005015200,2015200,14992,49575,64567,Bronx,3050706.492,Throgs Neck-Schuylerville
19-Jul,36005015200,2015200,3357,51937,55294,Bronx,3050706.492,Throgs Neck-Schuylerville
21-Jul,36005015200,2015200,14676,67487,82163,Bronx,3050706.492,Throgs Neck-Schuylerville
19-Aug,36005015200,2015200,11952,70023,81975,Bronx,3050706.492,Throgs Neck-Schuylerville
21-Aug,36005015200,2015200,4776,16447,21223,Bronx,3050706.492,Throgs Neck-Schuylerville
19-May,36005015300,2015300,4959,18346,23305,Bronx,2522690.201,Crotona Park East
21-May,36005015300,2015300,4239,36228,40467,Bronx,2522690.201,Crotona Park East
19-Jun,36005015300,2015300,11105,46055,57160,Bronx,2522690.201,Crotona Park East
21-Jun,36005015300,2015300,4201,65843,70044,Bronx,2522690.201,Crotona Park East
19-Jul,36005015300,2015300,11809,121067,132876,Bronx,2522690.201,Crotona Park East
21-Jul,36005015300,2015300,16729,66880,83609,Bronx,2522690.201,Crotona Park East
19-Aug,36005015300,2015300,4821,117217,122038,Bronx,2522690.201,Crotona Park East
21-Aug,36005015300,2015300,3270,99433,102703,Bronx,2522690.201,Crotona Park East
19-May,36005015800,2015800,6267,73858,80125,Bronx,1751816.316,Throgs Neck-Schuylerville
21-May,36005015800,2015800,7332,50737,58069,Bronx,1751816.316,Throgs Neck-Schuylerville
19-Jun,36005015800,2015800,11859,71,11930,Bronx,1751816.316,Throgs Neck-Schuylerville
21-Jun,36005015800,2015800,8862,11894,20756,Bronx,1751816.316,Throgs Neck-Schuylerville
19-Jul,36005015800,2015800,12622,23436,36058,Bronx,1751816.316,Throgs Neck-Schuylerville
21-Jul,36005015800,2015800,14645,83968,98613,Bronx,1751816.316,Throgs Neck-Schuylerville
19-Aug,36005015800,2015800,7111,98587,105698,Bronx,1751816.316,Throgs Neck-Schuylerville
21-Aug,36005015800,2015800,13863,121032,134895,Bronx,1751816.316,Throgs Neck-Schuylerville
19-May,36005016000,2016000,1554,98003,99557,Bronx,5532323.327,Throgs Neck-Schuylerville
21-May,36005016000,2016000,1052,20708,21760,Bronx,5532323.327,Throgs Neck-Schuylerville
19-Jun,36005016000,2016000,12225,126847,139072,Bronx,5532323.327,Throgs Neck-Schuylerville
21-Jun,36005016000,2016000,513,160847,161360,Bronx,5532323.327,Throgs Neck-Schuylerville
19-Jul,36005016000,2016000,2523,82074,84597,Bronx,5532323.327,Throgs Neck-Schuylerville
21-Jul,36005016000,2016000,5761,104200,109961,Bronx,5532323.327,Throgs Neck-Schuylerville
19-Aug,36005016000,2016000,8843,114389,123232,Bronx,5532323.327,Throgs Neck-Schuylerville
21-Aug,36005016000,2016000,11644,81603,93247,Bronx,5532323.327,Throgs Neck-Schuylerville
19-May,36005016200,2016200,0,88914,88914,Bronx,1944076.785,Throgs Neck-Schuylerville
21-May,36005016200,2016200,8077,108092,116169,Bronx,1944076.785,Throgs Neck-Schuylerville
19-Jun,36005016200,2016200,9106,41056,50162,Bronx,1944076.785,Throgs Neck-Schuylerville
21-Jun,36005016200,2016200,13522,142998,156520,Bronx,1944076.785,Throgs Neck-Schuylerville
19-Jul,36005016200,2016200,10781,53637,64418,Bronx,1944076.785,Throgs Neck-Schuylerville
21-Jul,36005016200,2016200,4857,99198,104055,Bronx,1944076.785,Throgs Neck-Schuylerville
19-Aug,36005016200,2016200,15596,98206,113802,Bronx,1944076.785,Throgs Neck-Schuylerville
21-Aug,36005016200,2016200,5800,58931,64731,Bronx,1944076.785,Throgs Neck-Schuylerville
19-May,36005016400,2016400,5400,90959,96359,Bronx,1768563.735,Throgs Neck-Schuylerville
21-May,36005016400,2016400,12946,96672,109618,Bronx,1768563.735,Throgs Neck-Schuylerville
19-Jun,36005016400,2016400,5867,82301,88168,Bronx,1768563.735,Throgs Neck-Schuylerville
21-Jun,36005016400,2016400,9013,34132,43145,Bronx,1768563.735,Throgs Neck-Schuylerville
19-Jul,36005016400,2016400,12578,36638,49216,Bronx,1768563.735,Throgs Neck-Schuylerville
21-Jul,36005016400,2016400,12823,56662,69485,Bronx,1768563.735,Throgs Neck-Schuylerville
19-Aug,36005016400,2016400,8034,93939,101973,Bronx,1768563.735,Throgs Neck-Schuylerville
21-Aug,36005016400,2016400,10175,34755,44930,Bronx,1768563.735,Throgs Neck-Schuylerville
19-May,36005017100,2017100,0,113480,113480,Bronx,1863712.181,Claremont Park
21-May,36005017100,2017100,11352,75719,87071,Bronx,1863712.181,Claremont Park
19-Jun,36005017100,2017100,9288,30941,40229,Bronx,1863712.181,Claremont Park
21-Jun,36005017100,2017100,5165,90017,95182,Bronx,1863712.181,Claremont Park
19-Jul,36005017100,2017100,10131,71,10202,Bronx,1863712.181,Claremont Park
21-Jul,36005017100,2017100,5427,94193,99620,Bronx,1863712.181,Claremont Park
19-Aug,36005017100,2017100,6728,158379,165107,Bronx,1863712.181,Claremont Park
21-Aug,36005017100,2017100,5045,60982,66027,Bronx,1863712.181,Claremont Park
19-May,36005017500,2017500,7599,70512,78111,Bronx,1631792.141,Concourse-Concourse Village
21-May,36005017500,2017500,7858,71,7929,Bronx,1631792.141,Concourse-Concourse Village
19-Jun,36005017500,2017500,3253,75159,78412,Bronx,1631792.141,Concourse-Concourse Village
21-Jun,36005017500,2017500,2432,149787,152219,Bronx,1631792.141,Concourse-Concourse Village
19-Jul,36005017500,2017500,5216,93469,98685,Bronx,1631792.141,Concourse-Concourse Village
21-Jul,36005017500,2017500,8216,81539,89755,Bronx,1631792.141,Concourse-Concourse Village
19-Aug,36005017500,2017500,3213,70815,74028,Bronx,1631792.141,Concourse-Concourse Village
21-Aug,36005017500,2017500,1290,124756,126046,Bronx,1631792.141,Concourse-Concourse Village
19-May,36005017901,2017901,7775,117356,125131,Bronx,825937.0746,Concourse-Concourse Village
21-May,36005017901,2017901,965,49566,50531,Bronx,825937.0746,Concourse-Concourse Village
19-Jun,36005017901,2017901,5915,75941,81856,Bronx,825937.0746,Concourse-Concourse Village
21-Jun,36005017901,2017901,10719,79286,90005,Bronx,825937.0746,Concourse-Concourse Village
19-Jul,36005017901,2017901,10663,146810,157473,Bronx,825937.0746,Concourse-Concourse Village
21-Jul,36005017901,2017901,3334,96608,99942,Bronx,825937.0746,Concourse-Concourse Village
19-Aug,36005017901,2017901,8204,67881,76085,Bronx,825937.0746,Concourse-Concourse Village
21-Aug,36005017901,2017901,14158,53027,67185,Bronx,825937.0746,Concourse-Concourse Village
19-May,36005017902,2017902,1887,56751,58638,Bronx,827548.2874,Mount Eden-Claremont (West)
21-May,36005017902,2017902,5318,23562,28880,Bronx,827548.2874,Mount Eden-Claremont (West)
19-Jun,36005017902,2017902,11307,108850,120157,Bronx,827548.2874,Mount Eden-Claremont (West)
21-Jun,36005017902,2017902,13234,40582,53816,Bronx,827548.2874,Mount Eden-Claremont (West)
19-Jul,36005017902,2017902,13207,86945,100152,Bronx,827548.2874,Mount Eden-Claremont (West)
21-Jul,36005017902,2017902,3144,141663,144807,Bronx,827548.2874,Mount Eden-Claremont (West)
19-Aug,36005017902,2017902,16648,88429,105077,Bronx,827548.2874,Mount Eden-Claremont (West)
21-Aug,36005017902,2017902,8199,26368,34567,Bronx,827548.2874,Mount Eden-Claremont (West)
19-May,36005018101,2018101,10864,91852,102716,Bronx,831113.0439,Concourse-Concourse Village
21-May,36005018101,2018101,9845,99275,109120,Bronx,831113.0439,Concourse-Concourse Village
19-Jun,36005018101,2018101,5367,33997,39364,Bronx,831113.0439,Concourse-Concourse Village
21-Jun,36005018101,2018101,15520,65138,80658,Bronx,831113.0439,Concourse-Concourse Village
19-Jul,36005018101,2018101,10393,76777,87170,Bronx,831113.0439,Concourse-Concourse Village
21-Jul,36005018101,2018101,9049,56753,65802,Bronx,831113.0439,Concourse-Concourse Village
19-Aug,36005018101,2018101,10318,83954,94272,Bronx,831113.0439,Concourse-Concourse Village
21-Aug,36005018101,2018101,8340,54364,62704,Bronx,831113.0439,Concourse-Concourse Village
19-May,36005018102,2018102,3150,92541,95691,Bronx,1040364.56,Concourse-Concourse Village
21-May,36005018102,2018102,5912,105345,111257,Bronx,1040364.56,Concourse-Concourse Village
19-Jun,36005018102,2018102,0,99357,99357,Bronx,1040364.56,Concourse-Concourse Village
21-Jun,36005018102,2018102,4571,88756,93327,Bronx,1040364.56,Concourse-Concourse Village
19-Jul,36005018102,2018102,10994,53729,64723,Bronx,1040364.56,Concourse-Concourse Village
21-Jul,36005018102,2018102,7537,109901,117438,Bronx,1040364.56,Concourse-Concourse Village
19-Aug,36005018102,2018102,3189,78996,82185,Bronx,1040364.56,Concourse-Concourse Village
21-Aug,36005018102,2018102,10169,28007,38176,Bronx,1040364.56,Concourse-Concourse Village
19-May,36005018302,2018302,8079,102932,111011,Bronx,1208595.544,Concourse-Concourse Village
21-May,36005018302,2018302,6207,63214,69421,Bronx,1208595.544,Concourse-Concourse Village
19-Jun,36005018302,2018302,2957,56548,59505,Bronx,1208595.544,Concourse-Concourse Village
21-Jun,36005018302,2018302,6736,139689,146425,Bronx,1208595.544,Concourse-Concourse Village
19-Jul,36005018302,2018302,10573,107268,117841,Bronx,1208595.544,Concourse-Concourse Village
21-Jul,36005018302,2018302,1953,99009,100962,Bronx,1208595.544,Concourse-Concourse Village
19-Aug,36005018302,2018302,18600,26709,45309,Bronx,1208595.544,Concourse-Concourse Village
21-Aug,36005018302,2018302,12777,71,12848,Bronx,1208595.544,Concourse-Concourse Village
19-May,36005018400,2018400,6821,120279,127100,Bronx,4814309.566,Throgs Neck-Schuylerville
21-May,36005018400,2018400,10431,37853,48284,Bronx,4814309.566,Throgs Neck-Schuylerville
19-Jun,36005018400,2018400,7049,119223,126272,Bronx,4814309.566,Throgs Neck-Schuylerville
21-Jun,36005018400,2018400,5720,73785,79505,Bronx,4814309.566,Throgs Neck-Schuylerville
19-Jul,36005018400,2018400,0,17928,17928,Bronx,4814309.566,Throgs Neck-Schuylerville
21-Jul,36005018400,2018400,13551,56312,69863,Bronx,4814309.566,Throgs Neck-Schuylerville
19-Aug,36005018400,2018400,9913,86469,96382,Bronx,4814309.566,Throgs Neck-Schuylerville
21-Aug,36005018400,2018400,2009,112601,114610,Bronx,4814309.566,Throgs Neck-Schuylerville
19-May,36005019700,2019700,10770,10504,21274,Bronx,1592663.294,Concourse-Concourse Village
21-May,36005019700,2019700,9148,71,9219,Bronx,1592663.294,Concourse-Concourse Village
19-Jun,36005019700,2019700,14570,18115,32685,Bronx,1592663.294,Concourse-Concourse Village
21-Jun,36005019700,2019700,4793,57011,61804,Bronx,1592663.294,Concourse-Concourse Village
19-Jul,36005019700,2019700,9478,132266,141744,Bronx,1592663.294,Concourse-Concourse Village
21-Jul,36005019700,2019700,6689,74088,80777,Bronx,1592663.294,Concourse-Concourse Village
19-Aug,36005019700,2019700,17984,86031,104015,Bronx,1592663.294,Concourse-Concourse Village
21-Aug,36005019700,2019700,9956,118402,128358,Bronx,1592663.294,Concourse-Concourse Village
19-May,36005020200,2020200,2217,57532,59749,Bronx,1343331.033,Westchester Square
21-May,36005020200,2020200,6734,19793,26527,Bronx,1343331.033,Westchester Square
19-Jun,36005020200,2020200,11737,50463,62200,Bronx,1343331.033,Westchester Square
21-Jun,36005020200,2020200,10355,96143,106498,Bronx,1343331.033,Westchester Square
19-Jul,36005020200,2020200,5787,71,5858,Bronx,1343331.033,Westchester Square
21-Jul,36005020200,2020200,12406,70511,82917,Bronx,1343331.033,Westchester Square
19-Aug,36005020200,2020200,7759,69316,77075,Bronx,1343331.033,Westchester Square
21-Aug,36005020200,2020200,11537,24910,36447,Bronx,1343331.033,Westchester Square
19-May,36005020400,2020400,13346,165802,179148,Bronx,1447956.023,Westchester Square
21-May,36005020400,2020400,10805,67307,78112,Bronx,1447956.023,Westchester Square
19-Jun,36005020400,2020400,11740,85713,97453,Bronx,1447956.023,Westchester Square
21-Jun,36005020400,2020400,2456,40494,42950,Bronx,1447956.023,Westchester Square
19-Jul,36005020400,2020400,7015,21463,28478,Bronx,1447956.023,Westchester Square
21-Jul,36005020400,2020400,0,87250,87250,Bronx,1447956.023,Westchester Square
19-Aug,36005020400,2020400,5629,35776,41405,Bronx,1447956.023,Westchester Square
21-Aug,36005020400,2020400,11464,39317,50781,Bronx,1447956.023,Westchester Square
19-May,36005020601,2020601,6799,83855,90654,Bronx,1629908.821,Westchester Square
21-May,36005020601,2020601,5238,25818,31056,Bronx,1629908.821,Westchester Square
19-Jun,36005020601,2020601,4640,116936,121576,Bronx,1629908.821,Westchester Square
21-Jun,36005020601,2020601,10772,27770,38542,Bronx,1629908.821,Westchester Square
19-Jul,36005020601,2020601,7240,57240,64480,Bronx,1629908.821,Westchester Square
21-Jul,36005020601,2020601,7213,136573,143786,Bronx,1629908.821,Westchester Square
19-Aug,36005020601,2020601,2988,95658,98646,Bronx,1629908.821,Westchester Square
21-Aug,36005020601,2020601,3125,59608,62733,Bronx,1629908.821,Westchester Square
19-May,36005020900,2020900,8657,64424,73081,Bronx,1429575.335,Mount Eden-Claremont (West)
21-May,36005020900,2020900,10838,85308,96146,Bronx,1429575.335,Mount Eden-Claremont (West)
19-Jun,36005020900,2020900,10108,59918,70026,Bronx,1429575.335,Mount Eden-Claremont (West)
21-Jun,36005020900,2020900,3289,91037,94326,Bronx,1429575.335,Mount Eden-Claremont (West)
19-Jul,36005020900,2020900,4188,62931,67119,Bronx,1429575.335,Mount Eden-Claremont (West)
21-Jul,36005020900,2020900,0,71,71,Bronx,1429575.335,Mount Eden-Claremont (West)
19-Aug,36005020900,2020900,12917,147374,160291,Bronx,1429575.335,Mount Eden-Claremont (West)
21-Aug,36005020900,2020900,6262,17882,24144,Bronx,1429575.335,Mount Eden-Claremont (West)
19-May,36005021002,2021002,0,54109,54109,Bronx,1867344.603,Parkchester
21-May,36005021002,2021002,11529,106185,117714,Bronx,1867344.603,Parkchester
19-Jun,36005021002,2021002,6652,102413,109065,Bronx,1867344.603,Parkchester
21-Jun,36005021002,2021002,17668,71,17739,Bronx,1867344.603,Parkchester
19-Jul,36005021002,2021002,4480,41282,45762,Bronx,1867344.603,Parkchester
21-Jul,36005021002,2021002,11108,132482,143590,Bronx,1867344.603,Parkchester
19-Aug,36005021002,2021002,11099,104979,116078,Bronx,1867344.603,Parkchester
21-Aug,36005021002,2021002,13694,33635,47329,Bronx,1867344.603,Parkchester
19-May,36005021301,2021301,16765,49438,66203,Bronx,660910.2265,University Heights (South)-Morris Heights
21-May,36005021301,2021301,8190,96130,104320,Bronx,660910.2265,University Heights (South)-Morris Heights
19-Jun,36005021301,2021301,4262,62665,66927,Bronx,660910.2265,University Heights (South)-Morris Heights
21-Jun,36005021301,2021301,12765,71,12836,Bronx,660910.2265,University Heights (South)-Morris Heights
19-Jul,36005021301,2021301,19207,134263,153470,Bronx,660910.2265,University Heights (South)-Morris Heights
21-Jul,36005021301,2021301,11473,142220,153693,Bronx,660910.2265,University Heights (South)-Morris Heights
19-Aug,36005021301,2021301,6828,78209,85037,Bronx,660910.2265,University Heights (South)-Morris Heights
21-Aug,36005021301,2021301,4874,107707,112581,Bronx,660910.2265,University Heights (South)-Morris Heights
19-May,36005021302,2021302,19502,45000,64502,Bronx,1812687.533,Mount Eden-Claremont (West)
21-May,36005021302,2021302,14675,38077,52752,Bronx,1812687.533,Mount Eden-Claremont (West)
19-Jun,36005021302,2021302,5110,54060,59170,Bronx,1812687.533,Mount Eden-Claremont (West)
21-Jun,36005021302,2021302,17933,94737,112670,Bronx,1812687.533,Mount Eden-Claremont (West)
19-Jul,36005021302,2021302,2484,81377,83861,Bronx,1812687.533,Mount Eden-Claremont (West)
21-Jul,36005021302,2021302,11458,90011,101469,Bronx,1812687.533,Mount Eden-Claremont (West)
19-Aug,36005021302,2021302,2972,121013,123985,Bronx,1812687.533,Mount Eden-Claremont (West)
21-Aug,36005021302,2021302,13957,89373,103330,Bronx,1812687.533,Mount Eden-Claremont (West)
19-May,36005021501,2021501,6013,105639,111652,Bronx,986700.6514,University Heights (South)-Morris Heights
21-May,36005021501,2021501,11995,59853,71848,Bronx,986700.6514,University Heights (South)-Morris Heights
19-Jun,36005021501,2021501,6140,96710,102850,Bronx,986700.6514,University Heights (South)-Morris Heights
21-Jun,36005021501,2021501,4131,63958,68089,Bronx,986700.6514,University Heights (South)-Morris Heights
19-Jul,36005021501,2021501,14401,87669,102070,Bronx,986700.6514,University Heights (South)-Morris Heights
21-Jul,36005021501,2021501,16779,86342,103121,Bronx,986700.6514,University Heights (South)-Morris Heights
19-Aug,36005021501,2021501,4339,57476,61815,Bronx,986700.6514,University Heights (South)-Morris Heights
21-Aug,36005021501,2021501,5224,62147,67371,Bronx,986700.6514,University Heights (South)-Morris Heights
19-May,36005021800,2021800,0,76262,76262,Bronx,3233495.523,Soundview-Bruckner-Bronx River
21-May,36005021800,2021800,19323,61871,81194,Bronx,3233495.523,Soundview-Bruckner-Bronx River
19-Jun,36005021800,2021800,11057,72980,84037,Bronx,3233495.523,Soundview-Bruckner-Bronx River
21-Jun,36005021800,2021800,7415,109874,117289,Bronx,3233495.523,Soundview-Bruckner-Bronx River
19-Jul,36005021800,2021800,3941,68127,72068,Bronx,3233495.523,Soundview-Bruckner-Bronx River
21-Jul,36005021800,2021800,9595,89058,98653,Bronx,3233495.523,Soundview-Bruckner-Bronx River
19-Aug,36005021800,2021800,14156,82942,97098,Bronx,3233495.523,Soundview-Bruckner-Bronx River
21-Aug,36005021800,2021800,18836,157340,176176,Bronx,3233495.523,Soundview-Bruckner-Bronx River
19-May,36005021900,2021900,16894,18748,35642,Bronx,1551551.824,Mount Eden-Claremont (West)
21-May,36005021900,2021900,1996,82918,84914,Bronx,1551551.824,Mount Eden-Claremont (West)
19-Jun,36005021900,2021900,8738,66853,75591,Bronx,1551551.824,Mount Eden-Claremont (West)
21-Jun,36005021900,2021900,9677,66788,76465,Bronx,1551551.824,Mount Eden-Claremont (West)
19-Jul,36005021900,2021900,9531,105521,115052,Bronx,1551551.824,Mount Eden-Claremont (West)
21-Jul,36005021900,2021900,1122,71,1193,Bronx,1551551.824,Mount Eden-Claremont (West)
19-Aug,36005021900,2021900,6294,81773,88067,Bronx,1551551.824,Mount Eden-Claremont (West)
21-Aug,36005021900,2021900,9895,49999,59894,Bronx,1551551.824,Mount Eden-Claremont (West)
19-May,36005022101,2022101,7931,96750,104681,Bronx,732245.1122,Mount Eden-Claremont (West)
21-May,36005022101,2022101,1556,31998,33554,Bronx,732245.1122,Mount Eden-Claremont (West)
19-Jun,36005022101,2022101,8294,47301,55595,Bronx,732245.1122,Mount Eden-Claremont (West)
21-Jun,36005022101,2022101,10659,96128,106787,Bronx,732245.1122,Mount Eden-Claremont (West)
19-Jul,36005022101,2022101,11081,72633,83714,Bronx,732245.1122,Mount Eden-Claremont (West)
21-Jul,36005022101,2022101,10454,35939,46393,Bronx,732245.1122,Mount Eden-Claremont (West)
19-Aug,36005022101,2022101,2884,71,2955,Bronx,732245.1122,Mount Eden-Claremont (West)
21-Aug,36005022101,2022101,11432,38569,50001,Bronx,732245.1122,Mount Eden-Claremont (West)
19-May,36005022102,2022102,13736,62841,76577,Bronx,842620.1287,Mount Eden-Claremont (West)
21-May,36005022102,2022102,18209,106583,124792,Bronx,842620.1287,Mount Eden-Claremont (West)
19-Jun,36005022102,2022102,8733,31337,40070,Bronx,842620.1287,Mount Eden-Claremont (West)
21-Jun,36005022102,2022102,7255,152799,160054,Bronx,842620.1287,Mount Eden-Claremont (West)
19-Jul,36005022102,2022102,14264,67031,81295,Bronx,842620.1287,Mount Eden-Claremont (West)
21-Jul,36005022102,2022102,16565,70538,87103,Bronx,842620.1287,Mount Eden-Claremont (West)
19-Aug,36005022102,2022102,5302,146024,151326,Bronx,842620.1287,Mount Eden-Claremont (West)
21-Aug,36005022102,2022102,7311,117038,124349,Bronx,842620.1287,Mount Eden-Claremont (West)
19-May,36005022300,2022300,5690,66247,71937,Bronx,1001578.161,Mount Eden-Claremont (West)
21-May,36005022300,2022300,0,48114,48114,Bronx,1001578.161,Mount Eden-Claremont (West)
19-Jun,36005022300,2022300,8447,102343,110790,Bronx,1001578.161,Mount Eden-Claremont (West)
21-Jun,36005022300,2022300,0,113322,113322,Bronx,1001578.161,Mount Eden-Claremont (West)
19-Jul,36005022300,2022300,13029,66696,79725,Bronx,1001578.161,Mount Eden-Claremont (West)
21-Jul,36005022300,2022300,14034,82651,96685,Bronx,1001578.161,Mount Eden-Claremont (West)
19-Aug,36005022300,2022300,5903,71,5974,Bronx,1001578.161,Mount Eden-Claremont (West)
21-Aug,36005022300,2022300,8529,53307,61836,Bronx,1001578.161,Mount Eden-Claremont (West)
19-May,36005022403,2022403,7275,14910,22185,Bronx,1338120.936,Pelham Parkway-Van Nest
21-May,36005022403,2022403,12776,78318,91094,Bronx,1338120.936,Pelham Parkway-Van Nest
19-Jun,36005022403,2022403,0,48307,48307,Bronx,1338120.936,Pelham Parkway-Van Nest
21-Jun,36005022403,2022403,21614,65361,86975,Bronx,1338120.936,Pelham Parkway-Van Nest
19-Jul,36005022403,2022403,2060,121483,123543,Bronx,1338120.936,Pelham Parkway-Van Nest
21-Jul,36005022403,2022403,6711,71,6782,Bronx,1338120.936,Pelham Parkway-Van Nest
19-Aug,36005022403,2022403,7003,113655,120658,Bronx,1338120.936,Pelham Parkway-Van Nest
21-Aug,36005022403,2022403,0,146643,146643,Bronx,1338120.936,Pelham Parkway-Van Nest
19-May,36005022404,2022404,12823,76829,89652,Bronx,999998.0109,Pelham Parkway-Van Nest
21-May,36005022404,2022404,6338,55936,62274,Bronx,999998.0109,Pelham Parkway-Van Nest
19-Jun,36005022404,2022404,9755,71,9826,Bronx,999998.0109,Pelham Parkway-Van Nest
21-Jun,36005022404,2022404,2827,23386,26213,Bronx,999998.0109,Pelham Parkway-Van Nest
19-Jul,36005022404,2022404,12902,49941,62843,Bronx,999998.0109,Pelham Parkway-Van Nest
21-Jul,36005022404,2022404,3394,81403,84797,Bronx,999998.0109,Pelham Parkway-Van Nest
19-Aug,36005022404,2022404,5413,115433,120846,Bronx,999998.0109,Pelham Parkway-Van Nest
21-Aug,36005022404,2022404,4202,51248,55450,Bronx,999998.0109,Pelham Parkway-Van Nest
19-May,36005022500,2022500,6831,93366,100197,Bronx,1953063.117,Mount Eden-Claremont (West)
21-May,36005022500,2022500,7734,114285,122019,Bronx,1953063.117,Mount Eden-Claremont (West)
19-Jun,36005022500,2022500,9143,110137,119280,Bronx,1953063.117,Mount Eden-Claremont (West)
21-Jun,36005022500,2022500,13159,68284,81443,Bronx,1953063.117,Mount Eden-Claremont (West)
19-Jul,36005022500,2022500,5104,8107,13211,Bronx,1953063.117,Mount Eden-Claremont (West)
21-Jul,36005022500,2022500,10827,33834,44661,Bronx,1953063.117,Mount Eden-Claremont (West)
19-Aug,36005022500,2022500,7656,64983,72639,Bronx,1953063.117,Mount Eden-Claremont (West)
21-Aug,36005022500,2022500,4780,80478,85258,Bronx,1953063.117,Mount Eden-Claremont (West)
19-May,36005022702,2022702,3775,67394,71169,Bronx,523884.2467,Mount Eden-Claremont (West)
21-May,36005022702,2022702,7541,46908,54449,Bronx,523884.2467,Mount Eden-Claremont (West)
19-Jun,36005022702,2022702,8252,89268,97520,Bronx,523884.2467,Mount Eden-Claremont (West)
21-Jun,36005022702,2022702,22298,42817,65115,Bronx,523884.2467,Mount Eden-Claremont (West)
19-Jul,36005022702,2022702,7605,56318,63923,Bronx,523884.2467,Mount Eden-Claremont (West)
21-Jul,36005022702,2022702,1946,161195,163141,Bronx,523884.2467,Mount Eden-Claremont (West)
19-Aug,36005022702,2022702,17902,69619,87521,Bronx,523884.2467,Mount Eden-Claremont (West)
21-Aug,36005022702,2022702,13038,56716,69754,Bronx,523884.2467,Mount Eden-Claremont (West)
19-May,36005022703,2022703,2837,49837,52674,Bronx,420601.0915,Mount Eden-Claremont (West)
21-May,36005022703,2022703,7732,96303,104035,Bronx,420601.0915,Mount Eden-Claremont (West)
19-Jun,36005022703,2022703,3742,100527,104269,Bronx,420601.0915,Mount Eden-Claremont (West)
21-Jun,36005022703,2022703,19131,73421,92552,Bronx,420601.0915,Mount Eden-Claremont (West)
19-Jul,36005022703,2022703,7201,137985,145186,Bronx,420601.0915,Mount Eden-Claremont (West)
21-Jul,36005022703,2022703,11263,99411,110674,Bronx,420601.0915,Mount Eden-Claremont (West)
19-Aug,36005022703,2022703,10727,126189,136916,Bronx,420601.0915,Mount Eden-Claremont (West)
21-Aug,36005022703,2022703,10887,61062,71949,Bronx,420601.0915,Mount Eden-Claremont (West)
19-May,36005022800,2022800,0,92368,92368,Bronx,1851825.718,Pelham Parkway-Van Nest
21-May,36005022800,2022800,5740,40295,46035,Bronx,1851825.718,Pelham Parkway-Van Nest
19-Jun,36005022800,2022800,9694,79478,89172,Bronx,1851825.718,Pelham Parkway-Van Nest
21-Jun,36005022800,2022800,11054,50347,61401,Bronx,1851825.718,Pelham Parkway-Van Nest
19-Jul,36005022800,2022800,9056,72936,81992,Bronx,1851825.718,Pelham Parkway-Van Nest
21-Jul,36005022800,2022800,4671,99921,104592,Bronx,1851825.718,Pelham Parkway-Van Nest
19-Aug,36005022800,2022800,11981,103765,115746,Bronx,1851825.718,Pelham Parkway-Van Nest
21-Aug,36005022800,2022800,24952,71,25023,Bronx,1851825.718,Pelham Parkway-Van Nest
19-May,36005022902,2022902,5187,94354,99541,Bronx,995810.3917,Mount Eden-Claremont (West)
21-May,36005022902,2022902,0,48083,48083,Bronx,995810.3917,Mount Eden-Claremont (West)
19-Jun,36005022902,2022902,11663,52945,64608,Bronx,995810.3917,Mount Eden-Claremont (West)
21-Jun,36005022902,2022902,2057,36840,38897,Bronx,995810.3917,Mount Eden-Claremont (West)
19-Jul,36005022902,2022902,9862,109005,118867,Bronx,995810.3917,Mount Eden-Claremont (West)
21-Jul,36005022902,2022902,14825,73712,88537,Bronx,995810.3917,Mount Eden-Claremont (West)
19-Aug,36005022902,2022902,4328,91938,96266,Bronx,995810.3917,Mount Eden-Claremont (West)
21-Aug,36005022902,2022902,10253,9106,19359,Bronx,995810.3917,Mount Eden-Claremont (West)
19-May,36005023200,2023200,1196,85172,86368,Bronx,1536082.344,Pelham Parkway-Van Nest
21-May,36005023200,2023200,5053,92504,97557,Bronx,1536082.344,Pelham Parkway-Van Nest
19-Jun,36005023200,2023200,6007,90319,96326,Bronx,1536082.344,Pelham Parkway-Van Nest
21-Jun,36005023200,2023200,8267,146276,154543,Bronx,1536082.344,Pelham Parkway-Van Nest
19-Jul,36005023200,2023200,1779,24556,26335,Bronx,1536082.344,Pelham Parkway-Van Nest
21-Jul,36005023200,2023200,9228,42200,51428,Bronx,1536082.344,Pelham Parkway-Van Nest
19-Aug,36005023200,2023200,7519,128094,135613,Bronx,1536082.344,Pelham Parkway-Van Nest
21-Aug,36005023200,2023200,9622,10593,20215,Bronx,1536082.344,Pelham Parkway-Van Nest
19-May,36005023301,2023301,9935,36505,46440,Bronx,1267798.769,Mount Hope
21-May,36005023301,2023301,15108,26997,42105,Bronx,1267798.769,Mount Hope
19-Jun,36005023301,2023301,2338,108058,110396,Bronx,1267798.769,Mount Hope
21-Jun,36005023301,2023301,9970,101824,111794,Bronx,1267798.769,Mount Hope
19-Jul,36005023301,2023301,1084,33167,34251,Bronx,1267798.769,Mount Hope
21-Jul,36005023301,2023301,0,78069,78069,Bronx,1267798.769,Mount Hope
19-Aug,36005023301,2023301,0,128504,128504,Bronx,1267798.769,Mount Hope
21-Aug,36005023301,2023301,8567,94157,102724,Bronx,1267798.769,Mount Hope
19-May,36005023600,2023600,4459,52240,56699,Bronx,989504.9447,Pelham Parkway-Van Nest
21-May,36005023600,2023600,2944,26885,29829,Bronx,989504.9447,Pelham Parkway-Van Nest
19-Jun,36005023600,2023600,2384,74102,76486,Bronx,989504.9447,Pelham Parkway-Van Nest
21-Jun,36005023600,2023600,8821,20714,29535,Bronx,989504.9447,Pelham Parkway-Van Nest
19-Jul,36005023600,2023600,13864,53917,67781,Bronx,989504.9447,Pelham Parkway-Van Nest
21-Jul,36005023600,2023600,1980,67182,69162,Bronx,989504.9447,Pelham Parkway-Van Nest
19-Aug,36005023600,2023600,11994,113063,125057,Bronx,989504.9447,Pelham Parkway-Van Nest
21-Aug,36005023600,2023600,1818,40028,41846,Bronx,989504.9447,Pelham Parkway-Van Nest
19-May,36005023704,2023704,18283,90671,108954,Bronx,728192.347,Fordham Heights
21-May,36005023704,2023704,10039,76595,86634,Bronx,728192.347,Fordham Heights
19-Jun,36005023704,2023704,11179,78670,89849,Bronx,728192.347,Fordham Heights
21-Jun,36005023704,2023704,13612,26680,40292,Bronx,728192.347,Fordham Heights
19-Jul,36005023704,2023704,16025,50842,66867,Bronx,728192.347,Fordham Heights
21-Jul,36005023704,2023704,7360,89909,97269,Bronx,728192.347,Fordham Heights
19-Aug,36005023704,2023704,10622,81060,91682,Bronx,728192.347,Fordham Heights
21-Aug,36005023704,2023704,0,30143,30143,Bronx,728192.347,Fordham Heights
19-May,36005023900,2023900,3435,60261,63696,Bronx,1913174.942,Fordham Heights
21-May,36005023900,2023900,12613,83438,96051,Bronx,1913174.942,Fordham Heights
19-Jun,36005023900,2023900,7457,102054,109511,Bronx,1913174.942,Fordham Heights
21-Jun,36005023900,2023900,5332,101449,106781,Bronx,1913174.942,Fordham Heights
19-Jul,36005023900,2023900,15071,85365,100436,Bronx,1913174.942,Fordham Heights
21-Jul,36005023900,2023900,6220,136137,142357,Bronx,1913174.942,Fordham Heights
19-Aug,36005023900,2023900,10584,37406,47990,Bronx,1913174.942,Fordham Heights
21-Aug,36005023900,2023900,15080,14177,29257,Bronx,1913174.942,Fordham Heights
19-May,36005024100,2024100,15881,77168,93049,Bronx,1447513.792,Mount Hope
21-May,36005024100,2024100,15909,26315,42224,Bronx,1447513.792,Mount Hope
19-Jun,36005024100,2024100,3209,113450,116659,Bronx,1447513.792,Mount Hope
21-Jun,36005024100,2024100,6330,35803,42133,Bronx,1447513.792,Mount Hope
19-Jul,36005024100,2024100,11759,151107,162866,Bronx,1447513.792,Mount Hope
21-Jul,36005024100,2024100,7920,14698,22618,Bronx,1447513.792,Mount Hope
19-Aug,36005024100,2024100,7784,76129,83913,Bronx,1447513.792,Mount Hope
21-Aug,36005024100,2024100,13074,72779,85853,Bronx,1447513.792,Mount Hope
19-May,36005024300,2024300,7101,71043,78144,Bronx,1608003.82,University Heights (South)-Morris Heights
21-May,36005024300,2024300,1648,49097,50745,Bronx,1608003.82,University Heights (South)-Morris Heights
19-Jun,36005024300,2024300,12348,87534,99882,Bronx,1608003.82,University Heights (South)-Morris Heights
21-Jun,36005024300,2024300,20631,46768,67399,Bronx,1608003.82,University Heights (South)-Morris Heights
19-Jul,36005024300,2024300,11747,55149,66896,Bronx,1608003.82,University Heights (South)-Morris Heights
21-Jul,36005024300,2024300,7193,151253,158446,Bronx,1608003.82,University Heights (South)-Morris Heights
19-Aug,36005024300,2024300,6803,47032,53835,Bronx,1608003.82,University Heights (South)-Morris Heights
21-Aug,36005024300,2024300,23206,149413,172619,Bronx,1608003.82,University Heights (South)-Morris Heights
19-May,36005024400,2024400,13965,53982,67947,Bronx,1892754.112,Morris Park
21-May,36005024400,2024400,11031,105168,116199,Bronx,1892754.112,Morris Park
19-Jun,36005024400,2024400,0,74033,74033,Bronx,1892754.112,Morris Park
21-Jun,36005024400,2024400,14830,30865,45695,Bronx,1892754.112,Morris Park
19-Jul,36005024400,2024400,10195,66279,76474,Bronx,1892754.112,Morris Park
21-Jul,36005024400,2024400,12208,139095,151303,Bronx,1892754.112,Morris Park
19-Aug,36005024400,2024400,9106,30075,39181,Bronx,1892754.112,Morris Park
21-Aug,36005024400,2024400,5167,75960,81127,Bronx,1892754.112,Morris Park
19-May,36005024501,2024501,13642,42161,55803,Bronx,1229662.708,University Heights (South)-Morris Heights
21-May,36005024501,2024501,6113,65704,71817,Bronx,1229662.708,University Heights (South)-Morris Heights
19-Jun,36005024501,2024501,11268,94073,105341,Bronx,1229662.708,University Heights (South)-Morris Heights
21-Jun,36005024501,2024501,5097,137476,142573,Bronx,1229662.708,University Heights (South)-Morris Heights
19-Jul,36005024501,2024501,6536,39469,46005,Bronx,1229662.708,University Heights (South)-Morris Heights
21-Jul,36005024501,2024501,12895,49308,62203,Bronx,1229662.708,University Heights (South)-Morris Heights
19-Aug,36005024501,2024501,3653,93617,97270,Bronx,1229662.708,University Heights (South)-Morris Heights
21-Aug,36005024501,2024501,4817,87828,92645,Bronx,1229662.708,University Heights (South)-Morris Heights
19-May,36005024502,2024502,3790,63576,67366,Bronx,1072966.533,University Heights (South)-Morris Heights
21-May,36005024502,2024502,4562,46255,50817,Bronx,1072966.533,University Heights (South)-Morris Heights
19-Jun,36005024502,2024502,2773,150033,152806,Bronx,1072966.533,University Heights (South)-Morris Heights
21-Jun,36005024502,2024502,6260,129199,135459,Bronx,1072966.533,University Heights (South)-Morris Heights
19-Jul,36005024502,2024502,12589,28839,41428,Bronx,1072966.533,University Heights (South)-Morris Heights
21-Jul,36005024502,2024502,9703,23054,32757,Bronx,1072966.533,University Heights (South)-Morris Heights
19-Aug,36005024502,2024502,9985,109227,119212,Bronx,1072966.533,University Heights (South)-Morris Heights
21-Aug,36005024502,2024502,13885,97014,110899,Bronx,1072966.533,University Heights (South)-Morris Heights
19-May,36005024600,2024600,6000,40262,46262,Bronx,1640625.734,Morris Park
21-May,36005024600,2024600,12149,76099,88248,Bronx,1640625.734,Morris Park
19-Jun,36005024600,2024600,3500,46650,50150,Bronx,1640625.734,Morris Park
21-Jun,36005024600,2024600,2271,53004,55275,Bronx,1640625.734,Morris Park
19-Jul,36005024600,2024600,3935,126603,130538,Bronx,1640625.734,Morris Park
21-Jul,36005024600,2024600,13050,77245,90295,Bronx,1640625.734,Morris Park
19-Aug,36005024600,2024600,1836,113915,115751,Bronx,1640625.734,Morris Park
21-Aug,36005024600,2024600,1106,30774,31880,Bronx,1640625.734,Morris Park
19-May,36005024800,2024800,18658,105078,123736,Bronx,2992858.757,Morris Park
21-May,36005024800,2024800,1024,103652,104676,Bronx,2992858.757,Morris Park
19-Jun,36005024800,2024800,3588,11992,15580,Bronx,2992858.757,Morris Park
21-Jun,36005024800,2024800,7035,133326,140361,Bronx,2992858.757,Morris Park
19-Jul,36005024800,2024800,11396,91399,102795,Bronx,2992858.757,Morris Park
21-Jul,36005024800,2024800,13931,35845,49776,Bronx,2992858.757,Morris Park
19-Aug,36005024800,2024800,19651,122583,142234,Bronx,2992858.757,Morris Park
21-Aug,36005024800,2024800,14905,100215,115120,Bronx,2992858.757,Morris Park
19-May,36005024900,2024900,7049,24237,31286,Bronx,1883272.79,University Heights (South)-Morris Heights
21-May,36005024900,2024900,11783,98843,110626,Bronx,1883272.79,University Heights (South)-Morris Heights
19-Jun,36005024900,2024900,10796,28769,39565,Bronx,1883272.79,University Heights (South)-Morris Heights
21-Jun,36005024900,2024900,4610,86055,90665,Bronx,1883272.79,University Heights (South)-Morris Heights
19-Jul,36005024900,2024900,11765,29542,41307,Bronx,1883272.79,University Heights (South)-Morris Heights
21-Jul,36005024900,2024900,1505,70050,71555,Bronx,1883272.79,University Heights (South)-Morris Heights
19-Aug,36005024900,2024900,12386,76710,89096,Bronx,1883272.79,University Heights (South)-Morris Heights
21-Aug,36005024900,2024900,5528,83265,88793,Bronx,1883272.79,University Heights (South)-Morris Heights
19-May,36005025000,2025000,12110,4650,16760,Bronx,1955822.595,Morris Park
21-May,36005025000,2025000,2953,71,3024,Bronx,1955822.595,Morris Park
19-Jun,36005025000,2025000,6546,97608,104154,Bronx,1955822.595,Morris Park
21-Jun,36005025000,2025000,8879,120365,129244,Bronx,1955822.595,Morris Park
19-Jul,36005025000,2025000,10331,71,10402,Bronx,1955822.595,Morris Park
21-Jul,36005025000,2025000,9537,79593,89130,Bronx,1955822.595,Morris Park
19-Aug,36005025000,2025000,6316,24574,30890,Bronx,1955822.595,Morris Park
21-Aug,36005025000,2025000,5356,84727,90083,Bronx,1955822.595,Morris Park
19-May,36005025100,2025100,7248,108005,115253,Bronx,2253288.151,University Heights (South)-Morris Heights
21-May,36005025100,2025100,7420,68793,76213,Bronx,2253288.151,University Heights (South)-Morris Heights
19-Jun,36005025100,2025100,19767,75760,95527,Bronx,2253288.151,University Heights (South)-Morris Heights
21-Jun,36005025100,2025100,7094,26148,33242,Bronx,2253288.151,University Heights (South)-Morris Heights
19-Jul,36005025100,2025100,9803,51440,61243,Bronx,2253288.151,University Heights (South)-Morris Heights
21-Jul,36005025100,2025100,3502,88311,91813,Bronx,2253288.151,University Heights (South)-Morris Heights
19-Aug,36005025100,2025100,6774,23324,30098,Bronx,2253288.151,University Heights (South)-Morris Heights
21-Aug,36005025100,2025100,20731,135488,156219,Bronx,2253288.151,University Heights (South)-Morris Heights
19-May,36005025200,2025200,11012,58347,69359,Bronx,2048258.913,Morris Park
21-May,36005025200,2025200,10388,95173,105561,Bronx,2048258.913,Morris Park
19-Jun,36005025200,2025200,6518,71,6589,Bronx,2048258.913,Morris Park
21-Jun,36005025200,2025200,11296,71,11367,Bronx,2048258.913,Morris Park
19-Jul,36005025200,2025200,4293,12130,16423,Bronx,2048258.913,Morris Park
21-Jul,36005025200,2025200,6433,52629,59062,Bronx,2048258.913,Morris Park
19-Aug,36005025200,2025200,10414,46799,57213,Bronx,2048258.913,Morris Park
21-Aug,36005025200,2025200,13679,49044,62723,Bronx,2048258.913,Morris Park
19-May,36005025300,2025300,9670,80768,90438,Bronx,1342439.487,University Heights (North)-Fordham
21-May,36005025300,2025300,13419,56885,70304,Bronx,1342439.487,University Heights (North)-Fordham
19-Jun,36005025300,2025300,6398,85810,92208,Bronx,1342439.487,University Heights (North)-Fordham
21-Jun,36005025300,2025300,15449,73386,88835,Bronx,1342439.487,University Heights (North)-Fordham
19-Jul,36005025300,2025300,9997,116532,126529,Bronx,1342439.487,University Heights (North)-Fordham
21-Jul,36005025300,2025300,1330,115125,116455,Bronx,1342439.487,University Heights (North)-Fordham
19-Aug,36005025300,2025300,12325,102666,114991,Bronx,1342439.487,University Heights (North)-Fordham
21-Aug,36005025300,2025300,9320,65235,74555,Bronx,1342439.487,University Heights (North)-Fordham
19-May,36005025400,2025400,17587,21340,38927,Bronx,1828910.707,Morris Park
21-May,36005025400,2025400,4252,107053,111305,Bronx,1828910.707,Morris Park
19-Jun,36005025400,2025400,9092,59563,68655,Bronx,1828910.707,Morris Park
21-Jun,36005025400,2025400,5014,90632,95646,Bronx,1828910.707,Morris Park
19-Jul,36005025400,2025400,8236,43561,51797,Bronx,1828910.707,Morris Park
21-Jul,36005025400,2025400,12797,113806,126603,Bronx,1828910.707,Morris Park
19-Aug,36005025400,2025400,20494,36275,56769,Bronx,1828910.707,Morris Park
21-Aug,36005025400,2025400,13213,184302,197515,Bronx,1828910.707,Morris Park
19-May,36005026500,2026500,5902,105840,111742,Bronx,2173748.287,University Heights (North)-Fordham
21-May,36005026500,2026500,10483,55378,65861,Bronx,2173748.287,University Heights (North)-Fordham
19-Jun,36005026500,2026500,20935,77049,97984,Bronx,2173748.287,University Heights (North)-Fordham
21-Jun,36005026500,2026500,7125,75682,82807,Bronx,2173748.287,University Heights (North)-Fordham
19-Jul,36005026500,2026500,0,126489,126489,Bronx,2173748.287,University Heights (North)-Fordham
21-Jul,36005026500,2026500,4646,37312,41958,Bronx,2173748.287,University Heights (North)-Fordham
19-Aug,36005026500,2026500,14798,47024,61822,Bronx,2173748.287,University Heights (North)-Fordham
21-Aug,36005026500,2026500,15467,22367,37834,Bronx,2173748.287,University Heights (North)-Fordham
19-May,36005026601,2026601,17709,78819,96528,Bronx,1832956.368,Pelham Bay-Country Club-City Island
21-May,36005026601,2026601,13299,61000,74299,Bronx,1832956.368,Pelham Bay-Country Club-City Island
19-Jun,36005026601,2026601,13999,96300,110299,Bronx,1832956.368,Pelham Bay-Country Club-City Island
21-Jun,36005026601,2026601,4332,66032,70364,Bronx,1832956.368,Pelham Bay-Country Club-City Island
19-Jul,36005026601,2026601,242,34094,34336,Bronx,1832956.368,Pelham Bay-Country Club-City Island
21-Jul,36005026601,2026601,0,115446,115446,Bronx,1832956.368,Pelham Bay-Country Club-City Island
19-Aug,36005026601,2026601,9859,51078,60937,Bronx,1832956.368,Pelham Bay-Country Club-City Island
21-Aug,36005026601,2026601,12377,104449,116826,Bronx,1832956.368,Pelham Bay-Country Club-City Island
19-May,36005026602,2026602,8498,20257,28755,Bronx,3269676.927,Pelham Bay-Country Club-City Island
21-May,36005026602,2026602,1228,70069,71297,Bronx,3269676.927,Pelham Bay-Country Club-City Island
19-Jun,36005026602,2026602,14630,130616,145246,Bronx,3269676.927,Pelham Bay-Country Club-City Island
21-Jun,36005026602,2026602,3647,97590,101237,Bronx,3269676.927,Pelham Bay-Country Club-City Island
19-Jul,36005026602,2026602,11221,57400,68621,Bronx,3269676.927,Pelham Bay-Country Club-City Island
21-Jul,36005026602,2026602,11998,71,12069,Bronx,3269676.927,Pelham Bay-Country Club-City Island
19-Aug,36005026602,2026602,8752,23409,32161,Bronx,3269676.927,Pelham Bay-Country Club-City Island
21-Aug,36005026602,2026602,0,28200,28200,Bronx,3269676.927,Pelham Bay-Country Club-City Island
19-May,36005026701,2026701,9378,103454,112832,Bronx,742841.5699,Kingsbridge Heights-Van Cortlandt Village
21-May,36005026701,2026701,10540,101231,111771,Bronx,742841.5699,Kingsbridge Heights-Van Cortlandt Village
19-Jun,36005026701,2026701,9967,71,10038,Bronx,742841.5699,Kingsbridge Heights-Van Cortlandt Village
21-Jun,36005026701,2026701,3618,77147,80765,Bronx,742841.5699,Kingsbridge Heights-Van Cortlandt Village
19-Jul,36005026701,2026701,7211,71,7282,Bronx,742841.5699,Kingsbridge Heights-Van Cortlandt Village
21-Jul,36005026701,2026701,8114,91619,99733,Bronx,742841.5699,Kingsbridge Heights-Van Cortlandt Village
19-Aug,36005026701,2026701,5929,49521,55450,Bronx,742841.5699,Kingsbridge Heights-Van Cortlandt Village
21-Aug,36005026701,2026701,8159,85389,93548,Bronx,742841.5699,Kingsbridge Heights-Van Cortlandt Village
19-May,36005026702,2026702,8795,24794,33589,Bronx,1819284.861,Kingsbridge Heights-Van Cortlandt Village
21-May,36005026702,2026702,15285,66186,81471,Bronx,1819284.861,Kingsbridge Heights-Van Cortlandt Village
19-Jun,36005026702,2026702,4693,71855,76548,Bronx,1819284.861,Kingsbridge Heights-Van Cortlandt Village
21-Jun,36005026702,2026702,11631,36680,48311,Bronx,1819284.861,Kingsbridge Heights-Van Cortlandt Village
19-Jul,36005026702,2026702,6518,74454,80972,Bronx,1819284.861,Kingsbridge Heights-Van Cortlandt Village
21-Jul,36005026702,2026702,6968,102790,109758,Bronx,1819284.861,Kingsbridge Heights-Van Cortlandt Village
19-Aug,36005026702,2026702,5346,85173,90519,Bronx,1819284.861,Kingsbridge Heights-Van Cortlandt Village
21-Aug,36005026702,2026702,14126,71,14197,Bronx,1819284.861,Kingsbridge Heights-Van Cortlandt Village
19-May,36005027300,2027300,3959,71892,75851,Bronx,2183729.083,Kingsbridge Heights-Van Cortlandt Village
21-May,36005027300,2027300,6297,71,6368,Bronx,2183729.083,Kingsbridge Heights-Van Cortlandt Village
19-Jun,36005027300,2027300,14516,26383,40899,Bronx,2183729.083,Kingsbridge Heights-Van Cortlandt Village
21-Jun,36005027300,2027300,8242,93925,102167,Bronx,2183729.083,Kingsbridge Heights-Van Cortlandt Village
19-Jul,36005027300,2027300,6043,158173,164216,Bronx,2183729.083,Kingsbridge Heights-Van Cortlandt Village
21-Jul,36005027300,2027300,3052,73660,76712,Bronx,2183729.083,Kingsbridge Heights-Van Cortlandt Village
19-Aug,36005027300,2027300,8246,62820,71066,Bronx,2183729.083,Kingsbridge Heights-Van Cortlandt Village
21-Aug,36005027300,2027300,12710,93616,106326,Bronx,2183729.083,Kingsbridge Heights-Van Cortlandt Village
19-May,36005027700,2027700,20524,59033,79557,Bronx,1880099.223,Kingsbridge Heights-Van Cortlandt Village
21-May,36005027700,2027700,4774,73827,78601,Bronx,1880099.223,Kingsbridge Heights-Van Cortlandt Village
19-Jun,36005027700,2027700,10782,32514,43296,Bronx,1880099.223,Kingsbridge Heights-Van Cortlandt Village
21-Jun,36005027700,2027700,5553,39451,45004,Bronx,1880099.223,Kingsbridge Heights-Van Cortlandt Village
19-Jul,36005027700,2027700,4378,119767,124145,Bronx,1880099.223,Kingsbridge Heights-Van Cortlandt Village
21-Jul,36005027700,2027700,22890,110325,133215,Bronx,1880099.223,Kingsbridge Heights-Van Cortlandt Village
19-Aug,36005027700,2027700,12188,122950,135138,Bronx,1880099.223,Kingsbridge Heights-Van Cortlandt Village
21-Aug,36005027700,2027700,10325,70841,81166,Bronx,1880099.223,Kingsbridge Heights-Van Cortlandt Village
19-May,36005027900,2027900,17926,4693,22619,Bronx,2954297.614,Kingsbridge Heights-Van Cortlandt Village
21-May,36005027900,2027900,11577,76411,87988,Bronx,2954297.614,Kingsbridge Heights-Van Cortlandt Village
19-Jun,36005027900,2027900,4912,103884,108796,Bronx,2954297.614,Kingsbridge Heights-Van Cortlandt Village
21-Jun,36005027900,2027900,8067,129879,137946,Bronx,2954297.614,Kingsbridge Heights-Van Cortlandt Village
19-Jul,36005027900,2027900,172,81912,82084,Bronx,2954297.614,Kingsbridge Heights-Van Cortlandt Village
21-Jul,36005027900,2027900,9292,46159,55451,Bronx,2954297.614,Kingsbridge Heights-Van Cortlandt Village
19-Aug,36005027900,2027900,6382,71,6453,Bronx,2954297.614,Kingsbridge Heights-Van Cortlandt Village
21-Aug,36005027900,2027900,0,81815,81815,Bronx,2954297.614,Kingsbridge Heights-Van Cortlandt Village
19-May,36005028600,2028600,8518,86141,94659,Bronx,2152041.739,Morris Park
21-May,36005028600,2028600,14352,109164,123516,Bronx,2152041.739,Morris Park
19-Jun,36005028600,2028600,8056,110512,118568,Bronx,2152041.739,Morris Park
21-Jun,36005028600,2028600,5273,93847,99120,Bronx,2152041.739,Morris Park
19-Jul,36005028600,2028600,1593,78140,79733,Bronx,2152041.739,Morris Park
21-Jul,36005028600,2028600,1927,22915,24842,Bronx,2152041.739,Morris Park
19-Aug,36005028600,2028600,5542,59240,64782,Bronx,2152041.739,Morris Park
21-Aug,36005028600,2028600,6921,152321,159242,Bronx,2152041.739,Morris Park
19-May,36005028700,2028700,6644,58766,65410,Bronx,1670599.139,Kingsbridge-Marble Hill
21-May,36005028700,2028700,17658,158926,176584,Bronx,1670599.139,Kingsbridge-Marble Hill
19-Jun,36005028700,2028700,11889,34914,46803,Bronx,1670599.139,Kingsbridge-Marble Hill
21-Jun,36005028700,2028700,5624,71,5695,Bronx,1670599.139,Kingsbridge-Marble Hill
19-Jul,36005028700,2028700,10693,71,10764,Bronx,1670599.139,Kingsbridge-Marble Hill
21-Jul,36005028700,2028700,887,96533,97420,Bronx,1670599.139,Kingsbridge-Marble Hill
19-Aug,36005028700,2028700,9735,74636,84371,Bronx,1670599.139,Kingsbridge-Marble Hill
21-Aug,36005028700,2028700,2390,75480,77870,Bronx,1670599.139,Kingsbridge-Marble Hill
19-May,36005028800,2028800,13680,47339,61019,Bronx,3616695.331,Morris Park
21-May,36005028800,2028800,7882,44111,51993,Bronx,3616695.331,Morris Park
19-Jun,36005028800,2028800,9496,82413,91909,Bronx,3616695.331,Morris Park
21-Jun,36005028800,2028800,4855,9369,14224,Bronx,3616695.331,Morris Park
19-Jul,36005028800,2028800,14780,42599,57379,Bronx,3616695.331,Morris Park
21-Jul,36005028800,2028800,6928,51037,57965,Bronx,3616695.331,Morris Park
19-Aug,36005028800,2028800,1750,55168,56918,Bronx,3616695.331,Morris Park
21-Aug,36005028800,2028800,1970,110530,112500,Bronx,3616695.331,Morris Park
19-May,36005029600,2029600,16521,23354,39875,Bronx,7667278.218,Morris Park
21-May,36005029600,2029600,16267,47709,63976,Bronx,7667278.218,Morris Park
19-Jun,36005029600,2029600,5107,71504,76611,Bronx,7667278.218,Morris Park
21-Jun,36005029600,2029600,11097,61583,72680,Bronx,7667278.218,Morris Park
19-Jul,36005029600,2029600,12025,60872,72897,Bronx,7667278.218,Morris Park
21-Jul,36005029600,2029600,8676,78880,87556,Bronx,7667278.218,Morris Park
19-Aug,36005029600,2029600,2127,56851,58978,Bronx,7667278.218,Morris Park
21-Aug,36005029600,2029600,7159,22651,29810,Bronx,7667278.218,Morris Park
19-May,36005030000,2030000,7753,93674,101427,Bronx,4490156.833,Pelham Bay-Country Club-City Island
21-May,36005030000,2030000,3344,10969,14313,Bronx,4490156.833,Pelham Bay-Country Club-City Island
19-Jun,36005030000,2030000,3928,48517,52445,Bronx,4490156.833,Pelham Bay-Country Club-City Island
21-Jun,36005030000,2030000,1779,77336,79115,Bronx,4490156.833,Pelham Bay-Country Club-City Island
19-Jul,36005030000,2030000,12698,77626,90324,Bronx,4490156.833,Pelham Bay-Country Club-City Island
21-Jul,36005030000,2030000,0,152113,152113,Bronx,4490156.833,Pelham Bay-Country Club-City Island
19-Aug,36005030000,2030000,17819,95413,113232,Bronx,4490156.833,Pelham Bay-Country Club-City Island
21-Aug,36005030000,2030000,11835,28043,39878,Bronx,4490156.833,Pelham Bay-Country Club-City Island
19-May,36005030100,2030100,7564,12411,19975,Bronx,1583340.307,Riverdale-Spuyten Duyvil
21-May,36005030100,2030100,13283,39768,53051,Bronx,1583340.307,Riverdale-Spuyten Duyvil
19-Jun,36005030100,2030100,7307,85312,92619,Bronx,1583340.307,Riverdale-Spuyten Duyvil
21-Jun,36005030100,2030100,12492,88227,100719,Bronx,1583340.307,Riverdale-Spuyten Duyvil
19-Jul,36005030100,2030100,529,69839,70368,Bronx,1583340.307,Riverdale-Spuyten Duyvil
21-Jul,36005030100,2030100,0,109346,109346,Bronx,1583340.307,Riverdale-Spuyten Duyvil
19-Aug,36005030100,2030100,5462,71,5533,Bronx,1583340.307,Riverdale-Spuyten Duyvil
21-Aug,36005030100,2030100,9343,10837,20180,Bronx,1583340.307,Riverdale-Spuyten Duyvil
19-May,36005030201,2030201,10828,22070,32898,Bronx,2389721.128,Co-op City
21-May,36005030201,2030201,10011,71,10082,Bronx,2389721.128,Co-op City
19-Jun,36005030201,2030201,10936,85956,96892,Bronx,2389721.128,Co-op City
21-Jun,36005030201,2030201,7358,53635,60993,Bronx,2389721.128,Co-op City
19-Jul,36005030201,2030201,11551,71566,83117,Bronx,2389721.128,Co-op City
21-Jul,36005030201,2030201,8588,108234,116822,Bronx,2389721.128,Co-op City
19-Aug,36005030201,2030201,8340,61943,70283,Bronx,2389721.128,Co-op City
21-Aug,36005030201,2030201,10635,62393,73028,Bronx,2389721.128,Co-op City
19-May,36005030701,2030701,1385,108751,110136,Bronx,4267734.149,Riverdale-Spuyten Duyvil
21-May,36005030701,2030701,2962,60059,63021,Bronx,4267734.149,Riverdale-Spuyten Duyvil
19-Jun,36005030701,2030701,3628,72119,75747,Bronx,4267734.149,Riverdale-Spuyten Duyvil
21-Jun,36005030701,2030701,8342,10985,19327,Bronx,4267734.149,Riverdale-Spuyten Duyvil
19-Jul,36005030701,2030701,8609,105503,114112,Bronx,4267734.149,Riverdale-Spuyten Duyvil
21-Jul,36005030701,2030701,11837,50667,62504,Bronx,4267734.149,Riverdale-Spuyten Duyvil
19-Aug,36005030701,2030701,4786,55650,60436,Bronx,4267734.149,Riverdale-Spuyten Duyvil
21-Aug,36005030701,2030701,15502,33142,48644,Bronx,4267734.149,Riverdale-Spuyten Duyvil
19-May,36005030900,2030900,7201,51577,58778,Bronx,13704916.71,Riverdale-Spuyten Duyvil
21-May,36005030900,2030900,10926,97089,108015,Bronx,13704916.71,Riverdale-Spuyten Duyvil
19-Jun,36005030900,2030900,7589,98126,105715,Bronx,13704916.71,Riverdale-Spuyten Duyvil
21-Jun,36005030900,2030900,13962,88612,102574,Bronx,13704916.71,Riverdale-Spuyten Duyvil
19-Jul,36005030900,2030900,7979,73201,81180,Bronx,13704916.71,Riverdale-Spuyten Duyvil
21-Jul,36005030900,2030900,9842,57252,67094,Bronx,13704916.71,Riverdale-Spuyten Duyvil
19-Aug,36005030900,2030900,0,109568,109568,Bronx,13704916.71,Riverdale-Spuyten Duyvil
21-Aug,36005030900,2030900,8239,116500,124739,Bronx,13704916.71,Riverdale-Spuyten Duyvil
19-May,36005031200,2031200,21704,85414,107118,Bronx,2175833.893,Pelham Gardens
21-May,36005031200,2031200,8374,93719,102093,Bronx,2175833.893,Pelham Gardens
19-Jun,36005031200,2031200,13320,61270,74590,Bronx,2175833.893,Pelham Gardens
21-Jun,36005031200,2031200,14262,35203,49465,Bronx,2175833.893,Pelham Gardens
19-Jul,36005031200,2031200,9542,57201,66743,Bronx,2175833.893,Pelham Gardens
21-Jul,36005031200,2031200,9786,28838,38624,Bronx,2175833.893,Pelham Gardens
19-Aug,36005031200,2031200,12466,41304,53770,Bronx,2175833.893,Pelham Gardens
21-Aug,36005031200,2031200,9373,71,9444,Bronx,2175833.893,Pelham Gardens
19-May,36005031400,2031400,9376,34448,43824,Bronx,2272270.806,Pelham Gardens
21-May,36005031400,2031400,6090,111880,117970,Bronx,2272270.806,Pelham Gardens
19-Jun,36005031400,2031400,2437,71,2508,Bronx,2272270.806,Pelham Gardens
21-Jun,36005031400,2031400,9756,109679,119435,Bronx,2272270.806,Pelham Gardens
19-Jul,36005031400,2031400,0,112298,112298,Bronx,2272270.806,Pelham Gardens
21-Jul,36005031400,2031400,9099,4000,13099,Bronx,2272270.806,Pelham Gardens
19-Aug,36005031400,2031400,684,46061,46745,Bronx,2272270.806,Pelham Gardens
21-Aug,36005031400,2031400,4837,103710,108547,Bronx,2272270.806,Pelham Gardens
19-May,36005031600,2031600,1821,44069,45890,Bronx,1906941.288,Pelham Gardens
21-May,36005031600,2031600,3349,65810,69159,Bronx,1906941.288,Pelham Gardens
19-Jun,36005031600,2031600,3802,94677,98479,Bronx,1906941.288,Pelham Gardens
21-Jun,36005031600,2031600,5440,90386,95826,Bronx,1906941.288,Pelham Gardens
19-Jul,36005031600,2031600,7522,151721,159243,Bronx,1906941.288,Pelham Gardens
21-Jul,36005031600,2031600,10157,31234,41391,Bronx,1906941.288,Pelham Gardens
19-Aug,36005031600,2031600,7373,24745,32118,Bronx,1906941.288,Pelham Gardens
21-Aug,36005031600,2031600,6904,119626,126530,Bronx,1906941.288,Pelham Gardens
19-May,36005031800,2031800,21105,52636,73741,Bronx,1919429.469,Pelham Gardens
21-May,36005031800,2031800,7238,145691,152929,Bronx,1919429.469,Pelham Gardens
19-Jun,36005031800,2031800,11401,74773,86174,Bronx,1919429.469,Pelham Gardens
21-Jun,36005031800,2031800,4745,18346,23091,Bronx,1919429.469,Pelham Gardens
19-Jul,36005031800,2031800,7010,75397,82407,Bronx,1919429.469,Pelham Gardens
21-Jul,36005031800,2031800,11426,87697,99123,Bronx,1919429.469,Pelham Gardens
19-Aug,36005031800,2031800,3957,60709,64666,Bronx,1919429.469,Pelham Gardens
21-Aug,36005031800,2031800,11849,45676,57525,Bronx,1919429.469,Pelham Gardens
19-May,36005031900,2031900,13092,102987,116079,Bronx,2381338.394,Riverdale-Spuyten Duyvil
21-May,36005031900,2031900,6984,73413,80397,Bronx,2381338.394,Riverdale-Spuyten Duyvil
19-Jun,36005031900,2031900,18593,71,18664,Bronx,2381338.394,Riverdale-Spuyten Duyvil
21-Jun,36005031900,2031900,7942,58220,66162,Bronx,2381338.394,Riverdale-Spuyten Duyvil
19-Jul,36005031900,2031900,5208,35964,41172,Bronx,2381338.394,Riverdale-Spuyten Duyvil
21-Jul,36005031900,2031900,11588,72450,84038,Bronx,2381338.394,Riverdale-Spuyten Duyvil
19-Aug,36005031900,2031900,9891,110951,120842,Bronx,2381338.394,Riverdale-Spuyten Duyvil
21-Aug,36005031900,2031900,0,74284,74284,Bronx,2381338.394,Riverdale-Spuyten Duyvil
19-May,36005032400,2032400,14511,41903,56414,Bronx,2875893.39,Allerton
21-May,36005032400,2032400,14499,71,14570,Bronx,2875893.39,Allerton
19-Jun,36005032400,2032400,0,34142,34142,Bronx,2875893.39,Allerton
21-Jun,36005032400,2032400,8515,156365,164880,Bronx,2875893.39,Allerton
19-Jul,36005032400,2032400,5494,95974,101468,Bronx,2875893.39,Allerton
21-Jul,36005032400,2032400,7731,49611,57342,Bronx,2875893.39,Allerton
19-Aug,36005032400,2032400,8857,76561,85418,Bronx,2875893.39,Allerton
21-Aug,36005032400,2032400,7838,41489,49327,Bronx,2875893.39,Allerton
19-May,36005032600,2032600,2923,30979,33902,Bronx,3578517.87,Pelham Gardens
21-May,36005032600,2032600,10308,67857,78165,Bronx,3578517.87,Pelham Gardens
19-Jun,36005032600,2032600,7428,35961,43389,Bronx,3578517.87,Pelham Gardens
21-Jun,36005032600,2032600,14836,1026,15862,Bronx,3578517.87,Pelham Gardens
19-Jul,36005032600,2032600,14581,55676,70257,Bronx,3578517.87,Pelham Gardens
21-Jul,36005032600,2032600,11063,72423,83486,Bronx,3578517.87,Pelham Gardens
19-Aug,36005032600,2032600,3552,81931,85483,Bronx,3578517.87,Pelham Gardens
21-Aug,36005032600,2032600,19052,11958,31010,Bronx,3578517.87,Pelham Gardens
19-May,36005032800,2032800,0,71,71,Bronx,2202647.739,Allerton
21-May,36005032800,2032800,14223,84278,98501,Bronx,2202647.739,Allerton
19-Jun,36005032800,2032800,2172,54052,56224,Bronx,2202647.739,Allerton
21-Jun,36005032800,2032800,1154,31788,32942,Bronx,2202647.739,Allerton
19-Jul,36005032800,2032800,12111,81362,93473,Bronx,2202647.739,Allerton
21-Jul,36005032800,2032800,6554,98797,105351,Bronx,2202647.739,Allerton
19-Aug,36005032800,2032800,9856,13463,23319,Bronx,2202647.739,Allerton
21-Aug,36005032800,2032800,3244,54421,57665,Bronx,2202647.739,Allerton
19-May,36005033000,2033000,0,50446,50446,Bronx,2218401.12,Allerton
21-May,36005033000,2033000,5777,75489,81266,Bronx,2218401.12,Allerton
19-Jun,36005033000,2033000,6328,147071,153399,Bronx,2218401.12,Allerton
21-Jun,36005033000,2033000,14467,59944,74411,Bronx,2218401.12,Allerton
19-Jul,36005033000,2033000,13942,126828,140770,Bronx,2218401.12,Allerton
21-Jul,36005033000,2033000,14400,61875,76275,Bronx,2218401.12,Allerton
19-Aug,36005033000,2033000,5873,118287,124160,Bronx,2218401.12,Allerton
21-Aug,36005033000,2033000,6438,70736,77174,Bronx,2218401.12,Allerton
19-May,36005033201,2033201,13383,100658,114041,Bronx,1224202.535,Allerton
21-May,36005033201,2033201,5247,89192,94439,Bronx,1224202.535,Allerton
19-Jun,36005033201,2033201,5782,48214,53996,Bronx,1224202.535,Allerton
21-Jun,36005033201,2033201,3660,51317,54977,Bronx,1224202.535,Allerton
19-Jul,36005033201,2033201,10247,64755,75002,Bronx,1224202.535,Allerton
21-Jul,36005033201,2033201,12542,61099,73641,Bronx,1224202.535,Allerton
19-Aug,36005033201,2033201,6756,35735,42491,Bronx,1224202.535,Allerton
21-Aug,36005033201,2033201,8237,51627,59864,Bronx,1224202.535,Allerton
19-May,36005033202,2033202,6364,79340,85704,Bronx,1231532.665,Allerton
21-May,36005033202,2033202,10900,144402,155302,Bronx,1231532.665,Allerton
19-Jun,36005033202,2033202,7539,21517,29056,Bronx,1231532.665,Allerton
21-Jun,36005033202,2033202,11022,2280,13302,Bronx,1231532.665,Allerton
19-Jul,36005033202,2033202,4939,65850,70789,Bronx,1231532.665,Allerton
21-Jul,36005033202,2033202,12106,144752,156858,Bronx,1231532.665,Allerton
19-Aug,36005033202,2033202,8142,6228,14370,Bronx,1231532.665,Allerton
21-Aug,36005033202,2033202,4831,71,4902,Bronx,1231532.665,Allerton
19-May,36005033601,2033601,5025,35885,40910,Bronx,1377962.879,Allerton
21-May,36005033601,2033601,6544,142943,149487,Bronx,1377962.879,Allerton
19-Jun,36005033601,2033601,19446,108813,128259,Bronx,1377962.879,Allerton
21-Jun,36005033601,2033601,15216,69225,84441,Bronx,1377962.879,Allerton
19-Jul,36005033601,2033601,7119,89730,96849,Bronx,1377962.879,Allerton
21-Jul,36005033601,2033601,7604,21066,28670,Bronx,1377962.879,Allerton
19-Aug,36005033601,2033601,11352,90512,101864,Bronx,1377962.879,Allerton
21-Aug,36005033601,2033601,1283,53413,54696,Bronx,1377962.879,Allerton
19-May,36005033602,2033602,13807,16504,30311,Bronx,607275.5147,Williamsbridge-Olinville
21-May,36005033602,2033602,8449,366,8815,Bronx,607275.5147,Williamsbridge-Olinville
19-Jun,36005033602,2033602,5063,23353,28416,Bronx,607275.5147,Williamsbridge-Olinville
21-Jun,36005033602,2033602,6878,72599,79477,Bronx,607275.5147,Williamsbridge-Olinville
19-Jul,36005033602,2033602,10220,83997,94217,Bronx,607275.5147,Williamsbridge-Olinville
21-Jul,36005033602,2033602,10100,30870,40970,Bronx,607275.5147,Williamsbridge-Olinville
19-Aug,36005033602,2033602,0,45668,45668,Bronx,607275.5147,Williamsbridge-Olinville
21-Aug,36005033602,2033602,10168,99077,109245,Bronx,607275.5147,Williamsbridge-Olinville
19-May,36005033801,2033801,7323,81270,88593,Bronx,1231399.346,Allerton
21-May,36005033801,2033801,6996,47123,54119,Bronx,1231399.346,Allerton
19-Jun,36005033801,2033801,1490,105611,107101,Bronx,1231399.346,Allerton
21-Jun,36005033801,2033801,2657,35504,38161,Bronx,1231399.346,Allerton
19-Jul,36005033801,2033801,9758,95787,105545,Bronx,1231399.346,Allerton
21-Jul,36005033801,2033801,13135,68575,81710,Bronx,1231399.346,Allerton
19-Aug,36005033801,2033801,10506,92651,103157,Bronx,1231399.346,Allerton
21-Aug,36005033801,2033801,5693,67711,73404,Bronx,1231399.346,Allerton
19-May,36005033802,2033802,10248,37199,47447,Bronx,505775.593,Williamsbridge-Olinville
21-May,36005033802,2033802,795,56345,57140,Bronx,505775.593,Williamsbridge-Olinville
19-Jun,36005033802,2033802,13097,27206,40303,Bronx,505775.593,Williamsbridge-Olinville
21-Jun,36005033802,2033802,12299,88235,100534,Bronx,505775.593,Williamsbridge-Olinville
19-Jul,36005033802,2033802,12233,23068,35301,Bronx,505775.593,Williamsbridge-Olinville
21-Jul,36005033802,2033802,10994,100677,111671,Bronx,505775.593,Williamsbridge-Olinville
19-Aug,36005033802,2033802,7342,1172,8514,Bronx,505775.593,Williamsbridge-Olinville
21-Aug,36005033802,2033802,8912,65057,73969,Bronx,505775.593,Williamsbridge-Olinville
19-May,36005034000,2034000,6175,62172,68347,Bronx,1704073.247,Allerton
21-May,36005034000,2034000,15771,135702,151473,Bronx,1704073.247,Allerton
19-Jun,36005034000,2034000,7531,34581,42112,Bronx,1704073.247,Allerton
21-Jun,36005034000,2034000,2320,47489,49809,Bronx,1704073.247,Allerton
19-Jul,36005034000,2034000,2605,83311,85916,Bronx,1704073.247,Allerton
21-Jul,36005034000,2034000,11531,84046,95577,Bronx,1704073.247,Allerton
19-Aug,36005034000,2034000,8065,69842,77907,Bronx,1704073.247,Allerton
21-Aug,36005034000,2034000,4848,47288,52136,Bronx,1704073.247,Allerton
19-May,36005034200,2034200,13268,34807,48075,Bronx,1687802.789,Allerton
21-May,36005034200,2034200,2160,72369,74529,Bronx,1687802.789,Allerton
19-Jun,36005034200,2034200,10321,78346,88667,Bronx,1687802.789,Allerton
21-Jun,36005034200,2034200,3677,75282,78959,Bronx,1687802.789,Allerton
19-Jul,36005034200,2034200,7679,77788,85467,Bronx,1687802.789,Allerton
21-Jul,36005034200,2034200,4545,71087,75632,Bronx,1687802.789,Allerton
19-Aug,36005034200,2034200,9686,110815,120501,Bronx,1687802.789,Allerton
21-Aug,36005034200,2034200,10436,87115,97551,Bronx,1687802.789,Allerton
19-May,36005034300,2034300,2262,34898,37160,Bronx,1318002.857,Riverdale-Spuyten Duyvil
21-May,36005034300,2034300,5339,26316,31655,Bronx,1318002.857,Riverdale-Spuyten Duyvil
19-Jun,36005034300,2034300,0,83442,83442,Bronx,1318002.857,Riverdale-Spuyten Duyvil
21-Jun,36005034300,2034300,11739,129563,141302,Bronx,1318002.857,Riverdale-Spuyten Duyvil
19-Jul,36005034300,2034300,7392,10816,18208,Bronx,1318002.857,Riverdale-Spuyten Duyvil
21-Jul,36005034300,2034300,9846,30684,40530,Bronx,1318002.857,Riverdale-Spuyten Duyvil
19-Aug,36005034300,2034300,6346,78506,84852,Bronx,1318002.857,Riverdale-Spuyten Duyvil
21-Aug,36005034300,2034300,8216,76196,84412,Bronx,1318002.857,Riverdale-Spuyten Duyvil
19-May,36005034400,2034400,12305,94310,106615,Bronx,1690333.115,Pelham Gardens
21-May,36005034400,2034400,7133,89114,96247,Bronx,1690333.115,Pelham Gardens
19-Jun,36005034400,2034400,5476,159816,165292,Bronx,1690333.115,Pelham Gardens
21-Jun,36005034400,2034400,7873,104790,112663,Bronx,1690333.115,Pelham Gardens
19-Jul,36005034400,2034400,7430,48724,56154,Bronx,1690333.115,Pelham Gardens
21-Jul,36005034400,2034400,14300,140511,154811,Bronx,1690333.115,Pelham Gardens
19-Aug,36005034400,2034400,13892,87671,101563,Bronx,1690333.115,Pelham Gardens
21-Aug,36005034400,2034400,670,70877,71547,Bronx,1690333.115,Pelham Gardens
19-May,36005034800,2034800,16462,59837,76299,Bronx,4713702.797,Pelham Gardens
21-May,36005034800,2034800,2058,9453,11511,Bronx,4713702.797,Pelham Gardens
19-Jun,36005034800,2034800,9762,78244,88006,Bronx,4713702.797,Pelham Gardens
21-Jun,36005034800,2034800,13306,96620,109926,Bronx,4713702.797,Pelham Gardens
19-Jul,36005034800,2034800,4362,131586,135948,Bronx,4713702.797,Pelham Gardens
21-Jul,36005034800,2034800,9630,68189,77819,Bronx,4713702.797,Pelham Gardens
19-Aug,36005034800,2034800,8784,122915,131699,Bronx,4713702.797,Pelham Gardens
21-Aug,36005034800,2034800,6730,64761,71491,Bronx,4713702.797,Pelham Gardens
19-May,36005035900,2035900,9123,38644,47767,Bronx,1451682.169,West Farms
21-May,36005035900,2035900,9122,62748,71870,Bronx,1451682.169,West Farms
19-Jun,36005035900,2035900,5265,27400,32665,Bronx,1451682.169,West Farms
21-Jun,36005035900,2035900,348,88680,89028,Bronx,1451682.169,West Farms
19-Jul,36005035900,2035900,3658,75089,78747,Bronx,1451682.169,West Farms
21-Jul,36005035900,2035900,9073,124276,133349,Bronx,1451682.169,West Farms
19-Aug,36005035900,2035900,9119,62722,71841,Bronx,1451682.169,West Farms
21-Aug,36005035900,2035900,8135,69986,78121,Bronx,1451682.169,West Farms
19-May,36005036000,2036000,8400,91404,99804,Bronx,2857374.872,Pelham Gardens
21-May,36005036000,2036000,16820,35837,52657,Bronx,2857374.872,Pelham Gardens
19-Jun,36005036000,2036000,7484,78425,85909,Bronx,2857374.872,Pelham Gardens
21-Jun,36005036000,2036000,6320,95740,102060,Bronx,2857374.872,Pelham Gardens
19-Jul,36005036000,2036000,3068,66641,69709,Bronx,2857374.872,Pelham Gardens
21-Jul,36005036000,2036000,3396,115628,119024,Bronx,2857374.872,Pelham Gardens
19-Aug,36005036000,2036000,12871,84222,97093,Bronx,2857374.872,Pelham Gardens
21-Aug,36005036000,2036000,12033,116364,128397,Bronx,2857374.872,Pelham Gardens
19-May,36005036300,2036300,5739,57159,62898,Bronx,2378745.485,West Farms
21-May,36005036300,2036300,7735,46700,54435,Bronx,2378745.485,West Farms
19-Jun,36005036300,2036300,5161,69487,74648,Bronx,2378745.485,West Farms
21-Jun,36005036300,2036300,15752,125470,141222,Bronx,2378745.485,West Farms
19-Jul,36005036300,2036300,8085,2085,10170,Bronx,2378745.485,West Farms
21-Jul,36005036300,2036300,7649,81982,89631,Bronx,2378745.485,West Farms
19-Aug,36005036300,2036300,16241,41160,57401,Bronx,2378745.485,West Farms
21-Aug,36005036300,2036300,1470,82141,83611,Bronx,2378745.485,West Farms
19-May,36005036400,2036400,13916,76513,90429,Bronx,2191493.988,Eastchester-Edenwald-Baychester
21-May,36005036400,2036400,0,107147,107147,Bronx,2191493.988,Eastchester-Edenwald-Baychester
19-Jun,36005036400,2036400,14728,50099,64827,Bronx,2191493.988,Eastchester-Edenwald-Baychester
21-Jun,36005036400,2036400,18773,71531,90304,Bronx,2191493.988,Eastchester-Edenwald-Baychester
19-Jul,36005036400,2036400,11579,130425,142004,Bronx,2191493.988,Eastchester-Edenwald-Baychester
21-Jul,36005036400,2036400,12211,83243,95454,Bronx,2191493.988,Eastchester-Edenwald-Baychester
19-Aug,36005036400,2036400,4874,67541,72415,Bronx,2191493.988,Eastchester-Edenwald-Baychester
21-Aug,36005036400,2036400,9058,96756,105814,Bronx,2191493.988,Eastchester-Edenwald-Baychester
19-May,36005036501,2036501,14333,85552,99885,Bronx,1034842.669,Tremont
21-May,36005036501,2036501,8769,68716,77485,Bronx,1034842.669,Tremont
19-Jun,36005036501,2036501,27224,37941,65165,Bronx,1034842.669,Tremont
21-Jun,36005036501,2036501,7714,97389,105103,Bronx,1034842.669,Tremont
19-Jul,36005036501,2036501,13637,93186,106823,Bronx,1034842.669,Tremont
21-Jul,36005036501,2036501,0,43166,43166,Bronx,1034842.669,Tremont
19-Aug,36005036501,2036501,7667,77834,85501,Bronx,1034842.669,Tremont
21-Aug,36005036501,2036501,1310,78028,79338,Bronx,1034842.669,Tremont
19-May,36005036800,2036800,13555,16244,29799,Bronx,1820227.82,Williamsbridge-Olinville
21-May,36005036800,2036800,9363,113089,122452,Bronx,1820227.82,Williamsbridge-Olinville
19-Jun,36005036800,2036800,7940,65283,73223,Bronx,1820227.82,Williamsbridge-Olinville
21-Jun,36005036800,2036800,1338,60709,62047,Bronx,1820227.82,Williamsbridge-Olinville
19-Jul,36005036800,2036800,14885,64509,79394,Bronx,1820227.82,Williamsbridge-Olinville
21-Jul,36005036800,2036800,5690,116174,121864,Bronx,1820227.82,Williamsbridge-Olinville
19-Aug,36005036800,2036800,6780,152227,159007,Bronx,1820227.82,Williamsbridge-Olinville
21-Aug,36005036800,2036800,0,84382,84382,Bronx,1820227.82,Williamsbridge-Olinville
19-May,36005036901,2036901,13341,34149,47490,Bronx,1067643.895,Tremont
21-May,36005036901,2036901,7150,97907,105057,Bronx,1067643.895,Tremont
19-Jun,36005036901,2036901,10185,43568,53753,Bronx,1067643.895,Tremont
21-Jun,36005036901,2036901,0,130590,130590,Bronx,1067643.895,Tremont
19-Jul,36005036901,2036901,5099,82055,87154,Bronx,1067643.895,Tremont
21-Jul,36005036901,2036901,5526,71,5597,Bronx,1067643.895,Tremont
19-Aug,36005036901,2036901,8097,85090,93187,Bronx,1067643.895,Tremont
21-Aug,36005036901,2036901,5563,90089,95652,Bronx,1067643.895,Tremont
19-May,36005036902,2036902,7788,59238,67026,Bronx,672873.2713,Tremont
21-May,36005036902,2036902,2714,31736,34450,Bronx,672873.2713,Tremont
19-Jun,36005036902,2036902,15383,151589,166972,Bronx,672873.2713,Tremont
21-Jun,36005036902,2036902,2025,112124,114149,Bronx,672873.2713,Tremont
19-Jul,36005036902,2036902,19352,46173,65525,Bronx,672873.2713,Tremont
21-Jul,36005036902,2036902,10685,63377,74062,Bronx,672873.2713,Tremont
19-Aug,36005036902,2036902,16998,53615,70613,Bronx,672873.2713,Tremont
21-Aug,36005036902,2036902,5433,79098,84531,Bronx,672873.2713,Tremont
19-May,36005037000,2037000,0,56298,56298,Bronx,1709084.312,Williamsbridge-Olinville
21-May,36005037000,2037000,6816,42109,48925,Bronx,1709084.312,Williamsbridge-Olinville
19-Jun,36005037000,2037000,0,87894,87894,Bronx,1709084.312,Williamsbridge-Olinville
21-Jun,36005037000,2037000,22629,114372,137001,Bronx,1709084.312,Williamsbridge-Olinville
19-Jul,36005037000,2037000,2945,85693,88638,Bronx,1709084.312,Williamsbridge-Olinville
21-Jul,36005037000,2037000,1930,50144,52074,Bronx,1709084.312,Williamsbridge-Olinville
19-Aug,36005037000,2037000,10388,79943,90331,Bronx,1709084.312,Williamsbridge-Olinville
21-Aug,36005037000,2037000,4408,47070,51478,Bronx,1709084.312,Williamsbridge-Olinville
19-May,36005037100,2037100,10193,97245,107438,Bronx,2128494.652,Tremont
21-May,36005037100,2037100,5975,61027,67002,Bronx,2128494.652,Tremont
19-Jun,36005037100,2037100,13875,45424,59299,Bronx,2128494.652,Tremont
21-Jun,36005037100,2037100,4162,121123,125285,Bronx,2128494.652,Tremont
19-Jul,36005037100,2037100,10882,37537,48419,Bronx,2128494.652,Tremont
21-Jul,36005037100,2037100,15336,134589,149925,Bronx,2128494.652,Tremont
19-Aug,36005037100,2037100,4298,156137,160435,Bronx,2128494.652,Tremont
21-Aug,36005037100,2037100,10804,108266,119070,Bronx,2128494.652,Tremont
19-May,36005037200,2037200,10766,53102,63868,Bronx,2008935.357,Williamsbridge-Olinville
21-May,36005037200,2037200,12989,63649,76638,Bronx,2008935.357,Williamsbridge-Olinville
19-Jun,36005037200,2037200,7497,101316,108813,Bronx,2008935.357,Williamsbridge-Olinville
21-Jun,36005037200,2037200,2805,11535,14340,Bronx,2008935.357,Williamsbridge-Olinville
19-Jul,36005037200,2037200,3629,106017,109646,Bronx,2008935.357,Williamsbridge-Olinville
21-Jul,36005037200,2037200,7152,38293,45445,Bronx,2008935.357,Williamsbridge-Olinville
19-Aug,36005037200,2037200,6869,58016,64885,Bronx,2008935.357,Williamsbridge-Olinville
21-Aug,36005037200,2037200,4996,121066,126062,Bronx,2008935.357,Williamsbridge-Olinville
19-May,36005037300,2037300,17152,54682,71834,Bronx,1864495.109,Tremont
21-May,36005037300,2037300,0,71,71,Bronx,1864495.109,Tremont
19-Jun,36005037300,2037300,0,40619,40619,Bronx,1864495.109,Tremont
21-Jun,36005037300,2037300,4022,93530,97552,Bronx,1864495.109,Tremont
19-Jul,36005037300,2037300,10019,98983,109002,Bronx,1864495.109,Tremont
21-Jul,36005037300,2037300,0,30831,30831,Bronx,1864495.109,Tremont
19-Aug,36005037300,2037300,22290,51438,73728,Bronx,1864495.109,Tremont
21-Aug,36005037300,2037300,11623,32708,44331,Bronx,1864495.109,Tremont
19-May,36005037400,2037400,12484,48921,61405,Bronx,1799978.253,Williamsbridge-Olinville
21-May,36005037400,2037400,3838,33151,36989,Bronx,1799978.253,Williamsbridge-Olinville
19-Jun,36005037400,2037400,2228,83635,85863,Bronx,1799978.253,Williamsbridge-Olinville
21-Jun,36005037400,2037400,13895,79398,93293,Bronx,1799978.253,Williamsbridge-Olinville
19-Jul,36005037400,2037400,7551,34475,42026,Bronx,1799978.253,Williamsbridge-Olinville
21-Jul,36005037400,2037400,4797,125489,130286,Bronx,1799978.253,Williamsbridge-Olinville
19-Aug,36005037400,2037400,5265,46081,51346,Bronx,1799978.253,Williamsbridge-Olinville
21-Aug,36005037400,2037400,13875,71,13946,Bronx,1799978.253,Williamsbridge-Olinville
19-May,36005037504,2037504,13622,67088,80710,Bronx,2586046.38,Tremont
21-May,36005037504,2037504,0,119791,119791,Bronx,2586046.38,Tremont
19-Jun,36005037504,2037504,7040,52526,59566,Bronx,2586046.38,Tremont
21-Jun,36005037504,2037504,6498,86022,92520,Bronx,2586046.38,Tremont
19-Jul,36005037504,2037504,1211,135293,136504,Bronx,2586046.38,Tremont
21-Jul,36005037504,2037504,10179,51504,61683,Bronx,2586046.38,Tremont
19-Aug,36005037504,2037504,31,106344,106375,Bronx,2586046.38,Tremont
21-Aug,36005037504,2037504,5537,74848,80385,Bronx,2586046.38,Tremont
19-May,36005038200,2038200,11933,105894,117827,Bronx,1704010.145,Williamsbridge-Olinville
21-May,36005038200,2038200,5172,61776,66948,Bronx,1704010.145,Williamsbridge-Olinville
19-Jun,36005038200,2038200,18299,93735,112034,Bronx,1704010.145,Williamsbridge-Olinville
21-Jun,36005038200,2038200,7482,61496,68978,Bronx,1704010.145,Williamsbridge-Olinville
19-Jul,36005038200,2038200,13449,76517,89966,Bronx,1704010.145,Williamsbridge-Olinville
21-Jul,36005038200,2038200,8403,33364,41767,Bronx,1704010.145,Williamsbridge-Olinville
19-Aug,36005038200,2038200,9279,41408,50687,Bronx,1704010.145,Williamsbridge-Olinville
21-Aug,36005038200,2038200,5075,30195,35270,Bronx,1704010.145,Williamsbridge-Olinville
19-May,36005038301,2038301,13308,116951,130259,Bronx,1030540.595,Fordham Heights
21-May,36005038301,2038301,7996,102030,110026,Bronx,1030540.595,Fordham Heights
19-Jun,36005038301,2038301,11522,101861,113383,Bronx,1030540.595,Fordham Heights
21-Jun,36005038301,2038301,9439,104697,114136,Bronx,1030540.595,Fordham Heights
19-Jul,36005038301,2038301,5700,92960,98660,Bronx,1030540.595,Fordham Heights
21-Jul,36005038301,2038301,16166,116309,132475,Bronx,1030540.595,Fordham Heights
19-Aug,36005038301,2038301,13925,128662,142587,Bronx,1030540.595,Fordham Heights
21-Aug,36005038301,2038301,1168,46238,47406,Bronx,1030540.595,Fordham Heights
19-May,36005038600,2038600,8278,46052,54330,Bronx,4405922.405,Eastchester-Edenwald-Baychester
21-May,36005038600,2038600,14654,6949,21603,Bronx,4405922.405,Eastchester-Edenwald-Baychester
19-Jun,36005038600,2038600,0,109109,109109,Bronx,4405922.405,Eastchester-Edenwald-Baychester
21-Jun,36005038600,2038600,11529,68084,79613,Bronx,4405922.405,Eastchester-Edenwald-Baychester
19-Jul,36005038600,2038600,9161,61513,70674,Bronx,4405922.405,Eastchester-Edenwald-Baychester
21-Jul,36005038600,2038600,9966,10987,20953,Bronx,4405922.405,Eastchester-Edenwald-Baychester
19-Aug,36005038600,2038600,3354,156627,159981,Bronx,4405922.405,Eastchester-Edenwald-Baychester
21-Aug,36005038600,2038600,1340,71,1411,Bronx,4405922.405,Eastchester-Edenwald-Baychester
19-May,36005038700,2038700,12315,13255,25570,Bronx,1971794.597,Belmont
21-May,36005038700,2038700,1654,88139,89793,Bronx,1971794.597,Belmont
19-Jun,36005038700,2038700,7444,78398,85842,Bronx,1971794.597,Belmont
21-Jun,36005038700,2038700,8852,127401,136253,Bronx,1971794.597,Belmont
19-Jul,36005038700,2038700,15175,44567,59742,Bronx,1971794.597,Belmont
21-Jul,36005038700,2038700,7524,104918,112442,Bronx,1971794.597,Belmont
19-Aug,36005038700,2038700,10829,50614,61443,Bronx,1971794.597,Belmont
21-Aug,36005038700,2038700,6819,98324,105143,Bronx,1971794.597,Belmont
19-May,36005038800,2038800,13448,72631,86079,Bronx,1593876.135,Williamsbridge-Olinville
21-May,36005038800,2038800,10424,74033,84457,Bronx,1593876.135,Williamsbridge-Olinville
19-Jun,36005038800,2038800,5131,32612,37743,Bronx,1593876.135,Williamsbridge-Olinville
21-Jun,36005038800,2038800,0,101899,101899,Bronx,1593876.135,Williamsbridge-Olinville
19-Jul,36005038800,2038800,3953,54691,58644,Bronx,1593876.135,Williamsbridge-Olinville
21-Jul,36005038800,2038800,16220,24285,40505,Bronx,1593876.135,Williamsbridge-Olinville
19-Aug,36005038800,2038800,14265,31158,45423,Bronx,1593876.135,Williamsbridge-Olinville
21-Aug,36005038800,2038800,5303,47781,53084,Bronx,1593876.135,Williamsbridge-Olinville
19-May,36005039000,2039000,16566,50150,66716,Bronx,1959260.039,Williamsbridge-Olinville
21-May,36005039000,2039000,4043,68457,72500,Bronx,1959260.039,Williamsbridge-Olinville
19-Jun,36005039000,2039000,9598,26656,36254,Bronx,1959260.039,Williamsbridge-Olinville
21-Jun,36005039000,2039000,10441,111816,122257,Bronx,1959260.039,Williamsbridge-Olinville
19-Jul,36005039000,2039000,5614,115566,121180,Bronx,1959260.039,Williamsbridge-Olinville
21-Jul,36005039000,2039000,18230,48859,67089,Bronx,1959260.039,Williamsbridge-Olinville
19-Aug,36005039000,2039000,6869,77977,84846,Bronx,1959260.039,Williamsbridge-Olinville
21-Aug,36005039000,2039000,7302,48541,55843,Bronx,1959260.039,Williamsbridge-Olinville
19-May,36005039100,2039100,0,98527,98527,Bronx,2213716.112,Belmont
21-May,36005039100,2039100,10768,70696,81464,Bronx,2213716.112,Belmont
19-Jun,36005039100,2039100,13545,71,13616,Bronx,2213716.112,Belmont
21-Jun,36005039100,2039100,7040,2097,9137,Bronx,2213716.112,Belmont
19-Jul,36005039100,2039100,10672,16793,27465,Bronx,2213716.112,Belmont
21-Jul,36005039100,2039100,11464,71,11535,Bronx,2213716.112,Belmont
19-Aug,36005039100,2039100,11510,109020,120530,Bronx,2213716.112,Belmont
21-Aug,36005039100,2039100,6510,82104,88614,Bronx,2213716.112,Belmont
19-May,36005039200,2039200,5944,34502,40446,Bronx,1035615.788,Williamsbridge-Olinville
21-May,36005039200,2039200,3152,103834,106986,Bronx,1035615.788,Williamsbridge-Olinville
19-Jun,36005039200,2039200,8235,105006,113241,Bronx,1035615.788,Williamsbridge-Olinville
21-Jun,36005039200,2039200,8318,101211,109529,Bronx,1035615.788,Williamsbridge-Olinville
19-Jul,36005039200,2039200,8490,51821,60311,Bronx,1035615.788,Williamsbridge-Olinville
21-Jul,36005039200,2039200,15252,64389,79641,Bronx,1035615.788,Williamsbridge-Olinville
19-Aug,36005039200,2039200,11187,117222,128409,Bronx,1035615.788,Williamsbridge-Olinville
21-Aug,36005039200,2039200,10180,33039,43219,Bronx,1035615.788,Williamsbridge-Olinville
19-May,36005039400,2039400,10915,67560,78475,Bronx,1560974.46,Williamsbridge-Olinville
21-May,36005039400,2039400,516,99521,100037,Bronx,1560974.46,Williamsbridge-Olinville
19-Jun,36005039400,2039400,11398,34288,45686,Bronx,1560974.46,Williamsbridge-Olinville
21-Jun,36005039400,2039400,8768,66344,75112,Bronx,1560974.46,Williamsbridge-Olinville
19-Jul,36005039400,2039400,10717,56690,67407,Bronx,1560974.46,Williamsbridge-Olinville
21-Jul,36005039400,2039400,20346,87664,108010,Bronx,1560974.46,Williamsbridge-Olinville
19-Aug,36005039400,2039400,2934,86396,89330,Bronx,1560974.46,Williamsbridge-Olinville
21-Aug,36005039400,2039400,5634,50712,56346,Bronx,1560974.46,Williamsbridge-Olinville
19-May,36005039600,2039600,13264,46235,59499,Bronx,2402726.565,Williamsbridge-Olinville
21-May,36005039600,2039600,13373,98349,111722,Bronx,2402726.565,Williamsbridge-Olinville
19-Jun,36005039600,2039600,8220,15406,23626,Bronx,2402726.565,Williamsbridge-Olinville
21-Jun,36005039600,2039600,6802,42132,48934,Bronx,2402726.565,Williamsbridge-Olinville
19-Jul,36005039600,2039600,8385,85420,93805,Bronx,2402726.565,Williamsbridge-Olinville
21-Jul,36005039600,2039600,7067,97891,104958,Bronx,2402726.565,Williamsbridge-Olinville
19-Aug,36005039600,2039600,6679,83674,90353,Bronx,2402726.565,Williamsbridge-Olinville
21-Aug,36005039600,2039600,5421,54898,60319,Bronx,2402726.565,Williamsbridge-Olinville
19-May,36005039800,2039800,10649,65308,75957,Bronx,2172955.407,Williamsbridge-Olinville
21-May,36005039800,2039800,6635,91838,98473,Bronx,2172955.407,Williamsbridge-Olinville
19-Jun,36005039800,2039800,13174,78615,91789,Bronx,2172955.407,Williamsbridge-Olinville
21-Jun,36005039800,2039800,7373,49937,57310,Bronx,2172955.407,Williamsbridge-Olinville
19-Jul,36005039800,2039800,11616,51954,63570,Bronx,2172955.407,Williamsbridge-Olinville
21-Jul,36005039800,2039800,0,81538,81538,Bronx,2172955.407,Williamsbridge-Olinville
19-Aug,36005039800,2039800,13278,63456,76734,Bronx,2172955.407,Williamsbridge-Olinville
21-Aug,36005039800,2039800,11259,109924,121183,Bronx,2172955.407,Williamsbridge-Olinville
19-May,36005040302,2040302,8954,72618,81572,Bronx,682700.6587,Bedford Park
21-May,36005040302,2040302,10915,71,10986,Bronx,682700.6587,Bedford Park
19-Jun,36005040302,2040302,0,21315,21315,Bronx,682700.6587,Bedford Park
21-Jun,36005040302,2040302,4431,127063,131494,Bronx,682700.6587,Bedford Park
19-Jul,36005040302,2040302,14534,164411,178945,Bronx,682700.6587,Bedford Park
21-Jul,36005040302,2040302,3769,86844,90613,Bronx,682700.6587,Bedford Park
19-Aug,36005040302,2040302,0,117635,117635,Bronx,682700.6587,Bedford Park
21-Aug,36005040302,2040302,4976,59909,64885,Bronx,682700.6587,Bedford Park
19-May,36005040303,2040303,14633,76077,90710,Bronx,949187.694,Bedford Park
21-May,36005040303,2040303,8637,3503,12140,Bronx,949187.694,Bedford Park
19-Jun,36005040303,2040303,9827,83872,93699,Bronx,949187.694,Bedford Park
21-Jun,36005040303,2040303,12669,54239,66908,Bronx,949187.694,Bedford Park
19-Jul,36005040303,2040303,12232,9549,21781,Bronx,949187.694,Bedford Park
21-Jul,36005040303,2040303,17927,62035,79962,Bronx,949187.694,Bedford Park
19-Aug,36005040303,2040303,5593,51317,56910,Bronx,949187.694,Bedford Park
21-Aug,36005040303,2040303,9262,90071,99333,Bronx,949187.694,Bedford Park
19-May,36005040304,2040304,3428,65805,69233,Bronx,723328.3457,Bedford Park
21-May,36005040304,2040304,10167,21617,31784,Bronx,723328.3457,Bedford Park
19-Jun,36005040304,2040304,11332,112191,123523,Bronx,723328.3457,Bedford Park
21-Jun,36005040304,2040304,17481,14980,32461,Bronx,723328.3457,Bedford Park
19-Jul,36005040304,2040304,14032,80700,94732,Bronx,723328.3457,Bedford Park
21-Jul,36005040304,2040304,1971,94642,96613,Bronx,723328.3457,Bedford Park
19-Aug,36005040304,2040304,13952,86820,100772,Bronx,723328.3457,Bedford Park
21-Aug,36005040304,2040304,9857,100006,109863,Bronx,723328.3457,Bedford Park
19-May,36005040400,2040400,8392,108634,117026,Bronx,2316966.921,Williamsbridge-Olinville
21-May,36005040400,2040400,2247,99668,101915,Bronx,2316966.921,Williamsbridge-Olinville
19-Jun,36005040400,2040400,3258,23233,26491,Bronx,2316966.921,Williamsbridge-Olinville
21-Jun,36005040400,2040400,0,88580,88580,Bronx,2316966.921,Williamsbridge-Olinville
19-Jul,36005040400,2040400,4031,112369,116400,Bronx,2316966.921,Williamsbridge-Olinville
21-Jul,36005040400,2040400,2950,40589,43539,Bronx,2316966.921,Williamsbridge-Olinville
19-Aug,36005040400,2040400,4864,96642,101506,Bronx,2316966.921,Williamsbridge-Olinville
21-Aug,36005040400,2040400,3791,145761,149552,Bronx,2316966.921,Williamsbridge-Olinville
19-May,36005040501,2040501,10358,99786,110144,Bronx,873437.2758,Bedford Park
21-May,36005040501,2040501,5159,19435,24594,Bronx,873437.2758,Bedford Park
19-Jun,36005040501,2040501,0,54417,54417,Bronx,873437.2758,Bedford Park
21-Jun,36005040501,2040501,0,59318,59318,Bronx,873437.2758,Bedford Park
19-Jul,36005040501,2040501,8345,113372,121717,Bronx,873437.2758,Bedford Park
21-Jul,36005040501,2040501,14665,85954,100619,Bronx,873437.2758,Bedford Park
19-Aug,36005040501,2040501,6576,106840,113416,Bronx,873437.2758,Bedford Park
21-Aug,36005040501,2040501,13793,85670,99463,Bronx,873437.2758,Bedford Park
19-May,36005040502,2040502,3674,84583,88257,Bronx,1534114.739,Bedford Park
21-May,36005040502,2040502,9463,8581,18044,Bronx,1534114.739,Bedford Park
19-Jun,36005040502,2040502,7936,69734,77670,Bronx,1534114.739,Bedford Park
21-Jun,36005040502,2040502,19662,165433,185095,Bronx,1534114.739,Bedford Park
19-Jul,36005040502,2040502,7088,56534,63622,Bronx,1534114.739,Bedford Park
21-Jul,36005040502,2040502,0,61830,61830,Bronx,1534114.739,Bedford Park
19-Aug,36005040502,2040502,12159,78875,91034,Bronx,1534114.739,Bedford Park
21-Aug,36005040502,2040502,7061,115222,122283,Bronx,1534114.739,Bedford Park
19-May,36005040600,2040600,975,90884,91859,Bronx,2403938.307,Williamsbridge-Olinville
21-May,36005040600,2040600,9655,84636,94291,Bronx,2403938.307,Williamsbridge-Olinville
19-Jun,36005040600,2040600,4351,42105,46456,Bronx,2403938.307,Williamsbridge-Olinville
21-Jun,36005040600,2040600,18406,60436,78842,Bronx,2403938.307,Williamsbridge-Olinville
19-Jul,36005040600,2040600,1452,9375,10827,Bronx,2403938.307,Williamsbridge-Olinville
21-Jul,36005040600,2040600,6137,97660,103797,Bronx,2403938.307,Williamsbridge-Olinville
19-Aug,36005040600,2040600,8450,923,9373,Bronx,2403938.307,Williamsbridge-Olinville
21-Aug,36005040600,2040600,8649,70265,78914,Bronx,2403938.307,Williamsbridge-Olinville
19-May,36005040701,2040701,5093,63428,68521,Bronx,630565.9989,Bedford Park
21-May,36005040701,2040701,11367,64071,75438,Bronx,630565.9989,Bedford Park
19-Jun,36005040701,2040701,18844,83987,102831,Bronx,630565.9989,Bedford Park
21-Jun,36005040701,2040701,14375,72231,86606,Bronx,630565.9989,Bedford Park
19-Jul,36005040701,2040701,9618,6069,15687,Bronx,630565.9989,Bedford Park
21-Jul,36005040701,2040701,5383,146246,151629,Bronx,630565.9989,Bedford Park
19-Aug,36005040701,2040701,11359,90247,101606,Bronx,630565.9989,Bedford Park
21-Aug,36005040701,2040701,5268,53587,58855,Bronx,630565.9989,Bedford Park
19-May,36005040702,2040702,3395,68668,72063,Bronx,1956959.069,Bedford Park
21-May,36005040702,2040702,5721,61003,66724,Bronx,1956959.069,Bedford Park
19-Jun,36005040702,2040702,11131,71,11202,Bronx,1956959.069,Bedford Park
21-Jun,36005040702,2040702,10317,79981,90298,Bronx,1956959.069,Bedford Park
19-Jul,36005040702,2040702,5685,126066,131751,Bronx,1956959.069,Bedford Park
21-Jul,36005040702,2040702,11888,113446,125334,Bronx,1956959.069,Bedford Park
19-Aug,36005040702,2040702,12911,83524,96435,Bronx,1956959.069,Bedford Park
21-Aug,36005040702,2040702,7144,31762,38906,Bronx,1956959.069,Bedford Park
19-May,36005040800,2040800,1748,8825,10573,Bronx,1323605.762,Williamsbridge-Olinville
21-May,36005040800,2040800,17258,149300,166558,Bronx,1323605.762,Williamsbridge-Olinville
19-Jun,36005040800,2040800,9576,87098,96674,Bronx,1323605.762,Williamsbridge-Olinville
21-Jun,36005040800,2040800,5924,63128,69052,Bronx,1323605.762,Williamsbridge-Olinville
19-Jul,36005040800,2040800,7472,46098,53570,Bronx,1323605.762,Williamsbridge-Olinville
21-Jul,36005040800,2040800,3932,105976,109908,Bronx,1323605.762,Williamsbridge-Olinville
19-Aug,36005040800,2040800,1969,77793,79762,Bronx,1323605.762,Williamsbridge-Olinville
21-Aug,36005040800,2040800,6255,81878,88133,Bronx,1323605.762,Williamsbridge-Olinville
19-May,36005041500,2041500,7660,99570,107230,Bronx,1471377.991,Bedford Park
21-May,36005041500,2041500,11926,97645,109571,Bronx,1471377.991,Bedford Park
19-Jun,36005041500,2041500,11748,35442,47190,Bronx,1471377.991,Bedford Park
21-Jun,36005041500,2041500,21,116480,116501,Bronx,1471377.991,Bedford Park
19-Jul,36005041500,2041500,7360,92431,99791,Bronx,1471377.991,Bedford Park
21-Jul,36005041500,2041500,4208,55972,60180,Bronx,1471377.991,Bedford Park
19-Aug,36005041500,2041500,8408,81606,90014,Bronx,1471377.991,Bedford Park
21-Aug,36005041500,2041500,6790,35418,42208,Bronx,1471377.991,Bedford Park
19-May,36005041900,2041900,11043,71,11114,Bronx,3505470.626,Norwood
21-May,36005041900,2041900,11217,62573,73790,Bronx,3505470.626,Norwood
19-Jun,36005041900,2041900,7515,43282,50797,Bronx,3505470.626,Norwood
21-Jun,36005041900,2041900,7442,41798,49240,Bronx,3505470.626,Norwood
19-Jul,36005041900,2041900,10287,96114,106401,Bronx,3505470.626,Norwood
21-Jul,36005041900,2041900,13016,46366,59382,Bronx,3505470.626,Norwood
19-Aug,36005041900,2041900,3924,58411,62335,Bronx,3505470.626,Norwood
21-Aug,36005041900,2041900,8206,112237,120443,Bronx,3505470.626,Norwood
19-May,36005042000,2042000,1650,112185,113835,Bronx,1615128.649,Wakefield-Woodlawn
21-May,36005042000,2042000,6029,45188,51217,Bronx,1615128.649,Wakefield-Woodlawn
19-Jun,36005042000,2042000,9329,74953,84282,Bronx,1615128.649,Wakefield-Woodlawn
21-Jun,36005042000,2042000,5945,111493,117438,Bronx,1615128.649,Wakefield-Woodlawn
19-Jul,36005042000,2042000,11810,80661,92471,Bronx,1615128.649,Wakefield-Woodlawn
21-Jul,36005042000,2042000,16839,33274,50113,Bronx,1615128.649,Wakefield-Woodlawn
19-Aug,36005042000,2042000,978,27374,28352,Bronx,1615128.649,Wakefield-Woodlawn
21-Aug,36005042000,2042000,19808,83230,103038,Bronx,1615128.649,Wakefield-Woodlawn
19-May,36005042200,2042200,4478,77330,81808,Bronx,1884434.654,Wakefield-Woodlawn
21-May,36005042200,2042200,5517,87090,92607,Bronx,1884434.654,Wakefield-Woodlawn
19-Jun,36005042200,2042200,8451,11953,20404,Bronx,1884434.654,Wakefield-Woodlawn
21-Jun,36005042200,2042200,20009,88893,108902,Bronx,1884434.654,Wakefield-Woodlawn
19-Jul,36005042200,2042200,14020,143546,157566,Bronx,1884434.654,Wakefield-Woodlawn
21-Jul,36005042200,2042200,6352,94408,100760,Bronx,1884434.654,Wakefield-Woodlawn
19-Aug,36005042200,2042200,9459,58453,67912,Bronx,1884434.654,Wakefield-Woodlawn
21-Aug,36005042200,2042200,7098,68578,75676,Bronx,1884434.654,Wakefield-Woodlawn
19-May,36005042300,2042300,5661,13362,19023,Bronx,1939179.567,Norwood
21-May,36005042300,2042300,14738,104536,119274,Bronx,1939179.567,Norwood
19-Jun,36005042300,2042300,11331,67214,78545,Bronx,1939179.567,Norwood
21-Jun,36005042300,2042300,10492,39800,50292,Bronx,1939179.567,Norwood
19-Jul,36005042300,2042300,16074,103453,119527,Bronx,1939179.567,Norwood
21-Jul,36005042300,2042300,7621,48259,55880,Bronx,1939179.567,Norwood
19-Aug,36005042300,2042300,5848,78550,84398,Bronx,1939179.567,Norwood
21-Aug,36005042300,2042300,4205,110861,115066,Bronx,1939179.567,Norwood
19-May,36005042400,2042400,10800,71717,82517,Bronx,1882378.491,Wakefield-Woodlawn
21-May,36005042400,2042400,9730,64869,74599,Bronx,1882378.491,Wakefield-Woodlawn
19-Jun,36005042400,2042400,12294,68051,80345,Bronx,1882378.491,Wakefield-Woodlawn
21-Jun,36005042400,2042400,12726,36649,49375,Bronx,1882378.491,Wakefield-Woodlawn
19-Jul,36005042400,2042400,4155,31562,35717,Bronx,1882378.491,Wakefield-Woodlawn
21-Jul,36005042400,2042400,0,75974,75974,Bronx,1882378.491,Wakefield-Woodlawn
19-Aug,36005042400,2042400,13445,134762,148207,Bronx,1882378.491,Wakefield-Woodlawn
21-Aug,36005042400,2042400,7975,84366,92341,Bronx,1882378.491,Wakefield-Woodlawn
19-May,36005042800,2042800,3871,97256,101127,Bronx,1821034.949,Wakefield-Woodlawn
21-May,36005042800,2042800,5918,52470,58388,Bronx,1821034.949,Wakefield-Woodlawn
19-Jun,36005042800,2042800,10718,50899,61617,Bronx,1821034.949,Wakefield-Woodlawn
21-Jun,36005042800,2042800,4072,2893,6965,Bronx,1821034.949,Wakefield-Woodlawn
19-Jul,36005042800,2042800,8643,80524,89167,Bronx,1821034.949,Wakefield-Woodlawn
21-Jul,36005042800,2042800,7443,48097,55540,Bronx,1821034.949,Wakefield-Woodlawn
19-Aug,36005042800,2042800,15010,84744,99754,Bronx,1821034.949,Wakefield-Woodlawn
21-Aug,36005042800,2042800,9810,107989,117799,Bronx,1821034.949,Wakefield-Woodlawn
19-May,36005042902,2042902,6133,37812,43945,Bronx,1011498.962,Norwood
21-May,36005042902,2042902,1363,74241,75604,Bronx,1011498.962,Norwood
19-Jun,36005042902,2042902,968,48512,49480,Bronx,1011498.962,Norwood
21-Jun,36005042902,2042902,11248,48709,59957,Bronx,1011498.962,Norwood
19-Jul,36005042902,2042902,11897,80635,92532,Bronx,1011498.962,Norwood
21-Jul,36005042902,2042902,12335,61660,73995,Bronx,1011498.962,Norwood
19-Aug,36005042902,2042902,8371,119353,127724,Bronx,1011498.962,Norwood
21-Aug,36005042902,2042902,15077,71,15148,Bronx,1011498.962,Norwood
19-May,36005043000,2043000,11356,69854,81210,Bronx,2219376.108,Wakefield-Woodlawn
21-May,36005043000,2043000,4463,53406,57869,Bronx,2219376.108,Wakefield-Woodlawn
19-Jun,36005043000,2043000,16115,48215,64330,Bronx,2219376.108,Wakefield-Woodlawn
21-Jun,36005043000,2043000,13973,76023,89996,Bronx,2219376.108,Wakefield-Woodlawn
19-Jul,36005043000,2043000,8995,26070,35065,Bronx,2219376.108,Wakefield-Woodlawn
21-Jul,36005043000,2043000,7732,37702,45434,Bronx,2219376.108,Wakefield-Woodlawn
19-Aug,36005043000,2043000,10880,9561,20441,Bronx,2219376.108,Wakefield-Woodlawn
21-Aug,36005043000,2043000,4895,19941,24836,Bronx,2219376.108,Wakefield-Woodlawn
19-May,36005043101,2043101,12649,62958,75607,Bronx,1102962.888,Norwood
21-May,36005043101,2043101,10147,49573,59720,Bronx,1102962.888,Norwood
19-Jun,36005043101,2043101,10429,105558,115987,Bronx,1102962.888,Norwood
21-Jun,36005043101,2043101,9067,156673,165740,Bronx,1102962.888,Norwood
19-Jul,36005043101,2043101,12423,38793,51216,Bronx,1102962.888,Norwood
21-Jul,36005043101,2043101,3918,95263,99181,Bronx,1102962.888,Norwood
19-Aug,36005043101,2043101,5173,119765,124938,Bronx,1102962.888,Norwood
21-Aug,36005043101,2043101,4292,60106,64398,Bronx,1102962.888,Norwood
19-May,36005043400,2043400,4672,71517,76189,Bronx,3761013.026,Wakefield-Woodlawn
21-May,36005043400,2043400,15107,60111,75218,Bronx,3761013.026,Wakefield-Woodlawn
19-Jun,36005043400,2043400,0,82528,82528,Bronx,3761013.026,Wakefield-Woodlawn
21-Jun,36005043400,2043400,7075,57233,64308,Bronx,3761013.026,Wakefield-Woodlawn
19-Jul,36005043400,2043400,1365,60343,61708,Bronx,3761013.026,Wakefield-Woodlawn
21-Jul,36005043400,2043400,14877,121784,136661,Bronx,3761013.026,Wakefield-Woodlawn
19-Aug,36005043400,2043400,3120,22787,25907,Bronx,3761013.026,Wakefield-Woodlawn
21-Aug,36005043400,2043400,5539,67280,72819,Bronx,3761013.026,Wakefield-Woodlawn
19-May,36005043600,2043600,1360,59093,60453,Bronx,1679294.215,Wakefield-Woodlawn
21-May,36005043600,2043600,0,59408,59408,Bronx,1679294.215,Wakefield-Woodlawn
19-Jun,36005043600,2043600,3358,65569,68927,Bronx,1679294.215,Wakefield-Woodlawn
21-Jun,36005043600,2043600,16379,167421,183800,Bronx,1679294.215,Wakefield-Woodlawn
19-Jul,36005043600,2043600,6443,4168,10611,Bronx,1679294.215,Wakefield-Woodlawn
21-Jul,36005043600,2043600,3453,28938,32391,Bronx,1679294.215,Wakefield-Woodlawn
19-Aug,36005043600,2043600,8842,62922,71764,Bronx,1679294.215,Wakefield-Woodlawn
21-Aug,36005043600,2043600,4399,77335,81734,Bronx,1679294.215,Wakefield-Woodlawn
19-May,36005044200,2044200,7616,75025,82641,Bronx,2615882.212,Wakefield-Woodlawn
21-May,36005044200,2044200,6958,85392,92350,Bronx,2615882.212,Wakefield-Woodlawn
19-Jun,36005044200,2044200,9416,53266,62682,Bronx,2615882.212,Wakefield-Woodlawn
21-Jun,36005044200,2044200,5229,48441,53670,Bronx,2615882.212,Wakefield-Woodlawn
19-Jul,36005044200,2044200,8342,102969,111311,Bronx,2615882.212,Wakefield-Woodlawn
21-Jul,36005044200,2044200,13358,61315,74673,Bronx,2615882.212,Wakefield-Woodlawn
19-Aug,36005044200,2044200,10731,99627,110358,Bronx,2615882.212,Wakefield-Woodlawn
21-Aug,36005044200,2044200,3250,10962,14212,Bronx,2615882.212,Wakefield-Woodlawn
19-May,36005044400,2044400,1364,73640,75004,Bronx,3923532.515,Wakefield-Woodlawn
21-May,36005044400,2044400,9787,95573,105360,Bronx,3923532.515,Wakefield-Woodlawn
19-Jun,36005044400,2044400,6294,22162,28456,Bronx,3923532.515,Wakefield-Woodlawn
21-Jun,36005044400,2044400,3670,51698,55368,Bronx,3923532.515,Wakefield-Woodlawn
19-Jul,36005044400,2044400,6814,59583,66397,Bronx,3923532.515,Wakefield-Woodlawn
21-Jul,36005044400,2044400,10071,57670,67741,Bronx,3923532.515,Wakefield-Woodlawn
19-Aug,36005044400,2044400,8160,71,8231,Bronx,3923532.515,Wakefield-Woodlawn
21-Aug,36005044400,2044400,14578,100883,115461,Bronx,3923532.515,Wakefield-Woodlawn
19-May,36005044800,2044800,1939,40076,42015,Bronx,1817407.016,Wakefield-Woodlawn
21-May,36005044800,2044800,1597,104747,106344,Bronx,1817407.016,Wakefield-Woodlawn
19-Jun,36005044800,2044800,11784,35208,46992,Bronx,1817407.016,Wakefield-Woodlawn
21-Jun,36005044800,2044800,13842,92685,106527,Bronx,1817407.016,Wakefield-Woodlawn
19-Jul,36005044800,2044800,14322,81967,96289,Bronx,1817407.016,Wakefield-Woodlawn
21-Jul,36005044800,2044800,9464,61101,70565,Bronx,1817407.016,Wakefield-Woodlawn
19-Aug,36005044800,2044800,6964,53632,60596,Bronx,1817407.016,Wakefield-Woodlawn
21-Aug,36005044800,2044800,9705,140523,150228,Bronx,1817407.016,Wakefield-Woodlawn
19-May,36005044901,2044901,12197,25308,37505,Bronx,1709948.088,Wakefield-Woodlawn
21-May,36005044901,2044901,6394,105779,112173,Bronx,1709948.088,Wakefield-Woodlawn
19-Jun,36005044901,2044901,7110,41355,48465,Bronx,1709948.088,Wakefield-Woodlawn
21-Jun,36005044901,2044901,14282,48103,62385,Bronx,1709948.088,Wakefield-Woodlawn
19-Jul,36005044901,2044901,15822,68586,84408,Bronx,1709948.088,Wakefield-Woodlawn
21-Jul,36005044901,2044901,5336,36721,42057,Bronx,1709948.088,Wakefield-Woodlawn
19-Aug,36005044901,2044901,9922,98322,108244,Bronx,1709948.088,Wakefield-Woodlawn
21-Aug,36005044901,2044901,10997,97551,108548,Bronx,1709948.088,Wakefield-Woodlawn
19-May,36005044902,2044902,3937,39455,43392,Bronx,1676407.582,Wakefield-Woodlawn
21-May,36005044902,2044902,7321,92892,100213,Bronx,1676407.582,Wakefield-Woodlawn
19-Jun,36005044902,2044902,0,73709,73709,Bronx,1676407.582,Wakefield-Woodlawn
21-Jun,36005044902,2044902,9265,69326,78591,Bronx,1676407.582,Wakefield-Woodlawn
19-Jul,36005044902,2044902,3231,158432,161663,Bronx,1676407.582,Wakefield-Woodlawn
21-Jul,36005044902,2044902,1602,3521,5123,Bronx,1676407.582,Wakefield-Woodlawn
19-Aug,36005044902,2044902,9674,106833,116507,Bronx,1676407.582,Wakefield-Woodlawn
21-Aug,36005044902,2044902,10166,48690,58856,Bronx,1676407.582,Wakefield-Woodlawn
19-May,36005045600,2045600,12063,89619,101682,Bronx,9450414.574,Eastchester-Edenwald-Baychester
21-May,36005045600,2045600,1847,141818,143665,Bronx,9450414.574,Eastchester-Edenwald-Baychester
19-Jun,36005045600,2045600,8125,76802,84927,Bronx,9450414.574,Eastchester-Edenwald-Baychester
21-Jun,36005045600,2045600,10973,44495,55468,Bronx,9450414.574,Eastchester-Edenwald-Baychester
19-Jul,36005045600,2045600,8637,48243,56880,Bronx,9450414.574,Eastchester-Edenwald-Baychester
21-Jul,36005045600,2045600,16671,107591,124262,Bronx,9450414.574,Eastchester-Edenwald-Baychester
19-Aug,36005045600,2045600,10927,111341,122268,Bronx,9450414.574,Eastchester-Edenwald-Baychester
21-Aug,36005045600,2045600,0,24299,24299,Bronx,9450414.574,Eastchester-Edenwald-Baychester
19-May,36005045800,2045800,8654,96262,104916,Bronx,2582516.455,Eastchester-Edenwald-Baychester
21-May,36005045800,2045800,7387,53749,61136,Bronx,2582516.455,Eastchester-Edenwald-Baychester
19-Jun,36005045800,2045800,10160,99324,109484,Bronx,2582516.455,Eastchester-Edenwald-Baychester
21-Jun,36005045800,2045800,13094,10211,23305,Bronx,2582516.455,Eastchester-Edenwald-Baychester
19-Jul,36005045800,2045800,9720,60491,70211,Bronx,2582516.455,Eastchester-Edenwald-Baychester
21-Jul,36005045800,2045800,4107,102134,106241,Bronx,2582516.455,Eastchester-Edenwald-Baychester
19-Aug,36005045800,2045800,2935,141363,144298,Bronx,2582516.455,Eastchester-Edenwald-Baychester
21-Aug,36005045800,2045800,0,108228,108228,Bronx,2582516.455,Eastchester-Edenwald-Baychester
19-May,36005046203,2046203,1395,81544,82939,Bronx,9658545.976,Co-op City
21-May,36005046203,2046203,11626,55842,67468,Bronx,9658545.976,Co-op City
19-Jun,36005046203,2046203,9537,26957,36494,Bronx,9658545.976,Co-op City
21-Jun,36005046203,2046203,5644,14112,19756,Bronx,9658545.976,Co-op City
19-Jul,36005046203,2046203,1774,71,1845,Bronx,9658545.976,Co-op City
21-Jul,36005046203,2046203,5200,77617,82817,Bronx,9658545.976,Co-op City
19-Aug,36005046203,2046203,12780,52555,65335,Bronx,9658545.976,Co-op City
21-Aug,36005046203,2046203,6904,108265,115169,Bronx,9658545.976,Co-op City
19-May,36005046204,2046204,10552,69724,80276,Bronx,1470909.089,Co-op City
21-May,36005046204,2046204,9200,56838,66038,Bronx,1470909.089,Co-op City
19-Jun,36005046204,2046204,14677,88678,103355,Bronx,1470909.089,Co-op City
21-Jun,36005046204,2046204,12171,130780,142951,Bronx,1470909.089,Co-op City
19-Jul,36005046204,2046204,10068,71367,81435,Bronx,1470909.089,Co-op City
21-Jul,36005046204,2046204,6372,71,6443,Bronx,1470909.089,Co-op City
19-Aug,36005046204,2046204,9357,1490,10847,Bronx,1470909.089,Co-op City
21-Aug,36005046204,2046204,3419,59236,62655,Bronx,1470909.089,Co-op City
19-May,36005046206,2046206,9406,34146,43552,Bronx,769214.6937,Co-op City
21-May,36005046206,2046206,6001,92357,98358,Bronx,769214.6937,Co-op City
19-Jun,36005046206,2046206,17342,101001,118343,Bronx,769214.6937,Co-op City
21-Jun,36005046206,2046206,7916,63625,71541,Bronx,769214.6937,Co-op City
19-Jul,36005046206,2046206,0,77929,77929,Bronx,769214.6937,Co-op City
21-Jul,36005046206,2046206,9064,42449,51513,Bronx,769214.6937,Co-op City
19-Aug,36005046206,2046206,11803,101343,113146,Bronx,769214.6937,Co-op City
21-Aug,36005046206,2046206,13452,73241,86693,Bronx,769214.6937,Co-op City
19-May,36005046207,2046207,13570,95010,108580,Bronx,1991108.99,Co-op City
21-May,36005046207,2046207,5400,77197,82597,Bronx,1991108.99,Co-op City
19-Jun,36005046207,2046207,8265,70745,79010,Bronx,1991108.99,Co-op City
21-Jun,36005046207,2046207,5441,47305,52746,Bronx,1991108.99,Co-op City
19-Jul,36005046207,2046207,12054,51409,63463,Bronx,1991108.99,Co-op City
21-Jul,36005046207,2046207,1144,31380,32524,Bronx,1991108.99,Co-op City
19-Aug,36005046207,2046207,12537,29500,42037,Bronx,1991108.99,Co-op City
21-Aug,36005046207,2046207,8671,71,8742,Bronx,1991108.99,Co-op City
19-May,36005046209,2046209,1504,152438,153942,Bronx,5133432.623,Eastchester-Edenwald-Baychester
21-May,36005046209,2046209,17158,34753,51911,Bronx,5133432.623,Eastchester-Edenwald-Baychester
19-Jun,36005046209,2046209,3779,85537,89316,Bronx,5133432.623,Eastchester-Edenwald-Baychester
21-Jun,36005046209,2046209,7295,79559,86854,Bronx,5133432.623,Eastchester-Edenwald-Baychester
19-Jul,36005046209,2046209,9498,116268,125766,Bronx,5133432.623,Eastchester-Edenwald-Baychester
21-Jul,36005046209,2046209,7284,24183,31467,Bronx,5133432.623,Eastchester-Edenwald-Baychester
19-Aug,36005046209,2046209,0,85183,85183,Bronx,5133432.623,Eastchester-Edenwald-Baychester
21-Aug,36005046209,2046209,13886,86093,99979,Bronx,5133432.623,Eastchester-Edenwald-Baychester
19-May,36005048401,2048401,7660,128033,135693,Bronx,5439600.141,Eastchester-Edenwald-Baychester
21-May,36005048401,2048401,1217,53092,54309,Bronx,5439600.141,Eastchester-Edenwald-Baychester
19-Jun,36005048401,2048401,10652,102791,113443,Bronx,5439600.141,Eastchester-Edenwald-Baychester
21-Jun,36005048401,2048401,7893,99471,107364,Bronx,5439600.141,Eastchester-Edenwald-Baychester
19-Jul,36005048401,2048401,5175,9689,14864,Bronx,5439600.141,Eastchester-Edenwald-Baychester
21-Jul,36005048401,2048401,5493,122346,127839,Bronx,5439600.141,Eastchester-Edenwald-Baychester
19-Aug,36005048401,2048401,13699,31072,44771,Bronx,5439600.141,Eastchester-Edenwald-Baychester
21-Aug,36005048401,2048401,7080,44881,51961,Bronx,5439600.141,Eastchester-Edenwald-Baychester
19-May,36005048402,2048402,12898,42177,55075,Bronx,2046789.968,Eastchester-Edenwald-Baychester
21-May,36005048402,2048402,4394,75012,79406,Bronx,2046789.968,Eastchester-Edenwald-Baychester
19-Jun,36005048402,2048402,12466,122235,134701,Bronx,2046789.968,Eastchester-Edenwald-Baychester
21-Jun,36005048402,2048402,7434,80435,87869,Bronx,2046789.968,Eastchester-Edenwald-Baychester
19-Jul,36005048402,2048402,4242,80556,84798,Bronx,2046789.968,Eastchester-Edenwald-Baychester
21-Jul,36005048402,2048402,15636,95232,110868,Bronx,2046789.968,Eastchester-Edenwald-Baychester
19-Aug,36005048402,2048402,2980,50177,53157,Bronx,2046789.968,Eastchester-Edenwald-Baychester
21-Aug,36005048402,2048402,6645,57099,63744,Bronx,2046789.968,Eastchester-Edenwald-Baychester
19-May,36005050400,2050400,17642,71,17713,Bronx,79303597.48,Pelham Bay Park
21-May,36005050400,2050400,9308,127067,136375,Bronx,79303597.48,Pelham Bay Park
19-Jun,36005050400,2050400,7701,55515,63216,Bronx,79303597.48,Pelham Bay Park
21-Jun,36005050400,2050400,13958,76962,90920,Bronx,79303597.48,Pelham Bay Park
19-Jul,36005050400,2050400,18254,72036,90290,Bronx,79303597.48,Pelham Bay Park
21-Jul,36005050400,2050400,5987,85449,91436,Bronx,79303597.48,Pelham Bay Park
19-Aug,36005050400,2050400,16543,19270,35813,Bronx,79303597.48,Pelham Bay Park
21-Aug,36005050400,2050400,13723,102002,115725,Bronx,79303597.48,Pelham Bay Park
19-May,36081000200,4000200,10210,53815,64025,Queens,1665705.38,Woodhaven
21-May,36081000200,4000200,10506,71,10577,Queens,1665705.38,Woodhaven
19-Jun,36081000200,4000200,8778,104418,113196,Queens,1665705.38,Woodhaven
21-Jun,36081000200,4000200,6438,66431,72869,Queens,1665705.38,Woodhaven
19-Jul,36081000200,4000200,902,64975,65877,Queens,1665705.38,Woodhaven
21-Jul,36081000200,4000200,13985,43845,57830,Queens,1665705.38,Woodhaven
19-Aug,36081000200,4000200,3630,23597,27227,Queens,1665705.38,Woodhaven
21-Aug,36081000200,4000200,22253,89895,112148,Queens,1665705.38,Woodhaven
19-May,36081000400,4000400,10742,121373,132115,Queens,2420866.254,Woodhaven
21-May,36081000400,4000400,4911,53000,57911,Queens,2420866.254,Woodhaven
19-Jun,36081000400,4000400,11401,85909,97310,Queens,2420866.254,Woodhaven
21-Jun,36081000400,4000400,12945,75575,88520,Queens,2420866.254,Woodhaven
19-Jul,36081000400,4000400,8811,55912,64723,Queens,2420866.254,Woodhaven
21-Jul,36081000400,4000400,3840,83625,87465,Queens,2420866.254,Woodhaven
19-Aug,36081000400,4000400,10994,99693,110687,Queens,2420866.254,Woodhaven
21-Aug,36081000400,4000400,2891,154504,157395,Queens,2420866.254,Woodhaven
19-May,36081000600,4000600,8746,70829,79575,Queens,2307340.951,Woodhaven
21-May,36081000600,4000600,8712,62341,71053,Queens,2307340.951,Woodhaven
19-Jun,36081000600,4000600,0,91706,91706,Queens,2307340.951,Woodhaven
21-Jun,36081000600,4000600,8074,6185,14259,Queens,2307340.951,Woodhaven
19-Jul,36081000600,4000600,12511,128221,140732,Queens,2307340.951,Woodhaven
21-Jul,36081000600,4000600,2077,124038,126115,Queens,2307340.951,Woodhaven
19-Aug,36081000600,4000600,4871,34770,39641,Queens,2307340.951,Woodhaven
21-Aug,36081000600,4000600,0,74116,74116,Queens,2307340.951,Woodhaven
19-May,36081000702,4000702,7461,111110,118571,Queens,3276086.416,Long Island City-Hunters Point
21-May,36081000702,4000702,0,80093,80093,Queens,3276086.416,Long Island City-Hunters Point
19-Jun,36081000702,4000702,3459,66940,70399,Queens,3276086.416,Long Island City-Hunters Point
21-Jun,36081000702,4000702,3412,52170,55582,Queens,3276086.416,Long Island City-Hunters Point
19-Jul,36081000702,4000702,6861,119360,126221,Queens,3276086.416,Long Island City-Hunters Point
21-Jul,36081000702,4000702,11002,133161,144163,Queens,3276086.416,Long Island City-Hunters Point
19-Aug,36081000702,4000702,4277,100393,104670,Queens,3276086.416,Long Island City-Hunters Point
21-Aug,36081000702,4000702,3478,78710,82188,Queens,3276086.416,Long Island City-Hunters Point
19-May,36081000800,4000800,3655,132856,136511,Queens,2043534.043,Woodhaven
21-May,36081000800,4000800,18380,141846,160226,Queens,2043534.043,Woodhaven
19-Jun,36081000800,4000800,15425,55724,71149,Queens,2043534.043,Woodhaven
21-Jun,36081000800,4000800,9137,83910,93047,Queens,2043534.043,Woodhaven
19-Jul,36081000800,4000800,5546,92882,98428,Queens,2043534.043,Woodhaven
21-Jul,36081000800,4000800,8583,84115,92698,Queens,2043534.043,Woodhaven
19-Aug,36081000800,4000800,10832,112068,122900,Queens,2043534.043,Woodhaven
21-Aug,36081000800,4000800,7103,42970,50073,Queens,2043534.043,Woodhaven
19-May,36081001000,4001000,6202,96207,102409,Queens,1743090.154,Woodhaven
21-May,36081001000,4001000,5773,96432,102205,Queens,1743090.154,Woodhaven
19-Jun,36081001000,4001000,9927,114569,124496,Queens,1743090.154,Woodhaven
21-Jun,36081001000,4001000,17342,24207,41549,Queens,1743090.154,Woodhaven
19-Jul,36081001000,4001000,7905,92254,100159,Queens,1743090.154,Woodhaven
21-Jul,36081001000,4001000,8540,71,8611,Queens,1743090.154,Woodhaven
19-Aug,36081001000,4001000,12357,69330,81687,Queens,1743090.154,Woodhaven
21-Aug,36081001000,4001000,5663,99757,105420,Queens,1743090.154,Woodhaven
19-May,36081001200,4001200,7780,28677,36457,Queens,2420973.941,Woodhaven
21-May,36081001200,4001200,7450,107333,114783,Queens,2420973.941,Woodhaven
19-Jun,36081001200,4001200,5702,145221,150923,Queens,2420973.941,Woodhaven
21-Jun,36081001200,4001200,8986,31139,40125,Queens,2420973.941,Woodhaven
19-Jul,36081001200,4001200,17090,41145,58235,Queens,2420973.941,Woodhaven
21-Jul,36081001200,4001200,10671,96092,106763,Queens,2420973.941,Woodhaven
19-Aug,36081001200,4001200,7077,103448,110525,Queens,2420973.941,Woodhaven
21-Aug,36081001200,4001200,7900,56300,64200,Queens,2420973.941,Woodhaven
19-May,36081001600,4001600,9512,77927,87439,Queens,1623632.859,Woodhaven
21-May,36081001600,4001600,0,98753,98753,Queens,1623632.859,Woodhaven
19-Jun,36081001600,4001600,8132,70197,78329,Queens,1623632.859,Woodhaven
21-Jun,36081001600,4001600,12842,50504,63346,Queens,1623632.859,Woodhaven
19-Jul,36081001600,4001600,6978,78320,85298,Queens,1623632.859,Woodhaven
21-Jul,36081001600,4001600,17460,74204,91664,Queens,1623632.859,Woodhaven
19-Aug,36081001600,4001600,8237,15149,23386,Queens,1623632.859,Woodhaven
21-Aug,36081001600,4001600,5520,92482,98002,Queens,1623632.859,Woodhaven
19-May,36081002400,4002400,0,40878,40878,Queens,1519335.343,Richmond Hill
21-May,36081002400,4002400,7476,111748,119224,Queens,1519335.343,Richmond Hill
19-Jun,36081002400,4002400,15784,123346,139130,Queens,1519335.343,Richmond Hill
21-Jun,36081002400,4002400,7259,71,7330,Queens,1519335.343,Richmond Hill
19-Jul,36081002400,4002400,17018,31188,48206,Queens,1519335.343,Richmond Hill
21-Jul,36081002400,4002400,20110,46034,66144,Queens,1519335.343,Richmond Hill
19-Aug,36081002400,4002400,12952,52948,65900,Queens,1519335.343,Richmond Hill
21-Aug,36081002400,4002400,5293,2414,7707,Queens,1519335.343,Richmond Hill
19-May,36081002600,4002600,2971,63038,66009,Queens,1593309.292,Richmond Hill
21-May,36081002600,4002600,11398,68599,79997,Queens,1593309.292,Richmond Hill
19-Jun,36081002600,4002600,4973,80777,85750,Queens,1593309.292,Richmond Hill
21-Jun,36081002600,4002600,19698,92598,112296,Queens,1593309.292,Richmond Hill
19-Jul,36081002600,4002600,5119,108425,113544,Queens,1593309.292,Richmond Hill
21-Jul,36081002600,4002600,5758,98650,104408,Queens,1593309.292,Richmond Hill
19-Aug,36081002600,4002600,6360,65711,72071,Queens,1593309.292,Richmond Hill
21-Aug,36081002600,4002600,13712,74793,88505,Queens,1593309.292,Richmond Hill
19-May,36081002800,4002800,18719,70383,89102,Queens,2422506.155,Richmond Hill
21-May,36081002800,4002800,10661,17010,27671,Queens,2422506.155,Richmond Hill
19-Jun,36081002800,4002800,8155,93560,101715,Queens,2422506.155,Richmond Hill
21-Jun,36081002800,4002800,2021,71,2092,Queens,2422506.155,Richmond Hill
19-Jul,36081002800,4002800,9274,64361,73635,Queens,2422506.155,Richmond Hill
21-Jul,36081002800,4002800,15206,48117,63323,Queens,2422506.155,Richmond Hill
19-Aug,36081002800,4002800,13029,83222,96251,Queens,2422506.155,Richmond Hill
21-Aug,36081002800,4002800,5587,106667,112254,Queens,2422506.155,Richmond Hill
19-May,36081003000,4003000,12456,72464,84920,Queens,1220952.715,Woodhaven
21-May,36081003000,4003000,14245,27409,41654,Queens,1220952.715,Woodhaven
19-Jun,36081003000,4003000,9271,100274,109545,Queens,1220952.715,Woodhaven
21-Jun,36081003000,4003000,12070,61355,73425,Queens,1220952.715,Woodhaven
19-Jul,36081003000,4003000,14055,109555,123610,Queens,1220952.715,Woodhaven
21-Jul,36081003000,4003000,13117,65632,78749,Queens,1220952.715,Woodhaven
19-Aug,36081003000,4003000,6412,71,6483,Queens,1220952.715,Woodhaven
21-Aug,36081003000,4003000,4977,108199,113176,Queens,1220952.715,Woodhaven
19-May,36081003100,4003100,12889,71813,84702,Queens,1775765.177,Queensbridge-Ravenswood-Dutch Kills
21-May,36081003100,4003100,2601,74108,76709,Queens,1775765.177,Queensbridge-Ravenswood-Dutch Kills
19-Jun,36081003100,4003100,18551,119290,137841,Queens,1775765.177,Queensbridge-Ravenswood-Dutch Kills
21-Jun,36081003100,4003100,0,30098,30098,Queens,1775765.177,Queensbridge-Ravenswood-Dutch Kills
19-Jul,36081003100,4003100,1234,80324,81558,Queens,1775765.177,Queensbridge-Ravenswood-Dutch Kills
21-Jul,36081003100,4003100,7399,59576,66975,Queens,1775765.177,Queensbridge-Ravenswood-Dutch Kills
19-Aug,36081003100,4003100,14258,40708,54966,Queens,1775765.177,Queensbridge-Ravenswood-Dutch Kills
21-Aug,36081003100,4003100,13126,60603,73729,Queens,1775765.177,Queensbridge-Ravenswood-Dutch Kills
19-May,36081003200,4003200,4882,122522,127404,Queens,1731989.349,Ozone Park (North)
21-May,36081003200,4003200,11005,42777,53782,Queens,1731989.349,Ozone Park (North)
19-Jun,36081003200,4003200,19966,76512,96478,Queens,1731989.349,Ozone Park (North)
21-Jun,36081003200,4003200,17189,43590,60779,Queens,1731989.349,Ozone Park (North)
19-Jul,36081003200,4003200,3236,60861,64097,Queens,1731989.349,Ozone Park (North)
21-Jul,36081003200,4003200,283,83601,83884,Queens,1731989.349,Ozone Park (North)
19-Aug,36081003200,4003200,0,79486,79486,Queens,1731989.349,Ozone Park (North)
21-Aug,36081003200,4003200,4433,92071,96504,Queens,1731989.349,Ozone Park (North)
19-May,36081003302,4003302,10344,71,10415,Queens,3527015.335,Queensbridge-Ravenswood-Dutch Kills
21-May,36081003302,4003302,10462,48348,58810,Queens,3527015.335,Queensbridge-Ravenswood-Dutch Kills
19-Jun,36081003302,4003302,15731,27122,42853,Queens,3527015.335,Queensbridge-Ravenswood-Dutch Kills
21-Jun,36081003302,4003302,4977,51546,56523,Queens,3527015.335,Queensbridge-Ravenswood-Dutch Kills
19-Jul,36081003302,4003302,1169,88910,90079,Queens,3527015.335,Queensbridge-Ravenswood-Dutch Kills
21-Jul,36081003302,4003302,7950,58034,65984,Queens,3527015.335,Queensbridge-Ravenswood-Dutch Kills
19-Aug,36081003302,4003302,11155,113120,124275,Queens,3527015.335,Queensbridge-Ravenswood-Dutch Kills
21-Aug,36081003302,4003302,2376,40780,43156,Queens,3527015.335,Queensbridge-Ravenswood-Dutch Kills
19-May,36081003800,4003800,10851,43387,54238,Queens,1896703.541,Ozone Park (North)
21-May,36081003800,4003800,3968,130784,134752,Queens,1896703.541,Ozone Park (North)
19-Jun,36081003800,4003800,14279,107374,121653,Queens,1896703.541,Ozone Park (North)
21-Jun,36081003800,4003800,8317,101837,110154,Queens,1896703.541,Ozone Park (North)
19-Jul,36081003800,4003800,10079,31276,41355,Queens,1896703.541,Ozone Park (North)
21-Jul,36081003800,4003800,1780,57969,59749,Queens,1896703.541,Ozone Park (North)
19-Aug,36081003800,4003800,8250,63749,71999,Queens,1896703.541,Ozone Park (North)
21-Aug,36081003800,4003800,0,56359,56359,Queens,1896703.541,Ozone Park (North)
19-May,36081004001,4004001,12054,70966,83020,Queens,1875952.917,Ozone Park (North)
21-May,36081004001,4004001,1823,81782,83605,Queens,1875952.917,Ozone Park (North)
19-Jun,36081004001,4004001,14529,71,14600,Queens,1875952.917,Ozone Park (North)
21-Jun,36081004001,4004001,3015,79570,82585,Queens,1875952.917,Ozone Park (North)
19-Jul,36081004001,4004001,2993,67000,69993,Queens,1875952.917,Ozone Park (North)
21-Jul,36081004001,4004001,15690,150347,166037,Queens,1875952.917,Ozone Park (North)
19-Aug,36081004001,4004001,10444,16829,27273,Queens,1875952.917,Ozone Park (North)
21-Aug,36081004001,4004001,9969,88917,98886,Queens,1875952.917,Ozone Park (North)
19-May,36081004002,4004002,11113,90684,101797,Queens,1396952.364,Ozone Park
21-May,36081004002,4004002,3457,135446,138903,Queens,1396952.364,Ozone Park
19-Jun,36081004002,4004002,8579,51163,59742,Queens,1396952.364,Ozone Park
21-Jun,36081004002,4004002,3885,151864,155749,Queens,1396952.364,Ozone Park
19-Jul,36081004002,4004002,10167,49178,59345,Queens,1396952.364,Ozone Park
21-Jul,36081004002,4004002,8664,77277,85941,Queens,1396952.364,Ozone Park
19-Aug,36081004002,4004002,10227,23768,33995,Queens,1396952.364,Ozone Park
21-Aug,36081004002,4004002,5118,14299,19417,Queens,1396952.364,Ozone Park
19-May,36081004200,4004200,1092,83659,84751,Queens,2156063.822,Ozone Park (North)
21-May,36081004200,4004200,10781,116972,127753,Queens,2156063.822,Ozone Park (North)
19-Jun,36081004200,4004200,12260,81916,94176,Queens,2156063.822,Ozone Park (North)
21-Jun,36081004200,4004200,10089,42574,52663,Queens,2156063.822,Ozone Park (North)
19-Jul,36081004200,4004200,10243,18638,28881,Queens,2156063.822,Ozone Park (North)
21-Jul,36081004200,4004200,10326,74616,84942,Queens,2156063.822,Ozone Park (North)
19-Aug,36081004200,4004200,7555,117277,124832,Queens,2156063.822,Ozone Park (North)
21-Aug,36081004200,4004200,10662,99434,110096,Queens,2156063.822,Ozone Park (North)
19-May,36081004300,4004300,8032,37230,45262,Queens,1841331.485,Queensbridge-Ravenswood-Dutch Kills
21-May,36081004300,4004300,9261,64123,73384,Queens,1841331.485,Queensbridge-Ravenswood-Dutch Kills
19-Jun,36081004300,4004300,8384,66201,74585,Queens,1841331.485,Queensbridge-Ravenswood-Dutch Kills
21-Jun,36081004300,4004300,14843,93048,107891,Queens,1841331.485,Queensbridge-Ravenswood-Dutch Kills
19-Jul,36081004300,4004300,10337,80630,90967,Queens,1841331.485,Queensbridge-Ravenswood-Dutch Kills
21-Jul,36081004300,4004300,0,17967,17967,Queens,1841331.485,Queensbridge-Ravenswood-Dutch Kills
19-Aug,36081004300,4004300,14313,108784,123097,Queens,1841331.485,Queensbridge-Ravenswood-Dutch Kills
21-Aug,36081004300,4004300,13530,121517,135047,Queens,1841331.485,Queensbridge-Ravenswood-Dutch Kills
19-May,36081004500,4004500,6299,95254,101553,Queens,2375492.229,Queensbridge-Ravenswood-Dutch Kills
21-May,36081004500,4004500,10278,81640,91918,Queens,2375492.229,Queensbridge-Ravenswood-Dutch Kills
19-Jun,36081004500,4004500,0,92020,92020,Queens,2375492.229,Queensbridge-Ravenswood-Dutch Kills
21-Jun,36081004500,4004500,8785,65781,74566,Queens,2375492.229,Queensbridge-Ravenswood-Dutch Kills
19-Jul,36081004500,4004500,5008,88078,93086,Queens,2375492.229,Queensbridge-Ravenswood-Dutch Kills
21-Jul,36081004500,4004500,19324,46615,65939,Queens,2375492.229,Queensbridge-Ravenswood-Dutch Kills
19-Aug,36081004500,4004500,8668,46238,54906,Queens,2375492.229,Queensbridge-Ravenswood-Dutch Kills
21-Aug,36081004500,4004500,1856,148833,150689,Queens,2375492.229,Queensbridge-Ravenswood-Dutch Kills
19-May,36081004700,4004700,24615,65177,89792,Queens,1928980.716,Queensbridge-Ravenswood-Dutch Kills
21-May,36081004700,4004700,18146,67956,86102,Queens,1928980.716,Queensbridge-Ravenswood-Dutch Kills
19-Jun,36081004700,4004700,5396,74269,79665,Queens,1928980.716,Queensbridge-Ravenswood-Dutch Kills
21-Jun,36081004700,4004700,2082,54186,56268,Queens,1928980.716,Queensbridge-Ravenswood-Dutch Kills
19-Jul,36081004700,4004700,6060,53023,59083,Queens,1928980.716,Queensbridge-Ravenswood-Dutch Kills
21-Jul,36081004700,4004700,6586,84772,91358,Queens,1928980.716,Queensbridge-Ravenswood-Dutch Kills
19-Aug,36081004700,4004700,1808,64094,65902,Queens,1928980.716,Queensbridge-Ravenswood-Dutch Kills
21-Aug,36081004700,4004700,4226,98890,103116,Queens,1928980.716,Queensbridge-Ravenswood-Dutch Kills
19-May,36081005000,4005000,2534,39328,41862,Queens,1637675.636,Ozone Park
21-May,36081005000,4005000,1296,73802,75098,Queens,1637675.636,Ozone Park
19-Jun,36081005000,4005000,11193,115885,127078,Queens,1637675.636,Ozone Park
21-Jun,36081005000,4005000,5701,128037,133738,Queens,1637675.636,Ozone Park
19-Jul,36081005000,4005000,8892,62575,71467,Queens,1637675.636,Ozone Park
21-Jul,36081005000,4005000,11072,66224,77296,Queens,1637675.636,Ozone Park
19-Aug,36081005000,4005000,8734,158429,167163,Queens,1637675.636,Ozone Park
21-Aug,36081005000,4005000,6854,98170,105024,Queens,1637675.636,Ozone Park
19-May,36081005100,4005100,3608,71,3679,Queens,1476104.395,Queensbridge-Ravenswood-Dutch Kills
21-May,36081005100,4005100,12161,76277,88438,Queens,1476104.395,Queensbridge-Ravenswood-Dutch Kills
19-Jun,36081005100,4005100,9483,74384,83867,Queens,1476104.395,Queensbridge-Ravenswood-Dutch Kills
21-Jun,36081005100,4005100,12459,108406,120865,Queens,1476104.395,Queensbridge-Ravenswood-Dutch Kills
19-Jul,36081005100,4005100,7001,12328,19329,Queens,1476104.395,Queensbridge-Ravenswood-Dutch Kills
21-Jul,36081005100,4005100,2300,54629,56929,Queens,1476104.395,Queensbridge-Ravenswood-Dutch Kills
19-Aug,36081005100,4005100,11549,78146,89695,Queens,1476104.395,Queensbridge-Ravenswood-Dutch Kills
21-Aug,36081005100,4005100,14995,8709,23704,Queens,1476104.395,Queensbridge-Ravenswood-Dutch Kills
19-May,36081005200,4005200,10690,53891,64581,Queens,1405250.23,Ozone Park (North)
21-May,36081005200,4005200,8831,132729,141560,Queens,1405250.23,Ozone Park (North)
19-Jun,36081005200,4005200,2521,96402,98923,Queens,1405250.23,Ozone Park (North)
21-Jun,36081005200,4005200,0,149473,149473,Queens,1405250.23,Ozone Park (North)
19-Jul,36081005200,4005200,10937,61173,72110,Queens,1405250.23,Ozone Park (North)
21-Jul,36081005200,4005200,8183,97841,106024,Queens,1405250.23,Ozone Park (North)
19-Aug,36081005200,4005200,11163,96542,107705,Queens,1405250.23,Ozone Park (North)
21-Aug,36081005200,4005200,12715,67606,80321,Queens,1405250.23,Ozone Park (North)
19-May,36081005300,4005300,12259,110751,123010,Queens,2111785.603,Astoria (Central)
21-May,36081005300,4005300,12734,119856,132590,Queens,2111785.603,Astoria (Central)
19-Jun,36081005300,4005300,325,145470,145795,Queens,2111785.603,Astoria (Central)
21-Jun,36081005300,4005300,7340,115428,122768,Queens,2111785.603,Astoria (Central)
19-Jul,36081005300,4005300,2770,102154,104924,Queens,2111785.603,Astoria (Central)
21-Jul,36081005300,4005300,11492,41852,53344,Queens,2111785.603,Astoria (Central)
19-Aug,36081005300,4005300,13015,77154,90169,Queens,2111785.603,Astoria (Central)
21-Aug,36081005300,4005300,16798,57098,73896,Queens,2111785.603,Astoria (Central)
19-May,36081005500,4005500,2221,58498,60719,Queens,1786238.077,Queensbridge-Ravenswood-Dutch Kills
21-May,36081005500,4005500,9949,128467,138416,Queens,1786238.077,Queensbridge-Ravenswood-Dutch Kills
19-Jun,36081005500,4005500,5137,109886,115023,Queens,1786238.077,Queensbridge-Ravenswood-Dutch Kills
21-Jun,36081005500,4005500,9128,74313,83441,Queens,1786238.077,Queensbridge-Ravenswood-Dutch Kills
19-Jul,36081005500,4005500,6017,52400,58417,Queens,1786238.077,Queensbridge-Ravenswood-Dutch Kills
21-Jul,36081005500,4005500,10602,71,10673,Queens,1786238.077,Queensbridge-Ravenswood-Dutch Kills
19-Aug,36081005500,4005500,6942,123432,130374,Queens,1786238.077,Queensbridge-Ravenswood-Dutch Kills
21-Aug,36081005500,4005500,7067,103567,110634,Queens,1786238.077,Queensbridge-Ravenswood-Dutch Kills
19-May,36081005700,4005700,10062,56598,66660,Queens,2406263.406,Astoria (Central)
21-May,36081005700,4005700,151,113957,114108,Queens,2406263.406,Astoria (Central)
19-Jun,36081005700,4005700,2907,96012,98919,Queens,2406263.406,Astoria (Central)
21-Jun,36081005700,4005700,6131,58133,64264,Queens,2406263.406,Astoria (Central)
19-Jul,36081005700,4005700,10199,27520,37719,Queens,2406263.406,Astoria (Central)
21-Jul,36081005700,4005700,1798,56709,58507,Queens,2406263.406,Astoria (Central)
19-Aug,36081005700,4005700,4512,30844,35356,Queens,2406263.406,Astoria (Central)
21-Aug,36081005700,4005700,16549,87548,104097,Queens,2406263.406,Astoria (Central)
19-May,36081006300,4006300,14046,118779,132825,Queens,2288295.473,Astoria (Central)
21-May,36081006300,4006300,6990,52326,59316,Queens,2288295.473,Astoria (Central)
19-Jun,36081006300,4006300,13751,102453,116204,Queens,2288295.473,Astoria (Central)
21-Jun,36081006300,4006300,14977,71,15048,Queens,2288295.473,Astoria (Central)
19-Jul,36081006300,4006300,7898,877,8775,Queens,2288295.473,Astoria (Central)
21-Jul,36081006300,4006300,0,71434,71434,Queens,2288295.473,Astoria (Central)
19-Aug,36081006300,4006300,0,103345,103345,Queens,2288295.473,Astoria (Central)
21-Aug,36081006300,4006300,13673,46444,60117,Queens,2288295.473,Astoria (Central)
19-May,36081006501,4006501,8059,105790,113849,Queens,1198418.208,Astoria (Central)
21-May,36081006501,4006501,2908,163566,166474,Queens,1198418.208,Astoria (Central)
19-Jun,36081006501,4006501,7826,82401,90227,Queens,1198418.208,Astoria (Central)
21-Jun,36081006501,4006501,0,95562,95562,Queens,1198418.208,Astoria (Central)
19-Jul,36081006501,4006501,5700,138747,144447,Queens,1198418.208,Astoria (Central)
21-Jul,36081006501,4006501,3200,118758,121958,Queens,1198418.208,Astoria (Central)
19-Aug,36081006501,4006501,12426,71,12497,Queens,1198418.208,Astoria (Central)
21-Aug,36081006501,4006501,4622,71,4693,Queens,1198418.208,Astoria (Central)
19-May,36081006502,4006502,4549,78881,83430,Queens,1650722.208,Astoria (Central)
21-May,36081006502,4006502,14682,63344,78026,Queens,1650722.208,Astoria (Central)
19-Jun,36081006502,4006502,8310,110594,118904,Queens,1650722.208,Astoria (Central)
21-Jun,36081006502,4006502,8351,113738,122089,Queens,1650722.208,Astoria (Central)
19-Jul,36081006502,4006502,13536,29998,43534,Queens,1650722.208,Astoria (Central)
21-Jul,36081006502,4006502,56,38445,38501,Queens,1650722.208,Astoria (Central)
19-Aug,36081006502,4006502,0,86066,86066,Queens,1650722.208,Astoria (Central)
21-Aug,36081006502,4006502,6897,167241,174138,Queens,1650722.208,Astoria (Central)
19-May,36081006900,4006900,16178,114745,130923,Queens,2266843.348,Astoria (Central)
21-May,36081006900,4006900,7748,31319,39067,Queens,2266843.348,Astoria (Central)
19-Jun,36081006900,4006900,6819,80644,87463,Queens,2266843.348,Astoria (Central)
21-Jun,36081006900,4006900,15046,149255,164301,Queens,2266843.348,Astoria (Central)
19-Jul,36081006900,4006900,14826,124989,139815,Queens,2266843.348,Astoria (Central)
21-Jul,36081006900,4006900,6197,53692,59889,Queens,2266843.348,Astoria (Central)
19-Aug,36081006900,4006900,6312,71,6383,Queens,2266843.348,Astoria (Central)
21-Aug,36081006900,4006900,5998,15154,21152,Queens,2266843.348,Astoria (Central)
19-May,36081007100,4007100,10560,74678,85238,Queens,2102179.879,Astoria (Central)
21-May,36081007100,4007100,7471,71,7542,Queens,2102179.879,Astoria (Central)
19-Jun,36081007100,4007100,11070,29931,41001,Queens,2102179.879,Astoria (Central)
21-Jun,36081007100,4007100,14230,71,14301,Queens,2102179.879,Astoria (Central)
19-Jul,36081007100,4007100,7955,71,8026,Queens,2102179.879,Astoria (Central)
21-Jul,36081007100,4007100,2663,12057,14720,Queens,2102179.879,Astoria (Central)
19-Aug,36081007100,4007100,5911,95435,101346,Queens,2102179.879,Astoria (Central)
21-Aug,36081007100,4007100,17637,71,17708,Queens,2102179.879,Astoria (Central)
19-May,36081007300,4007300,8784,128060,136844,Queens,1522290.215,Astoria (Central)
21-May,36081007300,4007300,0,127637,127637,Queens,1522290.215,Astoria (Central)
19-Jun,36081007300,4007300,7444,154193,161637,Queens,1522290.215,Astoria (Central)
21-Jun,36081007300,4007300,8347,92010,100357,Queens,1522290.215,Astoria (Central)
19-Jul,36081007300,4007300,11591,71,11662,Queens,1522290.215,Astoria (Central)
21-Jul,36081007300,4007300,10621,19092,29713,Queens,1522290.215,Astoria (Central)
19-Aug,36081007300,4007300,9011,109250,118261,Queens,1522290.215,Astoria (Central)
21-Aug,36081007300,4007300,10693,79269,89962,Queens,1522290.215,Astoria (Central)
19-May,36081007500,4007500,6805,66986,73791,Queens,1391240.155,Astoria (Central)
21-May,36081007500,4007500,11532,55333,66865,Queens,1391240.155,Astoria (Central)
19-Jun,36081007500,4007500,12831,91528,104359,Queens,1391240.155,Astoria (Central)
21-Jun,36081007500,4007500,12676,37198,49874,Queens,1391240.155,Astoria (Central)
19-Jul,36081007500,4007500,4041,139287,143328,Queens,1391240.155,Astoria (Central)
21-Jul,36081007500,4007500,7436,88774,96210,Queens,1391240.155,Astoria (Central)
19-Aug,36081007500,4007500,9816,80887,90703,Queens,1391240.155,Astoria (Central)
21-Aug,36081007500,4007500,2436,111210,113646,Queens,1391240.155,Astoria (Central)
19-May,36081007700,4007700,9704,23997,33701,Queens,1363202.224,Old Astoria-Hallets Point
21-May,36081007700,4007700,885,97738,98623,Queens,1363202.224,Old Astoria-Hallets Point
19-Jun,36081007700,4007700,8429,35574,44003,Queens,1363202.224,Old Astoria-Hallets Point
21-Jun,36081007700,4007700,19029,80210,99239,Queens,1363202.224,Old Astoria-Hallets Point
19-Jul,36081007700,4007700,6367,76109,82476,Queens,1363202.224,Old Astoria-Hallets Point
21-Jul,36081007700,4007700,4604,48055,52659,Queens,1363202.224,Old Astoria-Hallets Point
19-Aug,36081007700,4007700,3040,81379,84419,Queens,1363202.224,Old Astoria-Hallets Point
21-Aug,36081007700,4007700,938,69683,70621,Queens,1363202.224,Old Astoria-Hallets Point
19-May,36081007900,4007900,8004,18089,26093,Queens,1727510.954,Old Astoria-Hallets Point
21-May,36081007900,4007900,4342,49296,53638,Queens,1727510.954,Old Astoria-Hallets Point
19-Jun,36081007900,4007900,9186,114577,123763,Queens,1727510.954,Old Astoria-Hallets Point
21-Jun,36081007900,4007900,16639,76653,93292,Queens,1727510.954,Old Astoria-Hallets Point
19-Jul,36081007900,4007900,13564,104210,117774,Queens,1727510.954,Old Astoria-Hallets Point
21-Jul,36081007900,4007900,6356,142083,148439,Queens,1727510.954,Old Astoria-Hallets Point
19-Aug,36081007900,4007900,10145,49830,59975,Queens,1727510.954,Old Astoria-Hallets Point
21-Aug,36081007900,4007900,6873,38617,45490,Queens,1727510.954,Old Astoria-Hallets Point
19-May,36081008300,4008300,10746,36224,46970,Queens,2059577.356,Old Astoria-Hallets Point
21-May,36081008300,4008300,6829,38845,45674,Queens,2059577.356,Old Astoria-Hallets Point
19-Jun,36081008300,4008300,8060,69076,77136,Queens,2059577.356,Old Astoria-Hallets Point
21-Jun,36081008300,4008300,10273,163489,173762,Queens,2059577.356,Old Astoria-Hallets Point
19-Jul,36081008300,4008300,5355,77274,82629,Queens,2059577.356,Old Astoria-Hallets Point
21-Jul,36081008300,4008300,3616,145077,148693,Queens,2059577.356,Old Astoria-Hallets Point
19-Aug,36081008300,4008300,3726,86987,90713,Queens,2059577.356,Old Astoria-Hallets Point
21-Aug,36081008300,4008300,6494,119422,125916,Queens,2059577.356,Old Astoria-Hallets Point
19-May,36081008500,4008500,7374,124278,131652,Queens,2942541.845,Queensbridge-Ravenswood-Dutch Kills
21-May,36081008500,4008500,19668,133276,152944,Queens,2942541.845,Queensbridge-Ravenswood-Dutch Kills
19-Jun,36081008500,4008500,7210,95922,103132,Queens,2942541.845,Queensbridge-Ravenswood-Dutch Kills
21-Jun,36081008500,4008500,319,72548,72867,Queens,2942541.845,Queensbridge-Ravenswood-Dutch Kills
19-Jul,36081008500,4008500,14428,7216,21644,Queens,2942541.845,Queensbridge-Ravenswood-Dutch Kills
21-Jul,36081008500,4008500,11477,65581,77058,Queens,2942541.845,Queensbridge-Ravenswood-Dutch Kills
19-Aug,36081008500,4008500,12448,159183,171631,Queens,2942541.845,Queensbridge-Ravenswood-Dutch Kills
21-Aug,36081008500,4008500,9519,71,9590,Queens,2942541.845,Queensbridge-Ravenswood-Dutch Kills
19-May,36081009400,4009400,9075,97651,106726,Queens,1869642.079,South Ozone Park
21-May,36081009400,4009400,7176,58309,65485,Queens,1869642.079,South Ozone Park
19-Jun,36081009400,4009400,5049,67401,72450,Queens,1869642.079,South Ozone Park
21-Jun,36081009400,4009400,1031,79325,80356,Queens,1869642.079,South Ozone Park
19-Jul,36081009400,4009400,11755,53093,64848,Queens,1869642.079,South Ozone Park
21-Jul,36081009400,4009400,6721,84842,91563,Queens,1869642.079,South Ozone Park
19-Aug,36081009400,4009400,11133,27378,38511,Queens,1869642.079,South Ozone Park
21-Aug,36081009400,4009400,8504,58618,67122,Queens,1869642.079,South Ozone Park
19-May,36081009500,4009500,7033,77441,84474,Queens,1770676.829,Astoria (North)-Ditmars-Steinway
21-May,36081009500,4009500,11338,50599,61937,Queens,1770676.829,Astoria (North)-Ditmars-Steinway
19-Jun,36081009500,4009500,3535,84088,87623,Queens,1770676.829,Astoria (North)-Ditmars-Steinway
21-Jun,36081009500,4009500,4136,90424,94560,Queens,1770676.829,Astoria (North)-Ditmars-Steinway
19-Jul,36081009500,4009500,10911,79955,90866,Queens,1770676.829,Astoria (North)-Ditmars-Steinway
21-Jul,36081009500,4009500,15622,49427,65049,Queens,1770676.829,Astoria (North)-Ditmars-Steinway
19-Aug,36081009500,4009500,11824,101963,113787,Queens,1770676.829,Astoria (North)-Ditmars-Steinway
21-Aug,36081009500,4009500,3800,76273,80073,Queens,1770676.829,Astoria (North)-Ditmars-Steinway
19-May,36081009600,4009600,8673,57502,66175,Queens,2222233.91,South Ozone Park
21-May,36081009600,4009600,0,84281,84281,Queens,2222233.91,South Ozone Park
19-Jun,36081009600,4009600,112,145419,145531,Queens,2222233.91,South Ozone Park
21-Jun,36081009600,4009600,13056,9914,22970,Queens,2222233.91,South Ozone Park
19-Jul,36081009600,4009600,5510,48921,54431,Queens,2222233.91,South Ozone Park
21-Jul,36081009600,4009600,14273,132260,146533,Queens,2222233.91,South Ozone Park
19-Aug,36081009600,4009600,10108,138795,148903,Queens,2222233.91,South Ozone Park
21-Aug,36081009600,4009600,3943,72210,76153,Queens,2222233.91,South Ozone Park
19-May,36081009700,4009700,14158,105464,119622,Queens,2171669.758,Astoria (North)-Ditmars-Steinway
21-May,36081009700,4009700,10347,70409,80756,Queens,2171669.758,Astoria (North)-Ditmars-Steinway
19-Jun,36081009700,4009700,8977,67465,76442,Queens,2171669.758,Astoria (North)-Ditmars-Steinway
21-Jun,36081009700,4009700,0,99249,99249,Queens,2171669.758,Astoria (North)-Ditmars-Steinway
19-Jul,36081009700,4009700,4751,34367,39118,Queens,2171669.758,Astoria (North)-Ditmars-Steinway
21-Jul,36081009700,4009700,9600,444,10044,Queens,2171669.758,Astoria (North)-Ditmars-Steinway
19-Aug,36081009700,4009700,14332,79887,94219,Queens,2171669.758,Astoria (North)-Ditmars-Steinway
21-Aug,36081009700,4009700,8483,55926,64409,Queens,2171669.758,Astoria (North)-Ditmars-Steinway
19-May,36081009800,4009800,21,47711,47732,Queens,1460890.811,South Ozone Park
21-May,36081009800,4009800,11668,85091,96759,Queens,1460890.811,South Ozone Park
19-Jun,36081009800,4009800,12855,133707,146562,Queens,1460890.811,South Ozone Park
21-Jun,36081009800,4009800,11439,53919,65358,Queens,1460890.811,South Ozone Park
19-Jul,36081009800,4009800,12341,59203,71544,Queens,1460890.811,South Ozone Park
21-Jul,36081009800,4009800,14580,97858,112438,Queens,1460890.811,South Ozone Park
19-Aug,36081009800,4009800,6672,75586,82258,Queens,1460890.811,South Ozone Park
21-Aug,36081009800,4009800,2562,65450,68012,Queens,1460890.811,South Ozone Park
19-May,36081010000,4010000,3847,49968,53815,Queens,2403901.655,South Ozone Park
21-May,36081010000,4010000,16879,32988,49867,Queens,2403901.655,South Ozone Park
19-Jun,36081010000,4010000,4049,78323,82372,Queens,2403901.655,South Ozone Park
21-Jun,36081010000,4010000,5956,88705,94661,Queens,2403901.655,South Ozone Park
19-Jul,36081010000,4010000,3514,53975,57489,Queens,2403901.655,South Ozone Park
21-Jul,36081010000,4010000,10965,119785,130750,Queens,2403901.655,South Ozone Park
19-Aug,36081010000,4010000,5211,78718,83929,Queens,2403901.655,South Ozone Park
21-Aug,36081010000,4010000,10215,108525,118740,Queens,2403901.655,South Ozone Park
19-May,36081010100,4010100,13007,101680,114687,Queens,1860062.557,Astoria (North)-Ditmars-Steinway
21-May,36081010100,4010100,10462,78145,88607,Queens,1860062.557,Astoria (North)-Ditmars-Steinway
19-Jun,36081010100,4010100,15229,80487,95716,Queens,1860062.557,Astoria (North)-Ditmars-Steinway
21-Jun,36081010100,4010100,12801,69208,82009,Queens,1860062.557,Astoria (North)-Ditmars-Steinway
19-Jul,36081010100,4010100,7251,86697,93948,Queens,1860062.557,Astoria (North)-Ditmars-Steinway
21-Jul,36081010100,4010100,13651,40574,54225,Queens,1860062.557,Astoria (North)-Ditmars-Steinway
19-Aug,36081010100,4010100,6810,57239,64049,Queens,1860062.557,Astoria (North)-Ditmars-Steinway
21-Aug,36081010100,4010100,3065,21133,24198,Queens,1860062.557,Astoria (North)-Ditmars-Steinway
19-May,36081010200,4010200,8161,38207,46368,Queens,2302072.583,South Ozone Park
21-May,36081010200,4010200,8349,40822,49171,Queens,2302072.583,South Ozone Park
19-Jun,36081010200,4010200,0,62475,62475,Queens,2302072.583,South Ozone Park
21-Jun,36081010200,4010200,11120,71763,82883,Queens,2302072.583,South Ozone Park
19-Jul,36081010200,4010200,5075,129387,134462,Queens,2302072.583,South Ozone Park
21-Jul,36081010200,4010200,12735,29735,42470,Queens,2302072.583,South Ozone Park
19-Aug,36081010200,4010200,1750,83762,85512,Queens,2302072.583,South Ozone Park
21-Aug,36081010200,4010200,12145,57114,69259,Queens,2302072.583,South Ozone Park
19-May,36081010300,4010300,1385,83648,85033,Queens,2695889.599,Astoria (North)-Ditmars-Steinway
21-May,36081010300,4010300,14382,42669,57051,Queens,2695889.599,Astoria (North)-Ditmars-Steinway
19-Jun,36081010300,4010300,0,84267,84267,Queens,2695889.599,Astoria (North)-Ditmars-Steinway
21-Jun,36081010300,4010300,4886,118232,123118,Queens,2695889.599,Astoria (North)-Ditmars-Steinway
19-Jul,36081010300,4010300,6037,11551,17588,Queens,2695889.599,Astoria (North)-Ditmars-Steinway
21-Jul,36081010300,4010300,7060,15147,22207,Queens,2695889.599,Astoria (North)-Ditmars-Steinway
19-Aug,36081010300,4010300,5040,75031,80071,Queens,2695889.599,Astoria (North)-Ditmars-Steinway
21-Aug,36081010300,4010300,7234,8700,15934,Queens,2695889.599,Astoria (North)-Ditmars-Steinway
19-May,36081010400,4010400,11129,15346,26475,Queens,2007367.917,South Ozone Park
21-May,36081010400,4010400,2385,6895,9280,Queens,2007367.917,South Ozone Park
19-Jun,36081010400,4010400,10109,47046,57155,Queens,2007367.917,South Ozone Park
21-Jun,36081010400,4010400,1326,120095,121421,Queens,2007367.917,South Ozone Park
19-Jul,36081010400,4010400,6415,121580,127995,Queens,2007367.917,South Ozone Park
21-Jul,36081010400,4010400,5355,73760,79115,Queens,2007367.917,South Ozone Park
19-Aug,36081010400,4010400,7827,117076,124903,Queens,2007367.917,South Ozone Park
21-Aug,36081010400,4010400,0,35793,35793,Queens,2007367.917,South Ozone Park
19-May,36081010500,4010500,7069,95897,102966,Queens,2131456.337,Astoria (North)-Ditmars-Steinway
21-May,36081010500,4010500,12809,76793,89602,Queens,2131456.337,Astoria (North)-Ditmars-Steinway
19-Jun,36081010500,4010500,6372,135207,141579,Queens,2131456.337,Astoria (North)-Ditmars-Steinway
21-Jun,36081010500,4010500,0,39043,39043,Queens,2131456.337,Astoria (North)-Ditmars-Steinway
19-Jul,36081010500,4010500,7062,106255,113317,Queens,2131456.337,Astoria (North)-Ditmars-Steinway
21-Jul,36081010500,4010500,8206,70371,78577,Queens,2131456.337,Astoria (North)-Ditmars-Steinway
19-Aug,36081010500,4010500,11354,6141,17495,Queens,2131456.337,Astoria (North)-Ditmars-Steinway
21-Aug,36081010500,4010500,2835,93879,96714,Queens,2131456.337,Astoria (North)-Ditmars-Steinway
19-May,36081010800,4010800,9605,29756,39361,Queens,1696627.403,South Richmond Hill
21-May,36081010800,4010800,19655,70366,90021,Queens,1696627.403,South Richmond Hill
19-Jun,36081010800,4010800,5549,72631,78180,Queens,1696627.403,South Richmond Hill
21-Jun,36081010800,4010800,1237,71,1308,Queens,1696627.403,South Richmond Hill
19-Jul,36081010800,4010800,1001,117549,118550,Queens,1696627.403,South Richmond Hill
21-Jul,36081010800,4010800,8017,112185,120202,Queens,1696627.403,South Richmond Hill
19-Aug,36081010800,4010800,9007,106104,115111,Queens,1696627.403,South Richmond Hill
21-Aug,36081010800,4010800,4656,77585,82241,Queens,1696627.403,South Richmond Hill
19-May,36081011000,4011000,12605,65377,77982,Queens,1776467.639,South Richmond Hill
21-May,36081011000,4011000,3604,86764,90368,Queens,1776467.639,South Richmond Hill
19-Jun,36081011000,4011000,5405,98924,104329,Queens,1776467.639,South Richmond Hill
21-Jun,36081011000,4011000,13742,83427,97169,Queens,1776467.639,South Richmond Hill
19-Jul,36081011000,4011000,4611,3740,8351,Queens,1776467.639,South Richmond Hill
21-Jul,36081011000,4011000,10029,83298,93327,Queens,1776467.639,South Richmond Hill
19-Aug,36081011000,4011000,15715,50752,66467,Queens,1776467.639,South Richmond Hill
21-Aug,36081011000,4011000,2823,22335,25158,Queens,1776467.639,South Richmond Hill
19-May,36081011100,4011100,0,110890,110890,Queens,1622555.677,Astoria (North)-Ditmars-Steinway
21-May,36081011100,4011100,13257,85135,98392,Queens,1622555.677,Astoria (North)-Ditmars-Steinway
19-Jun,36081011100,4011100,7844,28727,36571,Queens,1622555.677,Astoria (North)-Ditmars-Steinway
21-Jun,36081011100,4011100,7021,26887,33908,Queens,1622555.677,Astoria (North)-Ditmars-Steinway
19-Jul,36081011100,4011100,3740,69692,73432,Queens,1622555.677,Astoria (North)-Ditmars-Steinway
21-Jul,36081011100,4011100,15658,96562,112220,Queens,1622555.677,Astoria (North)-Ditmars-Steinway
19-Aug,36081011100,4011100,7630,75239,82869,Queens,1622555.677,Astoria (North)-Ditmars-Steinway
21-Aug,36081011100,4011100,5191,110679,115870,Queens,1622555.677,Astoria (North)-Ditmars-Steinway
19-May,36081011200,4011200,10850,127844,138694,Queens,2029245.371,Ozone Park (North)
21-May,36081011200,4011200,5569,62653,68222,Queens,2029245.371,Ozone Park (North)
19-Jun,36081011200,4011200,11629,71,11700,Queens,2029245.371,Ozone Park (North)
21-Jun,36081011200,4011200,6435,28102,34537,Queens,2029245.371,Ozone Park (North)
19-Jul,36081011200,4011200,1549,91552,93101,Queens,2029245.371,Ozone Park (North)
21-Jul,36081011200,4011200,14042,50857,64899,Queens,2029245.371,Ozone Park (North)
19-Aug,36081011200,4011200,14291,12747,27038,Queens,2029245.371,Ozone Park (North)
21-Aug,36081011200,4011200,13798,71,13869,Queens,2029245.371,Ozone Park (North)
19-May,36081011300,4011300,8230,69159,77389,Queens,1922996.075,Astoria (North)-Ditmars-Steinway
21-May,36081011300,4011300,6028,90375,96403,Queens,1922996.075,Astoria (North)-Ditmars-Steinway
19-Jun,36081011300,4011300,3450,176584,180034,Queens,1922996.075,Astoria (North)-Ditmars-Steinway
21-Jun,36081011300,4011300,10068,78091,88159,Queens,1922996.075,Astoria (North)-Ditmars-Steinway
19-Jul,36081011300,4011300,4700,103991,108691,Queens,1922996.075,Astoria (North)-Ditmars-Steinway
21-Jul,36081011300,4011300,24804,77493,102297,Queens,1922996.075,Astoria (North)-Ditmars-Steinway
19-Aug,36081011300,4011300,9842,72408,82250,Queens,1922996.075,Astoria (North)-Ditmars-Steinway
21-Aug,36081011300,4011300,18377,39702,58079,Queens,1922996.075,Astoria (North)-Ditmars-Steinway
19-May,36081011400,4011400,4494,118649,123143,Queens,1280315.332,Ozone Park (North)
21-May,36081011400,4011400,17310,71212,88522,Queens,1280315.332,Ozone Park (North)
19-Jun,36081011400,4011400,15480,53248,68728,Queens,1280315.332,Ozone Park (North)
21-Jun,36081011400,4011400,20977,90407,111384,Queens,1280315.332,Ozone Park (North)
19-Jul,36081011400,4011400,1259,60560,61819,Queens,1280315.332,Ozone Park (North)
21-Jul,36081011400,4011400,11945,68278,80223,Queens,1280315.332,Ozone Park (North)
19-Aug,36081011400,4011400,6137,72496,78633,Queens,1280315.332,Ozone Park (North)
21-Aug,36081011400,4011400,4294,4114,8408,Queens,1280315.332,Ozone Park (North)
19-May,36081011500,4011500,12972,90573,103545,Queens,1997218.907,Astoria (North)-Ditmars-Steinway
21-May,36081011500,4011500,9472,68094,77566,Queens,1997218.907,Astoria (North)-Ditmars-Steinway
19-Jun,36081011500,4011500,5776,118922,124698,Queens,1997218.907,Astoria (North)-Ditmars-Steinway
21-Jun,36081011500,4011500,16568,71,16639,Queens,1997218.907,Astoria (North)-Ditmars-Steinway
19-Jul,36081011500,4011500,6431,90943,97374,Queens,1997218.907,Astoria (North)-Ditmars-Steinway
21-Jul,36081011500,4011500,4214,128217,132431,Queens,1997218.907,Astoria (North)-Ditmars-Steinway
19-Aug,36081011500,4011500,15090,33060,48150,Queens,1997218.907,Astoria (North)-Ditmars-Steinway
21-Aug,36081011500,4011500,10776,88091,98867,Queens,1997218.907,Astoria (North)-Ditmars-Steinway
19-May,36081011600,4011600,11696,57823,69519,Queens,1471248.552,Ozone Park (North)
21-May,36081011600,4011600,12959,110453,123412,Queens,1471248.552,Ozone Park (North)
19-Jun,36081011600,4011600,10777,38384,49161,Queens,1471248.552,Ozone Park (North)
21-Jun,36081011600,4011600,5627,35073,40700,Queens,1471248.552,Ozone Park (North)
19-Jul,36081011600,4011600,16579,60715,77294,Queens,1471248.552,Ozone Park (North)
21-Jul,36081011600,4011600,10680,91740,102420,Queens,1471248.552,Ozone Park (North)
19-Aug,36081011600,4011600,10130,71,10201,Queens,1471248.552,Ozone Park (North)
21-Aug,36081011600,4011600,8035,32751,40786,Queens,1471248.552,Ozone Park (North)
19-May,36081011700,4011700,9517,93441,102958,Queens,2290673.096,Astoria (North)-Ditmars-Steinway
21-May,36081011700,4011700,1204,15395,16599,Queens,2290673.096,Astoria (North)-Ditmars-Steinway
19-Jun,36081011700,4011700,7822,51167,58989,Queens,2290673.096,Astoria (North)-Ditmars-Steinway
21-Jun,36081011700,4011700,12070,72525,84595,Queens,2290673.096,Astoria (North)-Ditmars-Steinway
19-Jul,36081011700,4011700,9784,114550,124334,Queens,2290673.096,Astoria (North)-Ditmars-Steinway
21-Jul,36081011700,4011700,7665,93663,101328,Queens,2290673.096,Astoria (North)-Ditmars-Steinway
19-Aug,36081011700,4011700,16596,106561,123157,Queens,2290673.096,Astoria (North)-Ditmars-Steinway
21-Aug,36081011700,4011700,13662,13167,26829,Queens,2290673.096,Astoria (North)-Ditmars-Steinway
19-May,36081011800,4011800,5168,71076,76244,Queens,1681621.451,South Richmond Hill
21-May,36081011800,4011800,7163,95490,102653,Queens,1681621.451,South Richmond Hill
19-Jun,36081011800,4011800,4407,125863,130270,Queens,1681621.451,South Richmond Hill
21-Jun,36081011800,4011800,7744,46422,54166,Queens,1681621.451,South Richmond Hill
19-Jul,36081011800,4011800,7801,117493,125294,Queens,1681621.451,South Richmond Hill
21-Jul,36081011800,4011800,16185,63082,79267,Queens,1681621.451,South Richmond Hill
19-Aug,36081011800,4011800,5635,78820,84455,Queens,1681621.451,South Richmond Hill
21-Aug,36081011800,4011800,19317,37731,57048,Queens,1681621.451,South Richmond Hill
19-May,36081011900,4011900,8656,84207,92863,Queens,1199794.973,Astoria (North)-Ditmars-Steinway
21-May,36081011900,4011900,10344,18872,29216,Queens,1199794.973,Astoria (North)-Ditmars-Steinway
19-Jun,36081011900,4011900,8832,64943,73775,Queens,1199794.973,Astoria (North)-Ditmars-Steinway
21-Jun,36081011900,4011900,0,122411,122411,Queens,1199794.973,Astoria (North)-Ditmars-Steinway
19-Jul,36081011900,4011900,8560,120269,128829,Queens,1199794.973,Astoria (North)-Ditmars-Steinway
21-Jul,36081011900,4011900,16668,57743,74411,Queens,1199794.973,Astoria (North)-Ditmars-Steinway
19-Aug,36081011900,4011900,11481,70955,82436,Queens,1199794.973,Astoria (North)-Ditmars-Steinway
21-Aug,36081011900,4011900,0,36763,36763,Queens,1199794.973,Astoria (North)-Ditmars-Steinway
19-May,36081012000,4012000,10926,80912,91838,Queens,1553008.399,South Richmond Hill
21-May,36081012000,4012000,8438,92808,101246,Queens,1553008.399,South Richmond Hill
19-Jun,36081012000,4012000,15961,48332,64293,Queens,1553008.399,South Richmond Hill
21-Jun,36081012000,4012000,5856,111793,117649,Queens,1553008.399,South Richmond Hill
19-Jul,36081012000,4012000,16330,89322,105652,Queens,1553008.399,South Richmond Hill
21-Jul,36081012000,4012000,1453,79634,81087,Queens,1553008.399,South Richmond Hill
19-Aug,36081012000,4012000,0,71,71,Queens,1553008.399,South Richmond Hill
21-Aug,36081012000,4012000,6550,71,6621,Queens,1553008.399,South Richmond Hill
19-May,36081012100,4012100,5865,83672,89537,Queens,1484400.481,Astoria (North)-Ditmars-Steinway
21-May,36081012100,4012100,8565,119815,128380,Queens,1484400.481,Astoria (North)-Ditmars-Steinway
19-Jun,36081012100,4012100,6608,8250,14858,Queens,1484400.481,Astoria (North)-Ditmars-Steinway
21-Jun,36081012100,4012100,4759,102001,106760,Queens,1484400.481,Astoria (North)-Ditmars-Steinway
19-Jul,36081012100,4012100,14261,44918,59179,Queens,1484400.481,Astoria (North)-Ditmars-Steinway
21-Jul,36081012100,4012100,1896,55921,57817,Queens,1484400.481,Astoria (North)-Ditmars-Steinway
19-Aug,36081012100,4012100,6377,142187,148564,Queens,1484400.481,Astoria (North)-Ditmars-Steinway
21-Aug,36081012100,4012100,15164,39038,54202,Queens,1484400.481,Astoria (North)-Ditmars-Steinway
19-May,36081012200,4012200,0,121006,121006,Queens,2262780.108,Richmond Hill
21-May,36081012200,4012200,9251,102436,111687,Queens,2262780.108,Richmond Hill
19-Jun,36081012200,4012200,6108,81303,87411,Queens,2262780.108,Richmond Hill
21-Jun,36081012200,4012200,14435,138513,152948,Queens,2262780.108,Richmond Hill
19-Jul,36081012200,4012200,3714,139496,143210,Queens,2262780.108,Richmond Hill
21-Jul,36081012200,4012200,16612,77699,94311,Queens,2262780.108,Richmond Hill
19-Aug,36081012200,4012200,8302,71,8373,Queens,2262780.108,Richmond Hill
21-Aug,36081012200,4012200,16362,40952,57314,Queens,2262780.108,Richmond Hill
19-May,36081012400,4012400,5754,109378,115132,Queens,2134135.609,Richmond Hill
21-May,36081012400,4012400,16647,11537,28184,Queens,2134135.609,Richmond Hill
19-Jun,36081012400,4012400,9732,19127,28859,Queens,2134135.609,Richmond Hill
21-Jun,36081012400,4012400,16053,60930,76983,Queens,2134135.609,Richmond Hill
19-Jul,36081012400,4012400,8010,139242,147252,Queens,2134135.609,Richmond Hill
21-Jul,36081012400,4012400,0,42064,42064,Queens,2134135.609,Richmond Hill
19-Aug,36081012400,4012400,3017,117506,120523,Queens,2134135.609,Richmond Hill
21-Aug,36081012400,4012400,10008,137323,147331,Queens,2134135.609,Richmond Hill
19-May,36081012601,4012601,7200,96745,103945,Queens,1618300.192,Richmond Hill
21-May,36081012601,4012601,11715,54549,66264,Queens,1618300.192,Richmond Hill
19-Jun,36081012601,4012601,0,80152,80152,Queens,1618300.192,Richmond Hill
21-Jun,36081012601,4012601,12613,84713,97326,Queens,1618300.192,Richmond Hill
19-Jul,36081012601,4012601,9624,153226,162850,Queens,1618300.192,Richmond Hill
21-Jul,36081012601,4012601,6877,17292,24169,Queens,1618300.192,Richmond Hill
19-Aug,36081012601,4012601,9237,86406,95643,Queens,1618300.192,Richmond Hill
21-Aug,36081012601,4012601,8065,96220,104285,Queens,1618300.192,Richmond Hill
19-May,36081012602,4012602,7367,114140,121507,Queens,1605869.879,Richmond Hill
21-May,36081012602,4012602,0,46645,46645,Queens,1605869.879,Richmond Hill
19-Jun,36081012602,4012602,11186,76335,87521,Queens,1605869.879,Richmond Hill
21-Jun,36081012602,4012602,14174,57783,71957,Queens,1605869.879,Richmond Hill
19-Jul,36081012602,4012602,6037,111517,117554,Queens,1605869.879,Richmond Hill
21-Jul,36081012602,4012602,4266,83200,87466,Queens,1605869.879,Richmond Hill
19-Aug,36081012602,4012602,8278,64536,72814,Queens,1605869.879,Richmond Hill
21-Aug,36081012602,4012602,0,77062,77062,Queens,1605869.879,Richmond Hill
19-May,36081012800,4012800,1100,8307,9407,Queens,1721777.169,Richmond Hill
21-May,36081012800,4012800,9541,24493,34034,Queens,1721777.169,Richmond Hill
19-Jun,36081012800,4012800,13923,94504,108427,Queens,1721777.169,Richmond Hill
21-Jun,36081012800,4012800,9598,69944,79542,Queens,1721777.169,Richmond Hill
19-Jul,36081012800,4012800,8371,92414,100785,Queens,1721777.169,Richmond Hill
21-Jul,36081012800,4012800,11371,105072,116443,Queens,1721777.169,Richmond Hill
19-Aug,36081012800,4012800,11049,84667,95716,Queens,1721777.169,Richmond Hill
21-Aug,36081012800,4012800,5287,87348,92635,Queens,1721777.169,Richmond Hill
19-May,36081013200,4013200,5345,47838,53183,Queens,2070923.97,Richmond Hill
21-May,36081013200,4013200,17892,43498,61390,Queens,2070923.97,Richmond Hill
19-Jun,36081013200,4013200,386,71,457,Queens,2070923.97,Richmond Hill
21-Jun,36081013200,4013200,11538,115014,126552,Queens,2070923.97,Richmond Hill
19-Jul,36081013200,4013200,4528,169482,174010,Queens,2070923.97,Richmond Hill
21-Jul,36081013200,4013200,13805,66691,80496,Queens,2070923.97,Richmond Hill
19-Aug,36081013200,4013200,17844,96565,114409,Queens,2070923.97,Richmond Hill
21-Aug,36081013200,4013200,20363,35007,55370,Queens,2070923.97,Richmond Hill
19-May,36081013400,4013400,11566,122045,133611,Queens,2055584.026,Kew Gardens
21-May,36081013400,4013400,8366,103131,111497,Queens,2055584.026,Kew Gardens
19-Jun,36081013400,4013400,10161,49677,59838,Queens,2055584.026,Kew Gardens
21-Jun,36081013400,4013400,11913,71,11984,Queens,2055584.026,Kew Gardens
19-Jul,36081013400,4013400,11251,23473,34724,Queens,2055584.026,Kew Gardens
21-Jul,36081013400,4013400,9160,8234,17394,Queens,2055584.026,Kew Gardens
19-Aug,36081013400,4013400,4661,17989,22650,Queens,2055584.026,Kew Gardens
21-Aug,36081013400,4013400,10986,17663,28649,Queens,2055584.026,Kew Gardens
19-May,36081013500,4013500,12680,68237,80917,Queens,1461831.697,Astoria (North)-Ditmars-Steinway
21-May,36081013500,4013500,8900,127959,136859,Queens,1461831.697,Astoria (North)-Ditmars-Steinway
19-Jun,36081013500,4013500,16246,159109,175355,Queens,1461831.697,Astoria (North)-Ditmars-Steinway
21-Jun,36081013500,4013500,7912,84760,92672,Queens,1461831.697,Astoria (North)-Ditmars-Steinway
19-Jul,36081013500,4013500,2646,76970,79616,Queens,1461831.697,Astoria (North)-Ditmars-Steinway
21-Jul,36081013500,4013500,7566,54154,61720,Queens,1461831.697,Astoria (North)-Ditmars-Steinway
19-Aug,36081013500,4013500,5866,103103,108969,Queens,1461831.697,Astoria (North)-Ditmars-Steinway
21-Aug,36081013500,4013500,12458,88448,100906,Queens,1461831.697,Astoria (North)-Ditmars-Steinway
19-May,36081014000,4014000,8489,64171,72660,Queens,2390486.969,Kew Gardens
21-May,36081014000,4014000,3971,42411,46382,Queens,2390486.969,Kew Gardens
19-Jun,36081014000,4014000,5417,93290,98707,Queens,2390486.969,Kew Gardens
21-Jun,36081014000,4014000,15435,93886,109321,Queens,2390486.969,Kew Gardens
19-Jul,36081014000,4014000,9013,11858,20871,Queens,2390486.969,Kew Gardens
21-Jul,36081014000,4014000,18197,30145,48342,Queens,2390486.969,Kew Gardens
19-Aug,36081014000,4014000,3094,105554,108648,Queens,2390486.969,Kew Gardens
21-Aug,36081014000,4014000,8864,80385,89249,Queens,2390486.969,Kew Gardens
19-May,36081014201,4014201,709,114371,115080,Queens,2270918.859,Richmond Hill
21-May,36081014201,4014201,14990,67940,82930,Queens,2270918.859,Richmond Hill
19-Jun,36081014201,4014201,9241,103629,112870,Queens,2270918.859,Richmond Hill
21-Jun,36081014201,4014201,17743,37719,55462,Queens,2270918.859,Richmond Hill
19-Jul,36081014201,4014201,11919,81292,93211,Queens,2270918.859,Richmond Hill
21-Jul,36081014201,4014201,0,41272,41272,Queens,2270918.859,Richmond Hill
19-Aug,36081014201,4014201,9960,112231,122191,Queens,2270918.859,Richmond Hill
21-Aug,36081014201,4014201,12391,36896,49287,Queens,2270918.859,Richmond Hill
19-May,36081014300,4014300,16413,28373,44786,Queens,1469451.956,Astoria (East)-Woodside (North)
21-May,36081014300,4014300,513,113484,113997,Queens,1469451.956,Astoria (East)-Woodside (North)
19-Jun,36081014300,4014300,6781,79789,86570,Queens,1469451.956,Astoria (East)-Woodside (North)
21-Jun,36081014300,4014300,6189,67551,73740,Queens,1469451.956,Astoria (East)-Woodside (North)
19-Jul,36081014300,4014300,13047,106973,120020,Queens,1469451.956,Astoria (East)-Woodside (North)
21-Jul,36081014300,4014300,2035,91362,93397,Queens,1469451.956,Astoria (East)-Woodside (North)
19-Aug,36081014300,4014300,6377,73006,79383,Queens,1469451.956,Astoria (East)-Woodside (North)
21-Aug,36081014300,4014300,3099,160990,164089,Queens,1469451.956,Astoria (East)-Woodside (North)
19-May,36081014500,4014500,4639,92840,97479,Queens,1374739.917,Astoria (East)-Woodside (North)
21-May,36081014500,4014500,9314,120790,130104,Queens,1374739.917,Astoria (East)-Woodside (North)
19-Jun,36081014500,4014500,4619,43567,48186,Queens,1374739.917,Astoria (East)-Woodside (North)
21-Jun,36081014500,4014500,4096,25857,29953,Queens,1374739.917,Astoria (East)-Woodside (North)
19-Jul,36081014500,4014500,6022,88378,94400,Queens,1374739.917,Astoria (East)-Woodside (North)
21-Jul,36081014500,4014500,14813,91495,106308,Queens,1374739.917,Astoria (East)-Woodside (North)
19-Aug,36081014500,4014500,12167,101892,114059,Queens,1374739.917,Astoria (East)-Woodside (North)
21-Aug,36081014500,4014500,19092,66944,86036,Queens,1374739.917,Astoria (East)-Woodside (North)
19-May,36081014700,4014700,10510,79355,89865,Queens,1592386.546,Astoria (East)-Woodside (North)
21-May,36081014700,4014700,1283,52324,53607,Queens,1592386.546,Astoria (East)-Woodside (North)
19-Jun,36081014700,4014700,11030,53716,64746,Queens,1592386.546,Astoria (East)-Woodside (North)
21-Jun,36081014700,4014700,9360,118485,127845,Queens,1592386.546,Astoria (East)-Woodside (North)
19-Jul,36081014700,4014700,10138,18039,28177,Queens,1592386.546,Astoria (East)-Woodside (North)
21-Jul,36081014700,4014700,9386,43859,53245,Queens,1592386.546,Astoria (East)-Woodside (North)
19-Aug,36081014700,4014700,13700,50369,64069,Queens,1592386.546,Astoria (East)-Woodside (North)
21-Aug,36081014700,4014700,4458,30155,34613,Queens,1592386.546,Astoria (East)-Woodside (North)
19-May,36081014800,4014800,9199,76491,85690,Queens,1685384.501,South Richmond Hill
21-May,36081014800,4014800,7613,90470,98083,Queens,1685384.501,South Richmond Hill
19-Jun,36081014800,4014800,2811,95709,98520,Queens,1685384.501,South Richmond Hill
21-Jun,36081014800,4014800,2287,108348,110635,Queens,1685384.501,South Richmond Hill
19-Jul,36081014800,4014800,14966,73432,88398,Queens,1685384.501,South Richmond Hill
21-Jul,36081014800,4014800,9332,136518,145850,Queens,1685384.501,South Richmond Hill
19-Aug,36081014800,4014800,13703,55063,68766,Queens,1685384.501,South Richmond Hill
21-Aug,36081014800,4014800,4938,102198,107136,Queens,1685384.501,South Richmond Hill
19-May,36081014900,4014900,10141,49134,59275,Queens,1147477.752,Astoria (East)-Woodside (North)
21-May,36081014900,4014900,11439,80797,92236,Queens,1147477.752,Astoria (East)-Woodside (North)
19-Jun,36081014900,4014900,5120,81384,86504,Queens,1147477.752,Astoria (East)-Woodside (North)
21-Jun,36081014900,4014900,3100,24758,27858,Queens,1147477.752,Astoria (East)-Woodside (North)
19-Jul,36081014900,4014900,9427,79490,88917,Queens,1147477.752,Astoria (East)-Woodside (North)
21-Jul,36081014900,4014900,9647,74462,84109,Queens,1147477.752,Astoria (East)-Woodside (North)
19-Aug,36081014900,4014900,5566,91915,97481,Queens,1147477.752,Astoria (East)-Woodside (North)
21-Aug,36081014900,4014900,7251,197367,204618,Queens,1147477.752,Astoria (East)-Woodside (North)
19-May,36081015000,4015000,4932,95434,100366,Queens,1583628.113,South Richmond Hill
21-May,36081015000,4015000,8463,117265,125728,Queens,1583628.113,South Richmond Hill
19-Jun,36081015000,4015000,12474,54477,66951,Queens,1583628.113,South Richmond Hill
21-Jun,36081015000,4015000,13025,133386,146411,Queens,1583628.113,South Richmond Hill
19-Jul,36081015000,4015000,11862,98628,110490,Queens,1583628.113,South Richmond Hill
21-Jul,36081015000,4015000,10015,82282,92297,Queens,1583628.113,South Richmond Hill
19-Aug,36081015000,4015000,0,60071,60071,Queens,1583628.113,South Richmond Hill
21-Aug,36081015000,4015000,4806,75925,80731,Queens,1583628.113,South Richmond Hill
19-May,36081015100,4015100,17175,66829,84004,Queens,1435760.685,Astoria (East)-Woodside (North)
21-May,36081015100,4015100,9963,86091,96054,Queens,1435760.685,Astoria (East)-Woodside (North)
19-Jun,36081015100,4015100,12689,111159,123848,Queens,1435760.685,Astoria (East)-Woodside (North)
21-Jun,36081015100,4015100,4107,12732,16839,Queens,1435760.685,Astoria (East)-Woodside (North)
19-Jul,36081015100,4015100,8641,105411,114052,Queens,1435760.685,Astoria (East)-Woodside (North)
21-Jul,36081015100,4015100,13586,61360,74946,Queens,1435760.685,Astoria (East)-Woodside (North)
19-Aug,36081015100,4015100,9154,103996,113150,Queens,1435760.685,Astoria (East)-Woodside (North)
21-Aug,36081015100,4015100,3737,76730,80467,Queens,1435760.685,Astoria (East)-Woodside (North)
19-May,36081015200,4015200,8274,66342,74616,Queens,2001448.599,South Richmond Hill
21-May,36081015200,4015200,9006,71,9077,Queens,2001448.599,South Richmond Hill
19-Jun,36081015200,4015200,9219,42129,51348,Queens,2001448.599,South Richmond Hill
21-Jun,36081015200,4015200,9761,73187,82948,Queens,2001448.599,South Richmond Hill
19-Jul,36081015200,4015200,8712,80438,89150,Queens,2001448.599,South Richmond Hill
21-Jul,36081015200,4015200,20003,124164,144167,Queens,2001448.599,South Richmond Hill
19-Aug,36081015200,4015200,12921,49654,62575,Queens,2001448.599,South Richmond Hill
21-Aug,36081015200,4015200,6433,150056,156489,Queens,2001448.599,South Richmond Hill
19-May,36081015300,4015300,16263,21832,38095,Queens,1309390.506,Astoria (East)-Woodside (North)
21-May,36081015300,4015300,10139,95239,105378,Queens,1309390.506,Astoria (East)-Woodside (North)
19-Jun,36081015300,4015300,10838,57680,68518,Queens,1309390.506,Astoria (East)-Woodside (North)
21-Jun,36081015300,4015300,9482,51251,60733,Queens,1309390.506,Astoria (East)-Woodside (North)
19-Jul,36081015300,4015300,7426,30491,37917,Queens,1309390.506,Astoria (East)-Woodside (North)
21-Jul,36081015300,4015300,16996,88571,105567,Queens,1309390.506,Astoria (East)-Woodside (North)
19-Aug,36081015300,4015300,4661,62670,67331,Queens,1309390.506,Astoria (East)-Woodside (North)
21-Aug,36081015300,4015300,14085,44398,58483,Queens,1309390.506,Astoria (East)-Woodside (North)
19-May,36081015400,4015400,4069,146739,150808,Queens,1617854.352,South Richmond Hill
21-May,36081015400,4015400,6071,89754,95825,Queens,1617854.352,South Richmond Hill
19-Jun,36081015400,4015400,2131,54337,56468,Queens,1617854.352,South Richmond Hill
21-Jun,36081015400,4015400,5424,30577,36001,Queens,1617854.352,South Richmond Hill
19-Jul,36081015400,4015400,4563,111459,116022,Queens,1617854.352,South Richmond Hill
21-Jul,36081015400,4015400,1842,29376,31218,Queens,1617854.352,South Richmond Hill
19-Aug,36081015400,4015400,8690,64550,73240,Queens,1617854.352,South Richmond Hill
21-Aug,36081015400,4015400,5301,79742,85043,Queens,1617854.352,South Richmond Hill
19-May,36081015600,4015600,15141,46584,61725,Queens,2253099.397,South Richmond Hill
21-May,36081015600,4015600,10101,76565,86666,Queens,2253099.397,South Richmond Hill
19-Jun,36081015600,4015600,7515,33575,41090,Queens,2253099.397,South Richmond Hill
21-Jun,36081015600,4015600,1751,64394,66145,Queens,2253099.397,South Richmond Hill
19-Jul,36081015600,4015600,4592,58859,63451,Queens,2253099.397,South Richmond Hill
21-Jul,36081015600,4015600,3268,32739,36007,Queens,2253099.397,South Richmond Hill
19-Aug,36081015600,4015600,8312,71,8383,Queens,2253099.397,South Richmond Hill
21-Aug,36081015600,4015600,11846,97698,109544,Queens,2253099.397,South Richmond Hill
19-May,36081015700,4015700,15674,49549,65223,Queens,1383061.463,Astoria (East)-Woodside (North)
21-May,36081015700,4015700,9245,8758,18003,Queens,1383061.463,Astoria (East)-Woodside (North)
19-Jun,36081015700,4015700,12215,28006,40221,Queens,1383061.463,Astoria (East)-Woodside (North)
21-Jun,36081015700,4015700,11025,143545,154570,Queens,1383061.463,Astoria (East)-Woodside (North)
19-Jul,36081015700,4015700,9801,72674,82475,Queens,1383061.463,Astoria (East)-Woodside (North)
21-Jul,36081015700,4015700,9600,89036,98636,Queens,1383061.463,Astoria (East)-Woodside (North)
19-Aug,36081015700,4015700,12393,31164,43557,Queens,1383061.463,Astoria (East)-Woodside (North)
21-Aug,36081015700,4015700,13703,35731,49434,Queens,1383061.463,Astoria (East)-Woodside (North)
19-May,36081015801,4015801,7217,34565,41782,Queens,3201805.24,South Ozone Park
21-May,36081015801,4015801,9871,65971,75842,Queens,3201805.24,South Ozone Park
19-Jun,36081015801,4015801,9769,47389,57158,Queens,3201805.24,South Ozone Park
21-Jun,36081015801,4015801,7039,83270,90309,Queens,3201805.24,South Ozone Park
19-Jul,36081015801,4015801,19673,73154,92827,Queens,3201805.24,South Ozone Park
21-Jul,36081015801,4015801,5022,87184,92206,Queens,3201805.24,South Ozone Park
19-Aug,36081015801,4015801,6724,56663,63387,Queens,3201805.24,South Ozone Park
21-Aug,36081015801,4015801,4779,151500,156279,Queens,3201805.24,South Ozone Park
19-May,36081015802,4015802,1477,137862,139339,Queens,2997105.484,South Ozone Park
21-May,36081015802,4015802,0,85313,85313,Queens,2997105.484,South Ozone Park
19-Jun,36081015802,4015802,6797,41013,47810,Queens,2997105.484,South Ozone Park
21-Jun,36081015802,4015802,7948,57551,65499,Queens,2997105.484,South Ozone Park
19-Jul,36081015802,4015802,2492,81833,84325,Queens,2997105.484,South Ozone Park
21-Jul,36081015802,4015802,10179,150503,160682,Queens,2997105.484,South Ozone Park
19-Aug,36081015802,4015802,9215,98004,107219,Queens,2997105.484,South Ozone Park
21-Aug,36081015802,4015802,4729,49519,54248,Queens,2997105.484,South Ozone Park
19-May,36081016100,4016100,8267,63675,71942,Queens,1157640.358,Astoria (East)-Woodside (North)
21-May,36081016100,4016100,5739,34608,40347,Queens,1157640.358,Astoria (East)-Woodside (North)
19-Jun,36081016100,4016100,12096,51446,63542,Queens,1157640.358,Astoria (East)-Woodside (North)
21-Jun,36081016100,4016100,11221,63513,74734,Queens,1157640.358,Astoria (East)-Woodside (North)
19-Jul,36081016100,4016100,14946,68079,83025,Queens,1157640.358,Astoria (East)-Woodside (North)
21-Jul,36081016100,4016100,13734,68019,81753,Queens,1157640.358,Astoria (East)-Woodside (North)
19-Aug,36081016100,4016100,0,36143,36143,Queens,1157640.358,Astoria (East)-Woodside (North)
21-Aug,36081016100,4016100,7494,40855,48349,Queens,1157640.358,Astoria (East)-Woodside (North)
19-May,36081016400,4016400,10916,57082,67998,Queens,2129308.672,South Ozone Park
21-May,36081016400,4016400,8939,12064,21003,Queens,2129308.672,South Ozone Park
19-Jun,36081016400,4016400,4557,8401,12958,Queens,2129308.672,South Ozone Park
21-Jun,36081016400,4016400,4087,109079,113166,Queens,2129308.672,South Ozone Park
19-Jul,36081016400,4016400,6812,42319,49131,Queens,2129308.672,South Ozone Park
21-Jul,36081016400,4016400,7718,71,7789,Queens,2129308.672,South Ozone Park
19-Aug,36081016400,4016400,8065,76323,84388,Queens,2129308.672,South Ozone Park
21-Aug,36081016400,4016400,19434,50668,70102,Queens,2129308.672,South Ozone Park
19-May,36081016800,4016800,3199,31380,34579,Queens,2276026.717,South Ozone Park
21-May,36081016800,4016800,5507,51375,56882,Queens,2276026.717,South Ozone Park
19-Jun,36081016800,4016800,3785,83046,86831,Queens,2276026.717,South Ozone Park
21-Jun,36081016800,4016800,2845,23215,26060,Queens,2276026.717,South Ozone Park
19-Jul,36081016800,4016800,6683,59790,66473,Queens,2276026.717,South Ozone Park
21-Jul,36081016800,4016800,5342,41674,47016,Queens,2276026.717,South Ozone Park
19-Aug,36081016800,4016800,14657,43135,57792,Queens,2276026.717,South Ozone Park
21-Aug,36081016800,4016800,17525,76458,93983,Queens,2276026.717,South Ozone Park
19-May,36081016900,4016900,10722,38355,49077,Queens,2483619.458,Sunnyside
21-May,36081016900,4016900,10566,128797,139363,Queens,2483619.458,Sunnyside
19-Jun,36081016900,4016900,10150,57186,67336,Queens,2483619.458,Sunnyside
21-Jun,36081016900,4016900,17456,71,17527,Queens,2483619.458,Sunnyside
19-Jul,36081016900,4016900,5268,10682,15950,Queens,2483619.458,Sunnyside
21-Jul,36081016900,4016900,5377,128441,133818,Queens,2483619.458,Sunnyside
19-Aug,36081016900,4016900,3683,104702,108385,Queens,2483619.458,Sunnyside
21-Aug,36081016900,4016900,4304,60719,65023,Queens,2483619.458,Sunnyside
19-May,36081017000,4017000,11296,101907,113203,Queens,2352796.543,South Ozone Park
21-May,36081017000,4017000,6334,21982,28316,Queens,2352796.543,South Ozone Park
19-Jun,36081017000,4017000,14872,164465,179337,Queens,2352796.543,South Ozone Park
21-Jun,36081017000,4017000,5157,81130,86287,Queens,2352796.543,South Ozone Park
19-Jul,36081017000,4017000,9306,63187,72493,Queens,2352796.543,South Ozone Park
21-Jul,36081017000,4017000,8149,128758,136907,Queens,2352796.543,South Ozone Park
19-Aug,36081017000,4017000,9811,71,9882,Queens,2352796.543,South Ozone Park
21-Aug,36081017000,4017000,9211,85774,94985,Queens,2352796.543,South Ozone Park
19-May,36081017200,4017200,6776,83702,90478,Queens,2056699.082,South Ozone Park
21-May,36081017200,4017200,8692,20803,29495,Queens,2056699.082,South Ozone Park
19-Jun,36081017200,4017200,6453,115815,122268,Queens,2056699.082,South Ozone Park
21-Jun,36081017200,4017200,4853,33334,38187,Queens,2056699.082,South Ozone Park
19-Jul,36081017200,4017200,12203,102616,114819,Queens,2056699.082,South Ozone Park
21-Jul,36081017200,4017200,18978,92863,111841,Queens,2056699.082,South Ozone Park
19-Aug,36081017200,4017200,9164,74933,84097,Queens,2056699.082,South Ozone Park
21-Aug,36081017200,4017200,16878,62112,78990,Queens,2056699.082,South Ozone Park
19-May,36081017400,4017400,9147,120557,129704,Queens,2056259.49,South Ozone Park
21-May,36081017400,4017400,7742,69896,77638,Queens,2056259.49,South Ozone Park
19-Jun,36081017400,4017400,5831,53041,58872,Queens,2056259.49,South Ozone Park
21-Jun,36081017400,4017400,6067,102215,108282,Queens,2056259.49,South Ozone Park
19-Jul,36081017400,4017400,5786,59235,65021,Queens,2056259.49,South Ozone Park
21-Jul,36081017400,4017400,2222,73864,76086,Queens,2056259.49,South Ozone Park
19-Aug,36081017400,4017400,13893,49987,63880,Queens,2056259.49,South Ozone Park
21-Aug,36081017400,4017400,10836,84699,95535,Queens,2056259.49,South Ozone Park
19-May,36081017600,4017600,0,28479,28479,Queens,2052682.335,South Ozone Park
21-May,36081017600,4017600,0,58994,58994,Queens,2052682.335,South Ozone Park
19-Jun,36081017600,4017600,7426,83889,91315,Queens,2052682.335,South Ozone Park
21-Jun,36081017600,4017600,2990,29104,32094,Queens,2052682.335,South Ozone Park
19-Jul,36081017600,4017600,7190,92628,99818,Queens,2052682.335,South Ozone Park
21-Jul,36081017600,4017600,8977,65823,74800,Queens,2052682.335,South Ozone Park
19-Aug,36081017600,4017600,9697,83877,93574,Queens,2052682.335,South Ozone Park
21-Aug,36081017600,4017600,10327,20971,31298,Queens,2052682.335,South Ozone Park
19-May,36081017800,4017800,1362,37775,39137,Queens,2036947.548,South Ozone Park
21-May,36081017800,4017800,2885,97219,100104,Queens,2036947.548,South Ozone Park
19-Jun,36081017800,4017800,17222,107825,125047,Queens,2036947.548,South Ozone Park
21-Jun,36081017800,4017800,17565,121923,139488,Queens,2036947.548,South Ozone Park
19-Jul,36081017800,4017800,17549,112017,129566,Queens,2036947.548,South Ozone Park
21-Jul,36081017800,4017800,10400,46664,57064,Queens,2036947.548,South Ozone Park
19-Aug,36081017800,4017800,8634,69016,77650,Queens,2036947.548,South Ozone Park
21-Aug,36081017800,4017800,3628,65695,69323,Queens,2036947.548,South Ozone Park
19-May,36081017901,4017901,10766,113704,124470,Queens,1037434.788,Sunnyside
21-May,36081017901,4017901,12228,19913,32141,Queens,1037434.788,Sunnyside
19-Jun,36081017901,4017901,4652,9084,13736,Queens,1037434.788,Sunnyside
21-Jun,36081017901,4017901,3812,71,3883,Queens,1037434.788,Sunnyside
19-Jul,36081017901,4017901,8399,36207,44606,Queens,1037434.788,Sunnyside
21-Jul,36081017901,4017901,11480,128430,139910,Queens,1037434.788,Sunnyside
19-Aug,36081017901,4017901,1791,70147,71938,Queens,1037434.788,Sunnyside
21-Aug,36081017901,4017901,6673,8256,14929,Queens,1037434.788,Sunnyside
19-May,36081017902,4017902,8707,55077,63784,Queens,4062482.134,Sunnyside
21-May,36081017902,4017902,5375,62170,67545,Queens,4062482.134,Sunnyside
19-Jun,36081017902,4017902,10813,98575,109388,Queens,4062482.134,Sunnyside
21-Jun,36081017902,4017902,2741,51355,54096,Queens,4062482.134,Sunnyside
19-Jul,36081017902,4017902,4564,77890,82454,Queens,4062482.134,Sunnyside
21-Jul,36081017902,4017902,14362,107558,121920,Queens,4062482.134,Sunnyside
19-Aug,36081017902,4017902,18111,71,18182,Queens,4062482.134,Sunnyside
21-Aug,36081017902,4017902,19267,135392,154659,Queens,4062482.134,Sunnyside
19-May,36081018000,4018000,10488,62268,72756,Queens,1491934.505,South Ozone Park
21-May,36081018000,4018000,6185,85734,91919,Queens,1491934.505,South Ozone Park
19-Jun,36081018000,4018000,0,104170,104170,Queens,1491934.505,South Ozone Park
21-Jun,36081018000,4018000,3267,128234,131501,Queens,1491934.505,South Ozone Park
19-Jul,36081018000,4018000,15384,71256,86640,Queens,1491934.505,South Ozone Park
21-Jul,36081018000,4018000,7543,108823,116366,Queens,1491934.505,South Ozone Park
19-Aug,36081018000,4018000,18373,54336,72709,Queens,1491934.505,South Ozone Park
21-Aug,36081018000,4018000,12489,37207,49696,Queens,1491934.505,South Ozone Park
19-May,36081018101,4018101,5227,128143,133370,Queens,1035687.632,Sunnyside
21-May,36081018101,4018101,18477,11235,29712,Queens,1035687.632,Sunnyside
19-Jun,36081018101,4018101,9661,71,9732,Queens,1035687.632,Sunnyside
21-Jun,36081018101,4018101,1201,78194,79395,Queens,1035687.632,Sunnyside
19-Jul,36081018101,4018101,8295,93385,101680,Queens,1035687.632,Sunnyside
21-Jul,36081018101,4018101,6010,59050,65060,Queens,1035687.632,Sunnyside
19-Aug,36081018101,4018101,9452,87944,97396,Queens,1035687.632,Sunnyside
21-Aug,36081018101,4018101,8701,89597,98298,Queens,1035687.632,Sunnyside
19-May,36081018102,4018102,17486,137603,155089,Queens,1038481.145,Sunnyside
21-May,36081018102,4018102,13776,71,13847,Queens,1038481.145,Sunnyside
19-Jun,36081018102,4018102,5973,95864,101837,Queens,1038481.145,Sunnyside
21-Jun,36081018102,4018102,3490,126471,129961,Queens,1038481.145,Sunnyside
19-Jul,36081018102,4018102,1927,31206,33133,Queens,1038481.145,Sunnyside
21-Jul,36081018102,4018102,4960,99486,104446,Queens,1038481.145,Sunnyside
19-Aug,36081018102,4018102,2672,42191,44863,Queens,1038481.145,Sunnyside
21-Aug,36081018102,4018102,3193,77997,81190,Queens,1038481.145,Sunnyside
19-May,36081018200,4018200,1639,73021,74660,Queens,2804355.835,Baisley Park
21-May,36081018200,4018200,3253,108891,112144,Queens,2804355.835,Baisley Park
19-Jun,36081018200,4018200,581,84543,85124,Queens,2804355.835,Baisley Park
21-Jun,36081018200,4018200,10938,68769,79707,Queens,2804355.835,Baisley Park
19-Jul,36081018200,4018200,12415,43290,55705,Queens,2804355.835,Baisley Park
21-Jul,36081018200,4018200,11544,46693,58237,Queens,2804355.835,Baisley Park
19-Aug,36081018200,4018200,11659,142931,154590,Queens,2804355.835,Baisley Park
21-Aug,36081018200,4018200,10821,65827,76648,Queens,2804355.835,Baisley Park
19-May,36081018300,4018300,9608,5650,15258,Queens,2314483.754,Sunnyside
21-May,36081018300,4018300,9752,31479,41231,Queens,2314483.754,Sunnyside
19-Jun,36081018300,4018300,5285,137744,143029,Queens,2314483.754,Sunnyside
21-Jun,36081018300,4018300,21193,68171,89364,Queens,2314483.754,Sunnyside
19-Jul,36081018300,4018300,13512,53753,67265,Queens,2314483.754,Sunnyside
21-Jul,36081018300,4018300,833,70432,71265,Queens,2314483.754,Sunnyside
19-Aug,36081018300,4018300,0,83986,83986,Queens,2314483.754,Sunnyside
21-Aug,36081018300,4018300,9534,60195,69729,Queens,2314483.754,Sunnyside
19-May,36081018401,4018401,7163,46791,53954,Queens,2062597.676,Baisley Park
21-May,36081018401,4018401,2551,64719,67270,Queens,2062597.676,Baisley Park
19-Jun,36081018401,4018401,10830,66051,76881,Queens,2062597.676,Baisley Park
21-Jun,36081018401,4018401,12419,2377,14796,Queens,2062597.676,Baisley Park
19-Jul,36081018401,4018401,4067,20565,24632,Queens,2062597.676,Baisley Park
21-Jul,36081018401,4018401,13112,53549,66661,Queens,2062597.676,Baisley Park
19-Aug,36081018401,4018401,12033,158499,170532,Queens,2062597.676,Baisley Park
21-Aug,36081018401,4018401,4577,100109,104686,Queens,2062597.676,Baisley Park
19-May,36081018402,4018402,8104,113435,121539,Queens,2287905.768,Baisley Park
21-May,36081018402,4018402,0,91220,91220,Queens,2287905.768,Baisley Park
19-Jun,36081018402,4018402,3555,94791,98346,Queens,2287905.768,Baisley Park
21-Jun,36081018402,4018402,9144,18387,27531,Queens,2287905.768,Baisley Park
19-Jul,36081018402,4018402,16422,54136,70558,Queens,2287905.768,Baisley Park
21-Jul,36081018402,4018402,8195,81981,90176,Queens,2287905.768,Baisley Park
19-Aug,36081018402,4018402,3987,47578,51565,Queens,2287905.768,Baisley Park
21-Aug,36081018402,4018402,0,86844,86844,Queens,2287905.768,Baisley Park
19-May,36081018501,4018501,7209,97058,104267,Queens,1060458.042,Sunnyside
21-May,36081018501,4018501,2555,25300,27855,Queens,1060458.042,Sunnyside
19-Jun,36081018501,4018501,1668,47442,49110,Queens,1060458.042,Sunnyside
21-Jun,36081018501,4018501,17199,81192,98391,Queens,1060458.042,Sunnyside
19-Jul,36081018501,4018501,5520,72809,78329,Queens,1060458.042,Sunnyside
21-Jul,36081018501,4018501,4861,18465,23326,Queens,1060458.042,Sunnyside
19-Aug,36081018501,4018501,10864,95096,105960,Queens,1060458.042,Sunnyside
21-Aug,36081018501,4018501,6152,71521,77673,Queens,1060458.042,Sunnyside
19-May,36081018502,4018502,9550,97292,106842,Queens,1059000.893,Sunnyside
21-May,36081018502,4018502,7725,101969,109694,Queens,1059000.893,Sunnyside
19-Jun,36081018502,4018502,10355,3690,14045,Queens,1059000.893,Sunnyside
21-Jun,36081018502,4018502,216,72258,72474,Queens,1059000.893,Sunnyside
19-Jul,36081018502,4018502,11153,116043,127196,Queens,1059000.893,Sunnyside
21-Jul,36081018502,4018502,4494,38826,43320,Queens,1059000.893,Sunnyside
19-Aug,36081018502,4018502,4957,54833,59790,Queens,1059000.893,Sunnyside
21-Aug,36081018502,4018502,13651,51395,65046,Queens,1059000.893,Sunnyside
19-May,36081018600,4018600,17323,6116,23439,Queens,1940917.908,Baisley Park
21-May,36081018600,4018600,7362,89826,97188,Queens,1940917.908,Baisley Park
19-Jun,36081018600,4018600,8867,143734,152601,Queens,1940917.908,Baisley Park
21-Jun,36081018600,4018600,0,67463,67463,Queens,1940917.908,Baisley Park
19-Jul,36081018600,4018600,12198,87342,99540,Queens,1940917.908,Baisley Park
21-Jul,36081018600,4018600,12648,85693,98341,Queens,1940917.908,Baisley Park
19-Aug,36081018600,4018600,9925,26585,36510,Queens,1940917.908,Baisley Park
21-Aug,36081018600,4018600,9510,59433,68943,Queens,1940917.908,Baisley Park
19-May,36081018700,4018700,7656,70348,78004,Queens,2598727.312,Sunnyside
21-May,36081018700,4018700,4402,65919,70321,Queens,2598727.312,Sunnyside
19-Jun,36081018700,4018700,15677,31451,47128,Queens,2598727.312,Sunnyside
21-Jun,36081018700,4018700,15282,102128,117410,Queens,2598727.312,Sunnyside
19-Jul,36081018700,4018700,13055,13376,26431,Queens,2598727.312,Sunnyside
21-Jul,36081018700,4018700,2358,87348,89706,Queens,2598727.312,Sunnyside
19-Aug,36081018700,4018700,16170,62631,78801,Queens,2598727.312,Sunnyside
21-Aug,36081018700,4018700,12400,115154,127554,Queens,2598727.312,Sunnyside
19-May,36081018800,4018800,15145,67409,82554,Queens,1916871.622,Baisley Park
21-May,36081018800,4018800,13115,91224,104339,Queens,1916871.622,Baisley Park
19-Jun,36081018800,4018800,5666,74282,79948,Queens,1916871.622,Baisley Park
21-Jun,36081018800,4018800,2804,86974,89778,Queens,1916871.622,Baisley Park
19-Jul,36081018800,4018800,4103,104690,108793,Queens,1916871.622,Baisley Park
21-Jul,36081018800,4018800,2995,93165,96160,Queens,1916871.622,Baisley Park
19-Aug,36081018800,4018800,4447,139819,144266,Queens,1916871.622,Baisley Park
21-Aug,36081018800,4018800,4711,115481,120192,Queens,1916871.622,Baisley Park
19-May,36081018900,4018900,0,93385,93385,Queens,2343199.543,Sunnyside
21-May,36081018900,4018900,8986,40178,49164,Queens,2343199.543,Sunnyside
19-Jun,36081018900,4018900,11368,77161,88529,Queens,2343199.543,Sunnyside
21-Jun,36081018900,4018900,946,128234,129180,Queens,2343199.543,Sunnyside
19-Jul,36081018900,4018900,10787,31286,42073,Queens,2343199.543,Sunnyside
21-Jul,36081018900,4018900,9446,67461,76907,Queens,2343199.543,Sunnyside
19-Aug,36081018900,4018900,7032,116829,123861,Queens,2343199.543,Sunnyside
21-Aug,36081018900,4018900,7047,34423,41470,Queens,2343199.543,Sunnyside
19-May,36081019000,4019000,10221,88729,98950,Queens,2026398.51,Baisley Park
21-May,36081019000,4019000,9077,87231,96308,Queens,2026398.51,Baisley Park
19-Jun,36081019000,4019000,10489,101506,111995,Queens,2026398.51,Baisley Park
21-Jun,36081019000,4019000,6702,74377,81079,Queens,2026398.51,Baisley Park
19-Jul,36081019000,4019000,6866,60188,67054,Queens,2026398.51,Baisley Park
21-Jul,36081019000,4019000,17338,17117,34455,Queens,2026398.51,Baisley Park
19-Aug,36081019000,4019000,8508,45553,54061,Queens,2026398.51,Baisley Park
21-Aug,36081019000,4019000,1961,78575,80536,Queens,2026398.51,Baisley Park
19-May,36081019200,4019200,14263,70494,84757,Queens,2159253.192,Baisley Park
21-May,36081019200,4019200,4976,93674,98650,Queens,2159253.192,Baisley Park
19-Jun,36081019200,4019200,7514,193086,200600,Queens,2159253.192,Baisley Park
21-Jun,36081019200,4019200,0,33312,33312,Queens,2159253.192,Baisley Park
19-Jul,36081019200,4019200,10025,80502,90527,Queens,2159253.192,Baisley Park
21-Jul,36081019200,4019200,16571,131779,148350,Queens,2159253.192,Baisley Park
19-Aug,36081019200,4019200,12580,116935,129515,Queens,2159253.192,Baisley Park
21-Aug,36081019200,4019200,11552,71,11623,Queens,2159253.192,Baisley Park
19-May,36081019400,4019400,4715,16197,20912,Queens,3276890.918,South Jamaica
21-May,36081019400,4019400,5902,58513,64415,Queens,3276890.918,South Jamaica
19-Jun,36081019400,4019400,7076,72834,79910,Queens,3276890.918,South Jamaica
21-Jun,36081019400,4019400,8114,73092,81206,Queens,3276890.918,South Jamaica
19-Jul,36081019400,4019400,7158,37831,44989,Queens,3276890.918,South Jamaica
21-Jul,36081019400,4019400,395,71,466,Queens,3276890.918,South Jamaica
19-Aug,36081019400,4019400,7149,38425,45574,Queens,3276890.918,South Jamaica
21-Aug,36081019400,4019400,4959,28639,33598,Queens,3276890.918,South Jamaica
19-May,36081019600,4019600,14389,128922,143311,Queens,2402963.986,South Jamaica
21-May,36081019600,4019600,8966,84109,93075,Queens,2402963.986,South Jamaica
19-Jun,36081019600,4019600,12278,60723,73001,Queens,2402963.986,South Jamaica
21-Jun,36081019600,4019600,3010,58497,61507,Queens,2402963.986,South Jamaica
19-Jul,36081019600,4019600,5911,89921,95832,Queens,2402963.986,South Jamaica
21-Jul,36081019600,4019600,16639,97070,113709,Queens,2402963.986,South Jamaica
19-Aug,36081019600,4019600,6948,93597,100545,Queens,2402963.986,South Jamaica
21-Aug,36081019600,4019600,14511,112805,127316,Queens,2402963.986,South Jamaica
19-May,36081019800,4019800,11425,89296,100721,Queens,2231765.019,South Jamaica
21-May,36081019800,4019800,9702,78272,87974,Queens,2231765.019,South Jamaica
19-Jun,36081019800,4019800,12265,57668,69933,Queens,2231765.019,South Jamaica
21-Jun,36081019800,4019800,9782,76316,86098,Queens,2231765.019,South Jamaica
19-Jul,36081019800,4019800,8666,23000,31666,Queens,2231765.019,South Jamaica
21-Jul,36081019800,4019800,9071,63512,72583,Queens,2231765.019,South Jamaica
19-Aug,36081019800,4019800,9357,67696,77053,Queens,2231765.019,South Jamaica
21-Aug,36081019800,4019800,7182,59452,66634,Queens,2231765.019,South Jamaica
19-May,36081019901,4019901,6934,44912,51846,Queens,3440003.305,Sunnyside
21-May,36081019901,4019901,10880,81399,92279,Queens,3440003.305,Sunnyside
19-Jun,36081019901,4019901,3763,107141,110904,Queens,3440003.305,Sunnyside
21-Jun,36081019901,4019901,0,62105,62105,Queens,3440003.305,Sunnyside
19-Jul,36081019901,4019901,10286,107114,117400,Queens,3440003.305,Sunnyside
21-Jul,36081019901,4019901,8780,109050,117830,Queens,3440003.305,Sunnyside
19-Aug,36081019901,4019901,5127,82992,88119,Queens,3440003.305,Sunnyside
21-Aug,36081019901,4019901,12911,118432,131343,Queens,3440003.305,Sunnyside
19-May,36081019902,4019902,14040,44771,58811,Queens,6790206.448,Sunnyside
21-May,36081019902,4019902,8085,98387,106472,Queens,6790206.448,Sunnyside
19-Jun,36081019902,4019902,355,40531,40886,Queens,6790206.448,Sunnyside
21-Jun,36081019902,4019902,8520,51107,59627,Queens,6790206.448,Sunnyside
19-Jul,36081019902,4019902,20143,46090,66233,Queens,6790206.448,Sunnyside
21-Jul,36081019902,4019902,16700,16956,33656,Queens,6790206.448,Sunnyside
19-Aug,36081019902,4019902,2563,33069,35632,Queens,6790206.448,Sunnyside
21-Aug,36081019902,4019902,15798,72797,88595,Queens,6790206.448,Sunnyside
19-May,36081020200,4020200,2640,39873,42513,Queens,1629223.569,South Jamaica
21-May,36081020200,4020200,4839,58676,63515,Queens,1629223.569,South Jamaica
19-Jun,36081020200,4020200,8325,24661,32986,Queens,1629223.569,South Jamaica
21-Jun,36081020200,4020200,16038,32850,48888,Queens,1629223.569,South Jamaica
19-Jul,36081020200,4020200,3544,100387,103931,Queens,1629223.569,South Jamaica
21-Jul,36081020200,4020200,3497,57718,61215,Queens,1629223.569,South Jamaica
19-Aug,36081020200,4020200,4813,22035,26848,Queens,1629223.569,South Jamaica
21-Aug,36081020200,4020200,7604,46352,53956,Queens,1629223.569,South Jamaica
19-May,36081020400,4020400,11599,85191,96790,Queens,3087462.933,Jamaica
21-May,36081020400,4020400,13497,142890,156387,Queens,3087462.933,Jamaica
19-Jun,36081020400,4020400,6887,73646,80533,Queens,3087462.933,Jamaica
21-Jun,36081020400,4020400,6696,55588,62284,Queens,3087462.933,Jamaica
19-Jul,36081020400,4020400,10494,98768,109262,Queens,3087462.933,Jamaica
21-Jul,36081020400,4020400,11152,72855,84007,Queens,3087462.933,Jamaica
19-Aug,36081020400,4020400,11684,75223,86907,Queens,3087462.933,Jamaica
21-Aug,36081020400,4020400,2042,55486,57528,Queens,3087462.933,Jamaica
19-May,36081020600,4020600,8364,113822,122186,Queens,1593891.975,Jamaica
21-May,36081020600,4020600,1615,124967,126582,Queens,1593891.975,Jamaica
19-Jun,36081020600,4020600,13325,152570,165895,Queens,1593891.975,Jamaica
21-Jun,36081020600,4020600,13104,39816,52920,Queens,1593891.975,Jamaica
19-Jul,36081020600,4020600,11249,49813,61062,Queens,1593891.975,Jamaica
21-Jul,36081020600,4020600,7183,41852,49035,Queens,1593891.975,Jamaica
19-Aug,36081020600,4020600,5013,24828,29841,Queens,1593891.975,Jamaica
21-Aug,36081020600,4020600,10853,69646,80499,Queens,1593891.975,Jamaica
19-May,36081020800,4020800,8882,104760,113642,Queens,5842045.057,Jamaica
21-May,36081020800,4020800,2380,89062,91442,Queens,5842045.057,Jamaica
19-Jun,36081020800,4020800,10851,65045,75896,Queens,5842045.057,Jamaica
21-Jun,36081020800,4020800,8513,21696,30209,Queens,5842045.057,Jamaica
19-Jul,36081020800,4020800,6230,111634,117864,Queens,5842045.057,Jamaica
21-Jul,36081020800,4020800,2321,112892,115213,Queens,5842045.057,Jamaica
19-Aug,36081020800,4020800,14890,46884,61774,Queens,5842045.057,Jamaica
21-Aug,36081020800,4020800,6217,25631,31848,Queens,5842045.057,Jamaica
19-May,36081021200,4021200,5223,27790,33013,Queens,2579753.739,Jamaica
21-May,36081021200,4021200,3255,38571,41826,Queens,2579753.739,Jamaica
19-Jun,36081021200,4021200,6771,177094,183865,Queens,2579753.739,Jamaica
21-Jun,36081021200,4021200,4828,125957,130785,Queens,2579753.739,Jamaica
19-Jul,36081021200,4021200,9975,109896,119871,Queens,2579753.739,Jamaica
21-Jul,36081021200,4021200,0,54434,54434,Queens,2579753.739,Jamaica
19-Aug,36081021200,4021200,8903,107156,116059,Queens,2579753.739,Jamaica
21-Aug,36081021200,4021200,2465,101466,103931,Queens,2579753.739,Jamaica
19-May,36081021400,4021400,5835,154228,160063,Queens,4079387.031,Jamaica Hills-Briarwood
21-May,36081021400,4021400,2383,76411,78794,Queens,4079387.031,Jamaica Hills-Briarwood
19-Jun,36081021400,4021400,3374,116067,119441,Queens,4079387.031,Jamaica Hills-Briarwood
21-Jun,36081021400,4021400,13172,77835,91007,Queens,4079387.031,Jamaica Hills-Briarwood
19-Jul,36081021400,4021400,6704,55949,62653,Queens,4079387.031,Jamaica Hills-Briarwood
21-Jul,36081021400,4021400,18225,123013,141238,Queens,4079387.031,Jamaica Hills-Briarwood
19-Aug,36081021400,4021400,1889,62487,64376,Queens,4079387.031,Jamaica Hills-Briarwood
21-Aug,36081021400,4021400,6603,65602,72205,Queens,4079387.031,Jamaica Hills-Briarwood
19-May,36081021602,4021602,0,76404,76404,Queens,1207645.673,Kew Gardens
21-May,36081021602,4021602,7961,58948,66909,Queens,1207645.673,Kew Gardens
19-Jun,36081021602,4021602,7700,11461,19161,Queens,1207645.673,Kew Gardens
21-Jun,36081021602,4021602,8543,24790,33333,Queens,1207645.673,Kew Gardens
19-Jul,36081021602,4021602,4306,46111,50417,Queens,1207645.673,Kew Gardens
21-Jul,36081021602,4021602,9418,18086,27504,Queens,1207645.673,Kew Gardens
19-Aug,36081021602,4021602,7192,112422,119614,Queens,1207645.673,Kew Gardens
21-Aug,36081021602,4021602,6561,42380,48941,Queens,1207645.673,Kew Gardens
19-May,36081021603,4021603,5708,127486,133194,Queens,3232869.355,Kew Gardens
21-May,36081021603,4021603,7939,38244,46183,Queens,3232869.355,Kew Gardens
19-Jun,36081021603,4021603,12242,139142,151384,Queens,3232869.355,Kew Gardens
21-Jun,36081021603,4021603,3202,60006,63208,Queens,3232869.355,Kew Gardens
19-Jul,36081021603,4021603,1737,49831,51568,Queens,3232869.355,Kew Gardens
21-Jul,36081021603,4021603,8248,39569,47817,Queens,3232869.355,Kew Gardens
19-Aug,36081021603,4021603,17531,89966,107497,Queens,3232869.355,Kew Gardens
21-Aug,36081021603,4021603,8882,129026,137908,Queens,3232869.355,Kew Gardens
19-May,36081022002,4022002,5701,70299,76000,Queens,3309944.256,Jamaica Hills-Briarwood
21-May,36081022002,4022002,9719,21137,30856,Queens,3309944.256,Jamaica Hills-Briarwood
19-Jun,36081022002,4022002,932,158994,159926,Queens,3309944.256,Jamaica Hills-Briarwood
21-Jun,36081022002,4022002,9919,95078,104997,Queens,3309944.256,Jamaica Hills-Briarwood
19-Jul,36081022002,4022002,9489,91823,101312,Queens,3309944.256,Jamaica Hills-Briarwood
21-Jul,36081022002,4022002,523,39429,39952,Queens,3309944.256,Jamaica Hills-Briarwood
19-Aug,36081022002,4022002,2410,89296,91706,Queens,3309944.256,Jamaica Hills-Briarwood
21-Aug,36081022002,4022002,0,31670,31670,Queens,3309944.256,Jamaica Hills-Briarwood
19-May,36081023000,4023000,1627,102863,104490,Queens,1782960.068,Jamaica Hills-Briarwood
21-May,36081023000,4023000,3067,91561,94628,Queens,1782960.068,Jamaica Hills-Briarwood
19-Jun,36081023000,4023000,10601,130660,141261,Queens,1782960.068,Jamaica Hills-Briarwood
21-Jun,36081023000,4023000,11077,81402,92479,Queens,1782960.068,Jamaica Hills-Briarwood
19-Jul,36081023000,4023000,3982,35002,38984,Queens,1782960.068,Jamaica Hills-Briarwood
21-Jul,36081023000,4023000,12220,101789,114009,Queens,1782960.068,Jamaica Hills-Briarwood
19-Aug,36081023000,4023000,12815,49340,62155,Queens,1782960.068,Jamaica Hills-Briarwood
21-Aug,36081023000,4023000,5008,79759,84767,Queens,1782960.068,Jamaica Hills-Briarwood
19-May,36081023200,4023200,5162,129324,134486,Queens,3557225.476,Jamaica Hills-Briarwood
21-May,36081023200,4023200,12753,18658,31411,Queens,3557225.476,Jamaica Hills-Briarwood
19-Jun,36081023200,4023200,13040,92267,105307,Queens,3557225.476,Jamaica Hills-Briarwood
21-Jun,36081023200,4023200,0,5322,5322,Queens,3557225.476,Jamaica Hills-Briarwood
19-Jul,36081023200,4023200,10558,71,10629,Queens,3557225.476,Jamaica Hills-Briarwood
21-Jul,36081023200,4023200,8853,25499,34352,Queens,3557225.476,Jamaica Hills-Briarwood
19-Aug,36081023200,4023200,1872,71089,72961,Queens,3557225.476,Jamaica Hills-Briarwood
21-Aug,36081023200,4023200,8892,95487,104379,Queens,3557225.476,Jamaica Hills-Briarwood
19-May,36081023501,4023501,5812,71921,77733,Queens,1481337.994,Sunnyside
21-May,36081023501,4023501,12216,98873,111089,Queens,1481337.994,Sunnyside
19-Jun,36081023501,4023501,16062,54422,70484,Queens,1481337.994,Sunnyside
21-Jun,36081023501,4023501,15982,71,16053,Queens,1481337.994,Sunnyside
19-Jul,36081023501,4023501,12693,73811,86504,Queens,1481337.994,Sunnyside
21-Jul,36081023501,4023501,7403,26378,33781,Queens,1481337.994,Sunnyside
19-Aug,36081023501,4023501,16419,110628,127047,Queens,1481337.994,Sunnyside
21-Aug,36081023501,4023501,4898,123805,128703,Queens,1481337.994,Sunnyside
19-May,36081023502,4023502,7114,90557,97671,Queens,1265214.147,Sunnyside
21-May,36081023502,4023502,2462,86659,89121,Queens,1265214.147,Sunnyside
19-Jun,36081023502,4023502,2369,71,2440,Queens,1265214.147,Sunnyside
21-Jun,36081023502,4023502,7738,86485,94223,Queens,1265214.147,Sunnyside
19-Jul,36081023502,4023502,8914,23709,32623,Queens,1265214.147,Sunnyside
21-Jul,36081023502,4023502,10644,67228,77872,Queens,1265214.147,Sunnyside
19-Aug,36081023502,4023502,0,109090,109090,Queens,1265214.147,Sunnyside
21-Aug,36081023502,4023502,8138,103442,111580,Queens,1265214.147,Sunnyside
19-May,36081023600,4023600,1769,71,1840,Queens,1897473.674,Jamaica
21-May,36081023600,4023600,10845,85579,96424,Queens,1897473.674,Jamaica
19-Jun,36081023600,4023600,5636,39955,45591,Queens,1897473.674,Jamaica
21-Jun,36081023600,4023600,9173,112505,121678,Queens,1897473.674,Jamaica
19-Jul,36081023600,4023600,3598,75224,78822,Queens,1897473.674,Jamaica
21-Jul,36081023600,4023600,16921,93264,110185,Queens,1897473.674,Jamaica
19-Aug,36081023600,4023600,13901,53377,67278,Queens,1897473.674,Jamaica
21-Aug,36081023600,4023600,2745,71,2816,Queens,1897473.674,Jamaica
19-May,36081023800,4023800,8228,80015,88243,Queens,1686741.441,Jamaica
21-May,36081023800,4023800,11998,40595,52593,Queens,1686741.441,Jamaica
19-Jun,36081023800,4023800,5324,54702,60026,Queens,1686741.441,Jamaica
21-Jun,36081023800,4023800,6504,102784,109288,Queens,1686741.441,Jamaica
19-Jul,36081023800,4023800,3640,71,3711,Queens,1686741.441,Jamaica
21-Jul,36081023800,4023800,6464,56997,63461,Queens,1686741.441,Jamaica
19-Aug,36081023800,4023800,11196,51014,62210,Queens,1686741.441,Jamaica
21-Aug,36081023800,4023800,15598,53665,69263,Queens,1686741.441,Jamaica
19-May,36081024000,4024000,4762,116164,120926,Queens,2901926.004,Jamaica
21-May,36081024000,4024000,5664,58728,64392,Queens,2901926.004,Jamaica
19-Jun,36081024000,4024000,10417,101762,112179,Queens,2901926.004,Jamaica
21-Jun,36081024000,4024000,0,90666,90666,Queens,2901926.004,Jamaica
19-Jul,36081024000,4024000,4100,9159,13259,Queens,2901926.004,Jamaica
21-Jul,36081024000,4024000,8732,139902,148634,Queens,2901926.004,Jamaica
19-Aug,36081024000,4024000,6260,68059,74319,Queens,2901926.004,Jamaica
21-Aug,36081024000,4024000,21377,71,21448,Queens,2901926.004,Jamaica
19-May,36081024600,4024600,15773,68974,84747,Queens,3270870.563,Jamaica
21-May,36081024600,4024600,6874,43858,50732,Queens,3270870.563,Jamaica
19-Jun,36081024600,4024600,10816,69014,79830,Queens,3270870.563,Jamaica
21-Jun,36081024600,4024600,4641,125512,130153,Queens,3270870.563,Jamaica
19-Jul,36081024600,4024600,1276,80754,82030,Queens,3270870.563,Jamaica
21-Jul,36081024600,4024600,14676,104993,119669,Queens,3270870.563,Jamaica
19-Aug,36081024600,4024600,4521,79639,84160,Queens,3270870.563,Jamaica
21-Aug,36081024600,4024600,3414,59945,63359,Queens,3270870.563,Jamaica
19-May,36081025100,4025100,5728,74018,79746,Queens,2646559.911,Woodside
21-May,36081025100,4025100,21114,56665,77779,Queens,2646559.911,Woodside
19-Jun,36081025100,4025100,4803,71,4874,Queens,2646559.911,Woodside
21-Jun,36081025100,4025100,12086,71,12157,Queens,2646559.911,Woodside
19-Jul,36081025100,4025100,17784,85423,103207,Queens,2646559.911,Woodside
21-Jul,36081025100,4025100,0,70277,70277,Queens,2646559.911,Woodside
19-Aug,36081025100,4025100,13158,123680,136838,Queens,2646559.911,Woodside
21-Aug,36081025100,4025100,13824,26424,40248,Queens,2646559.911,Woodside
19-May,36081025301,4025301,10382,53096,63478,Queens,1370376.214,Sunnyside
21-May,36081025301,4025301,7252,135377,142629,Queens,1370376.214,Sunnyside
19-Jun,36081025301,4025301,12706,60331,73037,Queens,1370376.214,Sunnyside
21-Jun,36081025301,4025301,10558,82670,93228,Queens,1370376.214,Sunnyside
19-Jul,36081025301,4025301,7863,118084,125947,Queens,1370376.214,Sunnyside
21-Jul,36081025301,4025301,0,52649,52649,Queens,1370376.214,Sunnyside
19-Aug,36081025301,4025301,3475,105708,109183,Queens,1370376.214,Sunnyside
21-Aug,36081025301,4025301,9264,43919,53183,Queens,1370376.214,Sunnyside
19-May,36081025302,4025302,5912,93748,99660,Queens,1131234.798,Sunnyside
21-May,36081025302,4025302,14951,79981,94932,Queens,1131234.798,Sunnyside
19-Jun,36081025302,4025302,7188,93681,100869,Queens,1131234.798,Sunnyside
21-Jun,36081025302,4025302,5881,27198,33079,Queens,1131234.798,Sunnyside
19-Jul,36081025302,4025302,15223,82049,97272,Queens,1131234.798,Sunnyside
21-Jul,36081025302,4025302,11596,139012,150608,Queens,1131234.798,Sunnyside
19-Aug,36081025302,4025302,5892,71,5963,Queens,1131234.798,Sunnyside
21-Aug,36081025302,4025302,8200,96580,104780,Queens,1131234.798,Sunnyside
19-May,36081025401,4025401,14098,66910,81008,Queens,2727728.6,South Jamaica
21-May,36081025401,4025401,8078,69974,78052,Queens,2727728.6,South Jamaica
19-Jun,36081025401,4025401,0,71488,71488,Queens,2727728.6,South Jamaica
21-Jun,36081025401,4025401,2758,79313,82071,Queens,2727728.6,South Jamaica
19-Jul,36081025401,4025401,7396,39147,46543,Queens,2727728.6,South Jamaica
21-Jul,36081025401,4025401,12688,73519,86207,Queens,2727728.6,South Jamaica
19-Aug,36081025401,4025401,8488,39676,48164,Queens,2727728.6,South Jamaica
21-Aug,36081025401,4025401,15156,74602,89758,Queens,2727728.6,South Jamaica
19-May,36081025402,4025402,6771,87688,94459,Queens,4070763.156,South Jamaica
21-May,36081025402,4025402,21774,71,21845,Queens,4070763.156,South Jamaica
19-Jun,36081025402,4025402,845,16490,17335,Queens,4070763.156,South Jamaica
21-Jun,36081025402,4025402,6915,18719,25634,Queens,4070763.156,South Jamaica
19-Jul,36081025402,4025402,19189,120855,140044,Queens,4070763.156,South Jamaica
21-Jul,36081025402,4025402,8518,104348,112866,Queens,4070763.156,South Jamaica
19-Aug,36081025402,4025402,10550,71092,81642,Queens,4070763.156,South Jamaica
21-Aug,36081025402,4025402,5058,69138,74196,Queens,4070763.156,South Jamaica
19-May,36081025500,4025500,3583,118514,122097,Queens,2345871.578,Woodside
21-May,36081025500,4025500,6913,50299,57212,Queens,2345871.578,Woodside
19-Jun,36081025500,4025500,9561,127582,137143,Queens,2345871.578,Woodside
21-Jun,36081025500,4025500,16049,73715,89764,Queens,2345871.578,Woodside
19-Jul,36081025500,4025500,6304,148910,155214,Queens,2345871.578,Woodside
21-Jul,36081025500,4025500,12037,34549,46586,Queens,2345871.578,Woodside
19-Aug,36081025500,4025500,5345,91942,97287,Queens,2345871.578,Woodside
21-Aug,36081025500,4025500,924,50832,51756,Queens,2345871.578,Woodside
19-May,36081025700,4025700,8655,4989,13644,Queens,1621552.768,Woodside
21-May,36081025700,4025700,1737,27624,29361,Queens,1621552.768,Woodside
19-Jun,36081025700,4025700,8468,93817,102285,Queens,1621552.768,Woodside
21-Jun,36081025700,4025700,11280,15632,26912,Queens,1621552.768,Woodside
19-Jul,36081025700,4025700,15047,56316,71363,Queens,1621552.768,Woodside
21-Jul,36081025700,4025700,3295,16866,20161,Queens,1621552.768,Woodside
19-Aug,36081025700,4025700,8739,62886,71625,Queens,1621552.768,Woodside
21-Aug,36081025700,4025700,3210,35821,39031,Queens,1621552.768,Woodside
19-May,36081025800,4025800,2667,13548,16215,Queens,2280364.87,South Jamaica
21-May,36081025800,4025800,17046,49742,66788,Queens,2280364.87,South Jamaica
19-Jun,36081025800,4025800,5064,74860,79924,Queens,2280364.87,South Jamaica
21-Jun,36081025800,4025800,13600,28377,41977,Queens,2280364.87,South Jamaica
19-Jul,36081025800,4025800,8098,54297,62395,Queens,2280364.87,South Jamaica
21-Jul,36081025800,4025800,15158,124239,139397,Queens,2280364.87,South Jamaica
19-Aug,36081025800,4025800,5961,70526,76487,Queens,2280364.87,South Jamaica
21-Aug,36081025800,4025800,8803,114792,123595,Queens,2280364.87,South Jamaica
19-May,36081025900,4025900,10316,77742,88058,Queens,2014820.568,Woodside
21-May,36081025900,4025900,9106,101143,110249,Queens,2014820.568,Woodside
19-Jun,36081025900,4025900,7646,78851,86497,Queens,2014820.568,Woodside
21-Jun,36081025900,4025900,7392,111086,118478,Queens,2014820.568,Woodside
19-Jul,36081025900,4025900,11632,35167,46799,Queens,2014820.568,Woodside
21-Jul,36081025900,4025900,11291,99349,110640,Queens,2014820.568,Woodside
19-Aug,36081025900,4025900,6776,105769,112545,Queens,2014820.568,Woodside
21-Aug,36081025900,4025900,3058,88747,91805,Queens,2014820.568,Woodside
19-May,36081026000,4026000,10140,9830,19970,Queens,1920918.459,South Jamaica
21-May,36081026000,4026000,17406,51300,68706,Queens,1920918.459,South Jamaica
19-Jun,36081026000,4026000,5076,63343,68419,Queens,1920918.459,South Jamaica
21-Jun,36081026000,4026000,15040,52702,67742,Queens,1920918.459,South Jamaica
19-Jul,36081026000,4026000,6895,114178,121073,Queens,1920918.459,South Jamaica
21-Jul,36081026000,4026000,10409,60040,70449,Queens,1920918.459,South Jamaica
19-Aug,36081026000,4026000,16237,71,16308,Queens,1920918.459,South Jamaica
21-Aug,36081026000,4026000,3359,87589,90948,Queens,1920918.459,South Jamaica
19-May,36081026200,4026200,7300,24362,31662,Queens,1540114.822,South Jamaica
21-May,36081026200,4026200,0,76454,76454,Queens,1540114.822,South Jamaica
19-Jun,36081026200,4026200,4077,97684,101761,Queens,1540114.822,South Jamaica
21-Jun,36081026200,4026200,11148,38379,49527,Queens,1540114.822,South Jamaica
19-Jul,36081026200,4026200,393,38959,39352,Queens,1540114.822,South Jamaica
21-Jul,36081026200,4026200,0,39488,39488,Queens,1540114.822,South Jamaica
19-Aug,36081026200,4026200,2192,73401,75593,Queens,1540114.822,South Jamaica
21-Aug,36081026200,4026200,2213,71,2284,Queens,1540114.822,South Jamaica
19-May,36081026400,4026400,17463,139799,157262,Queens,2739605.46,South Jamaica
21-May,36081026400,4026400,0,107633,107633,Queens,2739605.46,South Jamaica
19-Jun,36081026400,4026400,8013,89774,97787,Queens,2739605.46,South Jamaica
21-Jun,36081026400,4026400,10370,141792,152162,Queens,2739605.46,South Jamaica
19-Jul,36081026400,4026400,8140,80324,88464,Queens,2739605.46,South Jamaica
21-Jul,36081026400,4026400,13764,42562,56326,Queens,2739605.46,South Jamaica
19-Aug,36081026400,4026400,10673,71,10744,Queens,2739605.46,South Jamaica
21-Aug,36081026400,4026400,3367,106589,109956,Queens,2739605.46,South Jamaica
19-May,36081026600,4026600,3467,84033,87500,Queens,1861807.709,South Jamaica
21-May,36081026600,4026600,9739,125161,134900,Queens,1861807.709,South Jamaica
19-Jun,36081026600,4026600,2940,34314,37254,Queens,1861807.709,South Jamaica
21-Jun,36081026600,4026600,9993,24377,34370,Queens,1861807.709,South Jamaica
19-Jul,36081026600,4026600,4440,85799,90239,Queens,1861807.709,South Jamaica
21-Jul,36081026600,4026600,10491,71110,81601,Queens,1861807.709,South Jamaica
19-Aug,36081026600,4026600,5458,28016,33474,Queens,1861807.709,South Jamaica
21-Aug,36081026600,4026600,11743,34345,46088,Queens,1861807.709,South Jamaica
19-May,36081026700,4026700,10663,34082,44745,Queens,2256191.117,Elmhurst
21-May,36081026700,4026700,2201,69177,71378,Queens,2256191.117,Elmhurst
19-Jun,36081026700,4026700,8879,34568,43447,Queens,2256191.117,Elmhurst
21-Jun,36081026700,4026700,4251,34075,38326,Queens,2256191.117,Elmhurst
19-Jul,36081026700,4026700,10183,99608,109791,Queens,2256191.117,Elmhurst
21-Jul,36081026700,4026700,5695,102390,108085,Queens,2256191.117,Elmhurst
19-Aug,36081026700,4026700,14669,147965,162634,Queens,2256191.117,Elmhurst
21-Aug,36081026700,4026700,18924,55799,74723,Queens,2256191.117,Elmhurst
19-May,36081026901,4026901,13736,93722,107458,Queens,1230343.797,Elmhurst
21-May,36081026901,4026901,3029,84135,87164,Queens,1230343.797,Elmhurst
19-Jun,36081026901,4026901,1164,131712,132876,Queens,1230343.797,Elmhurst
21-Jun,36081026901,4026901,8575,77211,85786,Queens,1230343.797,Elmhurst
19-Jul,36081026901,4026901,18067,105285,123352,Queens,1230343.797,Elmhurst
21-Jul,36081026901,4026901,5899,89102,95001,Queens,1230343.797,Elmhurst
19-Aug,36081026901,4026901,10549,89362,99911,Queens,1230343.797,Elmhurst
21-Aug,36081026901,4026901,10204,102603,112807,Queens,1230343.797,Elmhurst
19-May,36081026902,4026902,4228,82316,86544,Queens,844998.0139,Elmhurst
21-May,36081026902,4026902,4520,112616,117136,Queens,844998.0139,Elmhurst
19-Jun,36081026902,4026902,1977,7472,9449,Queens,844998.0139,Elmhurst
21-Jun,36081026902,4026902,6817,37035,43852,Queens,844998.0139,Elmhurst
19-Jul,36081026902,4026902,15189,33012,48201,Queens,844998.0139,Elmhurst
21-Jul,36081026902,4026902,10983,9168,20151,Queens,844998.0139,Elmhurst
19-Aug,36081026902,4026902,4490,73892,78382,Queens,844998.0139,Elmhurst
21-Aug,36081026902,4026902,11058,90314,101372,Queens,844998.0139,Elmhurst
19-May,36081027000,4027000,7211,65959,73170,Queens,1992019.022,South Jamaica
21-May,36081027000,4027000,10102,12798,22900,Queens,1992019.022,South Jamaica
19-Jun,36081027000,4027000,994,99959,100953,Queens,1992019.022,South Jamaica
21-Jun,36081027000,4027000,2929,69097,72026,Queens,1992019.022,South Jamaica
19-Jul,36081027000,4027000,9936,61328,71264,Queens,1992019.022,South Jamaica
21-Jul,36081027000,4027000,3640,14178,17818,Queens,1992019.022,South Jamaica
19-Aug,36081027000,4027000,3520,79734,83254,Queens,1992019.022,South Jamaica
21-Aug,36081027000,4027000,8250,94383,102633,Queens,1992019.022,South Jamaica
19-May,36081027101,4027101,6063,76247,82310,Queens,967871.9416,Elmhurst
21-May,36081027101,4027101,6843,113862,120705,Queens,967871.9416,Elmhurst
19-Jun,36081027101,4027101,11876,109286,121162,Queens,967871.9416,Elmhurst
21-Jun,36081027101,4027101,4335,20898,25233,Queens,967871.9416,Elmhurst
19-Jul,36081027101,4027101,16015,48628,64643,Queens,967871.9416,Elmhurst
21-Jul,36081027101,4027101,18483,69122,87605,Queens,967871.9416,Elmhurst
19-Aug,36081027101,4027101,0,110160,110160,Queens,967871.9416,Elmhurst
21-Aug,36081027101,4027101,4638,64336,68974,Queens,967871.9416,Elmhurst
19-May,36081027102,4027102,12093,13921,26014,Queens,528308.6204,Elmhurst
21-May,36081027102,4027102,4079,57136,61215,Queens,528308.6204,Elmhurst
19-Jun,36081027102,4027102,8597,68514,77111,Queens,528308.6204,Elmhurst
21-Jun,36081027102,4027102,10690,87357,98047,Queens,528308.6204,Elmhurst
19-Jul,36081027102,4027102,7723,118209,125932,Queens,528308.6204,Elmhurst
21-Jul,36081027102,4027102,0,69716,69716,Queens,528308.6204,Elmhurst
19-Aug,36081027102,4027102,5782,67289,73071,Queens,528308.6204,Elmhurst
21-Aug,36081027102,4027102,12368,44178,56546,Queens,528308.6204,Elmhurst
19-May,36081027200,4027200,9536,21380,30916,Queens,1653862.589,Baisley Park
21-May,36081027200,4027200,3853,84885,88738,Queens,1653862.589,Baisley Park
19-Jun,36081027200,4027200,10829,71782,82611,Queens,1653862.589,Baisley Park
21-Jun,36081027200,4027200,6855,115011,121866,Queens,1653862.589,Baisley Park
19-Jul,36081027200,4027200,11302,97000,108302,Queens,1653862.589,Baisley Park
21-Jul,36081027200,4027200,2442,7031,9473,Queens,1653862.589,Baisley Park
19-Aug,36081027200,4027200,8931,23548,32479,Queens,1653862.589,Baisley Park
21-Aug,36081027200,4027200,9967,36450,46417,Queens,1653862.589,Baisley Park
19-May,36081027301,4027301,7343,92628,99971,Queens,1061782.622,Jackson Heights
21-May,36081027301,4027301,6043,2771,8814,Queens,1061782.622,Jackson Heights
19-Jun,36081027301,4027301,8109,87412,95521,Queens,1061782.622,Jackson Heights
21-Jun,36081027301,4027301,0,30569,30569,Queens,1061782.622,Jackson Heights
19-Jul,36081027301,4027301,18467,71,18538,Queens,1061782.622,Jackson Heights
21-Jul,36081027301,4027301,18216,83547,101763,Queens,1061782.622,Jackson Heights
19-Aug,36081027301,4027301,14064,54220,68284,Queens,1061782.622,Jackson Heights
21-Aug,36081027301,4027301,11977,81432,93409,Queens,1061782.622,Jackson Heights
19-May,36081027302,4027302,9890,56803,66693,Queens,1254853.349,Jackson Heights
21-May,36081027302,4027302,0,71,71,Queens,1254853.349,Jackson Heights
19-Jun,36081027302,4027302,8487,55929,64416,Queens,1254853.349,Jackson Heights
21-Jun,36081027302,4027302,6069,82784,88853,Queens,1254853.349,Jackson Heights
19-Jul,36081027302,4027302,6855,22585,29440,Queens,1254853.349,Jackson Heights
21-Jul,36081027302,4027302,8372,105436,113808,Queens,1254853.349,Jackson Heights
19-Aug,36081027302,4027302,11459,139942,151401,Queens,1254853.349,Jackson Heights
21-Aug,36081027302,4027302,12351,21521,33872,Queens,1254853.349,Jackson Heights
19-May,36081027400,4027400,13984,52065,66049,Queens,1546921.136,Baisley Park
21-May,36081027400,4027400,711,115759,116470,Queens,1546921.136,Baisley Park
19-Jun,36081027400,4027400,5778,34387,40165,Queens,1546921.136,Baisley Park
21-Jun,36081027400,4027400,11836,147515,159351,Queens,1546921.136,Baisley Park
19-Jul,36081027400,4027400,8888,102364,111252,Queens,1546921.136,Baisley Park
21-Jul,36081027400,4027400,14502,122578,137080,Queens,1546921.136,Baisley Park
19-Aug,36081027400,4027400,5249,84354,89603,Queens,1546921.136,Baisley Park
21-Aug,36081027400,4027400,1305,122620,123925,Queens,1546921.136,Baisley Park
19-May,36081027500,4027500,8422,152005,160427,Queens,1911640.099,Jackson Heights
21-May,36081027500,4027500,11621,45410,57031,Queens,1911640.099,Jackson Heights
19-Jun,36081027500,4027500,8695,66346,75041,Queens,1911640.099,Jackson Heights
21-Jun,36081027500,4027500,6742,161816,168558,Queens,1911640.099,Jackson Heights
19-Jul,36081027500,4027500,2577,61280,63857,Queens,1911640.099,Jackson Heights
21-Jul,36081027500,4027500,6632,97097,103729,Queens,1911640.099,Jackson Heights
19-Aug,36081027500,4027500,10062,55473,65535,Queens,1911640.099,Jackson Heights
21-Aug,36081027500,4027500,0,104641,104641,Queens,1911640.099,Jackson Heights
19-May,36081027600,4027600,13741,71826,85567,Queens,1708235.145,Baisley Park
21-May,36081027600,4027600,13946,43875,57821,Queens,1708235.145,Baisley Park
19-Jun,36081027600,4027600,12951,92580,105531,Queens,1708235.145,Baisley Park
21-Jun,36081027600,4027600,898,85569,86467,Queens,1708235.145,Baisley Park
19-Jul,36081027600,4027600,15157,126731,141888,Queens,1708235.145,Baisley Park
21-Jul,36081027600,4027600,16130,107590,123720,Queens,1708235.145,Baisley Park
19-Aug,36081027600,4027600,6426,94922,101348,Queens,1708235.145,Baisley Park
21-Aug,36081027600,4027600,16077,67891,83968,Queens,1708235.145,Baisley Park
19-May,36081027701,4027701,2842,68301,71143,Queens,793890.5598,Jackson Heights
21-May,36081027701,4027701,9211,46459,55670,Queens,793890.5598,Jackson Heights
19-Jun,36081027701,4027701,10966,102428,113394,Queens,793890.5598,Jackson Heights
21-Jun,36081027701,4027701,13369,54556,67925,Queens,793890.5598,Jackson Heights
19-Jul,36081027701,4027701,8000,60012,68012,Queens,793890.5598,Jackson Heights
21-Jul,36081027701,4027701,10665,27649,38314,Queens,793890.5598,Jackson Heights
19-Aug,36081027701,4027701,13594,41163,54757,Queens,793890.5598,Jackson Heights
21-Aug,36081027701,4027701,14998,51556,66554,Queens,793890.5598,Jackson Heights
19-May,36081027702,4027702,17058,4804,21862,Queens,1082232.839,Jackson Heights
21-May,36081027702,4027702,10713,92688,103401,Queens,1082232.839,Jackson Heights
19-Jun,36081027702,4027702,11553,88076,99629,Queens,1082232.839,Jackson Heights
21-Jun,36081027702,4027702,21602,44747,66349,Queens,1082232.839,Jackson Heights
19-Jul,36081027702,4027702,8216,48365,56581,Queens,1082232.839,Jackson Heights
21-Jul,36081027702,4027702,399,95744,96143,Queens,1082232.839,Jackson Heights
19-Aug,36081027702,4027702,3420,127369,130789,Queens,1082232.839,Jackson Heights
21-Aug,36081027702,4027702,5160,39547,44707,Queens,1082232.839,Jackson Heights
19-May,36081027800,4027800,7618,88221,95839,Queens,1887113.231,Baisley Park
21-May,36081027800,4027800,3311,10840,14151,Queens,1887113.231,Baisley Park
19-Jun,36081027800,4027800,2871,69247,72118,Queens,1887113.231,Baisley Park
21-Jun,36081027800,4027800,2866,55725,58591,Queens,1887113.231,Baisley Park
19-Jul,36081027800,4027800,18484,59728,78212,Queens,1887113.231,Baisley Park
21-Jul,36081027800,4027800,11280,75716,86996,Queens,1887113.231,Baisley Park
19-Aug,36081027800,4027800,13137,51272,64409,Queens,1887113.231,Baisley Park
21-Aug,36081027800,4027800,11416,112746,124162,Queens,1887113.231,Baisley Park
19-May,36081027900,4027900,10280,34941,45221,Queens,1913241.99,Jackson Heights
21-May,36081027900,4027900,12276,38729,51005,Queens,1913241.99,Jackson Heights
19-Jun,36081027900,4027900,8607,44113,52720,Queens,1913241.99,Jackson Heights
21-Jun,36081027900,4027900,3057,99496,102553,Queens,1913241.99,Jackson Heights
19-Jul,36081027900,4027900,0,102326,102326,Queens,1913241.99,Jackson Heights
21-Jul,36081027900,4027900,14527,43215,57742,Queens,1913241.99,Jackson Heights
19-Aug,36081027900,4027900,11837,98905,110742,Queens,1913241.99,Jackson Heights
21-Aug,36081027900,4027900,7562,88389,95951,Queens,1913241.99,Jackson Heights
19-May,36081028000,4028000,9733,106662,116395,Queens,1775383.299,Baisley Park
21-May,36081028000,4028000,5420,81002,86422,Queens,1775383.299,Baisley Park
19-Jun,36081028000,4028000,5765,59591,65356,Queens,1775383.299,Baisley Park
21-Jun,36081028000,4028000,1508,27873,29381,Queens,1775383.299,Baisley Park
19-Jul,36081028000,4028000,1328,27904,29232,Queens,1775383.299,Baisley Park
21-Jul,36081028000,4028000,13476,8199,21675,Queens,1775383.299,Baisley Park
19-Aug,36081028000,4028000,3645,94745,98390,Queens,1775383.299,Baisley Park
21-Aug,36081028000,4028000,8295,12987,21282,Queens,1775383.299,Baisley Park
19-May,36081028100,4028100,2453,48764,51217,Queens,1877449.656,Jackson Heights
21-May,36081028100,4028100,12640,89800,102440,Queens,1877449.656,Jackson Heights
19-Jun,36081028100,4028100,20769,129995,150764,Queens,1877449.656,Jackson Heights
21-Jun,36081028100,4028100,2154,46907,49061,Queens,1877449.656,Jackson Heights
19-Jul,36081028100,4028100,11053,75942,86995,Queens,1877449.656,Jackson Heights
21-Jul,36081028100,4028100,13736,14644,28380,Queens,1877449.656,Jackson Heights
19-Aug,36081028100,4028100,2645,102234,104879,Queens,1877449.656,Jackson Heights
21-Aug,36081028100,4028100,0,83894,83894,Queens,1877449.656,Jackson Heights
19-May,36081028200,4028200,12038,99448,111486,Queens,1960738.872,Baisley Park
21-May,36081028200,4028200,12955,66346,79301,Queens,1960738.872,Baisley Park
19-Jun,36081028200,4028200,8739,40923,49662,Queens,1960738.872,Baisley Park
21-Jun,36081028200,4028200,6194,101128,107322,Queens,1960738.872,Baisley Park
19-Jul,36081028200,4028200,10111,80716,90827,Queens,1960738.872,Baisley Park
21-Jul,36081028200,4028200,5493,89531,95024,Queens,1960738.872,Baisley Park
19-Aug,36081028200,4028200,6504,40857,47361,Queens,1960738.872,Baisley Park
21-Aug,36081028200,4028200,5732,70725,76457,Queens,1960738.872,Baisley Park
19-May,36081028300,4028300,12942,48563,61505,Queens,1913172.778,Jackson Heights
21-May,36081028300,4028300,6401,69463,75864,Queens,1913172.778,Jackson Heights
19-Jun,36081028300,4028300,4724,42270,46994,Queens,1913172.778,Jackson Heights
21-Jun,36081028300,4028300,11130,101502,112632,Queens,1913172.778,Jackson Heights
19-Jul,36081028300,4028300,7337,18250,25587,Queens,1913172.778,Jackson Heights
21-Jul,36081028300,4028300,18980,176668,195648,Queens,1913172.778,Jackson Heights
19-Aug,36081028300,4028300,5120,68365,73485,Queens,1913172.778,Jackson Heights
21-Aug,36081028300,4028300,13376,187481,200857,Queens,1913172.778,Jackson Heights
19-May,36081028400,4028400,0,32231,32231,Queens,4625514.524,Baisley Park
21-May,36081028400,4028400,0,17131,17131,Queens,4625514.524,Baisley Park
19-Jun,36081028400,4028400,0,31255,31255,Queens,4625514.524,Baisley Park
21-Jun,36081028400,4028400,8918,65926,74844,Queens,4625514.524,Baisley Park
19-Jul,36081028400,4028400,4183,113501,117684,Queens,4625514.524,Baisley Park
21-Jul,36081028400,4028400,12635,39735,52370,Queens,4625514.524,Baisley Park
19-Aug,36081028400,4028400,9262,2981,12243,Queens,4625514.524,Baisley Park
21-Aug,36081028400,4028400,5564,126668,132232,Queens,4625514.524,Baisley Park
19-May,36081028500,4028500,11682,71195,82877,Queens,1701419.417,Jackson Heights
21-May,36081028500,4028500,9062,39063,48125,Queens,1701419.417,Jackson Heights
19-Jun,36081028500,4028500,6623,14767,21390,Queens,1701419.417,Jackson Heights
21-Jun,36081028500,4028500,3811,42600,46411,Queens,1701419.417,Jackson Heights
19-Jul,36081028500,4028500,15558,81366,96924,Queens,1701419.417,Jackson Heights
21-Jul,36081028500,4028500,14397,117632,132029,Queens,1701419.417,Jackson Heights
19-Aug,36081028500,4028500,11396,78603,89999,Queens,1701419.417,Jackson Heights
21-Aug,36081028500,4028500,0,15009,15009,Queens,1701419.417,Jackson Heights
19-May,36081028700,4028700,13773,152944,166717,Queens,2104677.737,Jackson Heights
21-May,36081028700,4028700,8438,44466,52904,Queens,2104677.737,Jackson Heights
19-Jun,36081028700,4028700,4308,46078,50386,Queens,2104677.737,Jackson Heights
21-Jun,36081028700,4028700,10336,77039,87375,Queens,2104677.737,Jackson Heights
19-Jul,36081028700,4028700,3830,31939,35769,Queens,2104677.737,Jackson Heights
21-Jul,36081028700,4028700,8077,85005,93082,Queens,2104677.737,Jackson Heights
19-Aug,36081028700,4028700,15776,104599,120375,Queens,2104677.737,Jackson Heights
21-Aug,36081028700,4028700,5600,77966,83566,Queens,2104677.737,Jackson Heights
19-May,36081028801,4028801,253,45201,45454,Queens,2567424.27,Baisley Park
21-May,36081028801,4028801,18093,32988,51081,Queens,2567424.27,Baisley Park
19-Jun,36081028801,4028801,4722,88246,92968,Queens,2567424.27,Baisley Park
21-Jun,36081028801,4028801,5803,107398,113201,Queens,2567424.27,Baisley Park
19-Jul,36081028801,4028801,4867,125263,130130,Queens,2567424.27,Baisley Park
21-Jul,36081028801,4028801,10645,20240,30885,Queens,2567424.27,Baisley Park
19-Aug,36081028801,4028801,7073,28807,35880,Queens,2567424.27,Baisley Park
21-Aug,36081028801,4028801,10492,10769,21261,Queens,2567424.27,Baisley Park
19-May,36081028802,4028802,4985,73102,78087,Queens,2152636.102,Baisley Park
21-May,36081028802,4028802,3947,50451,54398,Queens,2152636.102,Baisley Park
19-Jun,36081028802,4028802,4894,14737,19631,Queens,2152636.102,Baisley Park
21-Jun,36081028802,4028802,2657,63847,66504,Queens,2152636.102,Baisley Park
19-Jul,36081028802,4028802,2438,88688,91126,Queens,2152636.102,Baisley Park
21-Jul,36081028802,4028802,7582,109602,117184,Queens,2152636.102,Baisley Park
19-Aug,36081028802,4028802,12379,134493,146872,Queens,2152636.102,Baisley Park
21-Aug,36081028802,4028802,6075,22281,28356,Queens,2152636.102,Baisley Park
19-May,36081028900,4028900,9492,76254,85746,Queens,1859020.478,Jackson Heights
21-May,36081028900,4028900,8755,87880,96635,Queens,1859020.478,Jackson Heights
19-Jun,36081028900,4028900,21817,131572,153389,Queens,1859020.478,Jackson Heights
21-Jun,36081028900,4028900,7773,14212,21985,Queens,1859020.478,Jackson Heights
19-Jul,36081028900,4028900,9367,47700,57067,Queens,1859020.478,Jackson Heights
21-Jul,36081028900,4028900,3417,71178,74595,Queens,1859020.478,Jackson Heights
19-Aug,36081028900,4028900,15122,141986,157108,Queens,1859020.478,Jackson Heights
21-Aug,36081028900,4028900,12643,100695,113338,Queens,1859020.478,Jackson Heights
19-May,36081030903,4030903,17098,48827,65925,Queens,3785831.218,Jackson Heights
21-May,36081030903,4030903,1655,104027,105682,Queens,3785831.218,Jackson Heights
19-Jun,36081030903,4030903,10577,104512,115089,Queens,3785831.218,Jackson Heights
21-Jun,36081030903,4030903,14937,76942,91879,Queens,3785831.218,Jackson Heights
19-Jul,36081030903,4030903,13919,78733,92652,Queens,3785831.218,Jackson Heights
21-Jul,36081030903,4030903,7856,48615,56471,Queens,3785831.218,Jackson Heights
19-Aug,36081030903,4030903,9232,120704,129936,Queens,3785831.218,Jackson Heights
21-Aug,36081030903,4030903,6913,67648,74561,Queens,3785831.218,Jackson Heights
19-May,36081032700,4032700,11924,33573,45497,Queens,1623732.643,Jackson Heights
21-May,36081032700,4032700,6909,56968,63877,Queens,1623732.643,Jackson Heights
19-Jun,36081032700,4032700,9233,89294,98527,Queens,1623732.643,Jackson Heights
21-Jun,36081032700,4032700,831,74474,75305,Queens,1623732.643,Jackson Heights
19-Jul,36081032700,4032700,1772,74789,76561,Queens,1623732.643,Jackson Heights
21-Jul,36081032700,4032700,17458,42562,60020,Queens,1623732.643,Jackson Heights
19-Aug,36081032700,4032700,9969,57655,67624,Queens,1623732.643,Jackson Heights
21-Aug,36081032700,4032700,15442,151061,166503,Queens,1623732.643,Jackson Heights
19-May,36081032800,4032800,11403,60508,71911,Queens,3949347.625,Laurelton
21-May,36081032800,4032800,10811,48855,59666,Queens,3949347.625,Laurelton
19-Jun,36081032800,4032800,3672,139157,142829,Queens,3949347.625,Laurelton
21-Jun,36081032800,4032800,0,98205,98205,Queens,3949347.625,Laurelton
19-Jul,36081032800,4032800,6296,925,7221,Queens,3949347.625,Laurelton
21-Jul,36081032800,4032800,7665,66570,74235,Queens,3949347.625,Laurelton
19-Aug,36081032800,4032800,9225,19483,28708,Queens,3949347.625,Laurelton
21-Aug,36081032800,4032800,6595,102802,109397,Queens,3949347.625,Laurelton
19-May,36081033000,4033000,14011,35814,49825,Queens,8815542.343,Springfield Gardens (North)-Rochdale Village
21-May,36081033000,4033000,11563,24247,35810,Queens,8815542.343,Springfield Gardens (North)-Rochdale Village
19-Jun,36081033000,4033000,253,150717,150970,Queens,8815542.343,Springfield Gardens (North)-Rochdale Village
21-Jun,36081033000,4033000,6812,53425,60237,Queens,8815542.343,Springfield Gardens (North)-Rochdale Village
19-Jul,36081033000,4033000,3883,74073,77956,Queens,8815542.343,Springfield Gardens (North)-Rochdale Village
21-Jul,36081033000,4033000,9947,70801,80748,Queens,8815542.343,Springfield Gardens (North)-Rochdale Village
19-Aug,36081033000,4033000,6275,87967,94242,Queens,8815542.343,Springfield Gardens (North)-Rochdale Village
21-Aug,36081033000,4033000,0,50811,50811,Queens,8815542.343,Springfield Gardens (North)-Rochdale Village
19-May,36081033401,4033401,9493,41213,50706,Queens,6035942.442,Springfield Gardens (North)-Rochdale Village
21-May,36081033401,4033401,4963,84953,89916,Queens,6035942.442,Springfield Gardens (North)-Rochdale Village
19-Jun,36081033401,4033401,10595,32348,42943,Queens,6035942.442,Springfield Gardens (North)-Rochdale Village
21-Jun,36081033401,4033401,12214,23033,35247,Queens,6035942.442,Springfield Gardens (North)-Rochdale Village
19-Jul,36081033401,4033401,7396,61904,69300,Queens,6035942.442,Springfield Gardens (North)-Rochdale Village
21-Jul,36081033401,4033401,2759,135532,138291,Queens,6035942.442,Springfield Gardens (North)-Rochdale Village
19-Aug,36081033401,4033401,16807,102753,119560,Queens,6035942.442,Springfield Gardens (North)-Rochdale Village
21-Aug,36081033401,4033401,7521,117104,124625,Queens,6035942.442,Springfield Gardens (North)-Rochdale Village
19-May,36081033403,4033403,15493,73122,88615,Queens,2720742.626,Springfield Gardens (North)-Rochdale Village
21-May,36081033403,4033403,3430,99498,102928,Queens,2720742.626,Springfield Gardens (North)-Rochdale Village
19-Jun,36081033403,4033403,11519,103529,115048,Queens,2720742.626,Springfield Gardens (North)-Rochdale Village
21-Jun,36081033403,4033403,10714,55168,65882,Queens,2720742.626,Springfield Gardens (North)-Rochdale Village
19-Jul,36081033403,4033403,9419,70656,80075,Queens,2720742.626,Springfield Gardens (North)-Rochdale Village
21-Jul,36081033403,4033403,4679,129287,133966,Queens,2720742.626,Springfield Gardens (North)-Rochdale Village
19-Aug,36081033403,4033403,14082,52139,66221,Queens,2720742.626,Springfield Gardens (North)-Rochdale Village
21-Aug,36081033403,4033403,11107,24253,35360,Queens,2720742.626,Springfield Gardens (North)-Rochdale Village
19-May,36081033404,4033404,10657,108933,119590,Queens,2473631.601,Springfield Gardens (North)-Rochdale Village
21-May,36081033404,4033404,15629,79894,95523,Queens,2473631.601,Springfield Gardens (North)-Rochdale Village
19-Jun,36081033404,4033404,7584,69809,77393,Queens,2473631.601,Springfield Gardens (North)-Rochdale Village
21-Jun,36081033404,4033404,3424,129434,132858,Queens,2473631.601,Springfield Gardens (North)-Rochdale Village
19-Jul,36081033404,4033404,14932,76862,91794,Queens,2473631.601,Springfield Gardens (North)-Rochdale Village
21-Jul,36081033404,4033404,2126,61870,63996,Queens,2473631.601,Springfield Gardens (North)-Rochdale Village
19-Aug,36081033404,4033404,8945,107380,116325,Queens,2473631.601,Springfield Gardens (North)-Rochdale Village
21-Aug,36081033404,4033404,5481,65522,71003,Queens,2473631.601,Springfield Gardens (North)-Rochdale Village
19-May,36081033405,4033405,3838,59569,63407,Queens,2959525.039,Springfield Gardens (North)-Rochdale Village
21-May,36081033405,4033405,16987,127195,144182,Queens,2959525.039,Springfield Gardens (North)-Rochdale Village
19-Jun,36081033405,4033405,9372,58535,67907,Queens,2959525.039,Springfield Gardens (North)-Rochdale Village
21-Jun,36081033405,4033405,0,72844,72844,Queens,2959525.039,Springfield Gardens (North)-Rochdale Village
19-Jul,36081033405,4033405,9346,106935,116281,Queens,2959525.039,Springfield Gardens (North)-Rochdale Village
21-Jul,36081033405,4033405,7595,73165,80760,Queens,2959525.039,Springfield Gardens (North)-Rochdale Village
19-Aug,36081033405,4033405,4021,58195,62216,Queens,2959525.039,Springfield Gardens (North)-Rochdale Village
21-Aug,36081033405,4033405,8124,108671,116795,Queens,2959525.039,Springfield Gardens (North)-Rochdale Village
19-May,36081033700,4033700,2009,129284,131293,Queens,1623669.197,Jackson Heights
21-May,36081033700,4033700,15797,122713,138510,Queens,1623669.197,Jackson Heights
19-Jun,36081033700,4033700,5753,47127,52880,Queens,1623669.197,Jackson Heights
21-Jun,36081033700,4033700,19643,63180,82823,Queens,1623669.197,Jackson Heights
19-Jul,36081033700,4033700,5467,38131,43598,Queens,1623669.197,Jackson Heights
21-Jul,36081033700,4033700,93,94731,94824,Queens,1623669.197,Jackson Heights
19-Aug,36081033700,4033700,12076,24134,36210,Queens,1623669.197,Jackson Heights
21-Aug,36081033700,4033700,9012,86664,95676,Queens,1623669.197,Jackson Heights
19-May,36081033900,4033900,14781,97509,112290,Queens,1623371.631,Jackson Heights
21-May,36081033900,4033900,4817,38327,43144,Queens,1623371.631,Jackson Heights
19-Jun,36081033900,4033900,17240,71,17311,Queens,1623371.631,Jackson Heights
21-Jun,36081033900,4033900,10719,55921,66640,Queens,1623371.631,Jackson Heights
19-Jul,36081033900,4033900,12942,71,13013,Queens,1623371.631,Jackson Heights
21-Jul,36081033900,4033900,10831,86068,96899,Queens,1623371.631,Jackson Heights
19-Aug,36081033900,4033900,10708,71110,81818,Queens,1623371.631,Jackson Heights
21-Aug,36081033900,4033900,1870,132441,134311,Queens,1623371.631,Jackson Heights
19-May,36081035100,4035100,9833,66538,76371,Queens,1498730.141,Jackson Heights
21-May,36081035100,4035100,8823,64643,73466,Queens,1498730.141,Jackson Heights
19-Jun,36081035100,4035100,6617,67410,74027,Queens,1498730.141,Jackson Heights
21-Jun,36081035100,4035100,12040,101024,113064,Queens,1498730.141,Jackson Heights
19-Jul,36081035100,4035100,7182,50154,57336,Queens,1498730.141,Jackson Heights
21-Jul,36081035100,4035100,14356,26612,40968,Queens,1498730.141,Jackson Heights
19-Aug,36081035100,4035100,4414,89795,94209,Queens,1498730.141,Jackson Heights
21-Aug,36081035100,4035100,5270,31271,36541,Queens,1498730.141,Jackson Heights
19-May,36081035200,4035200,12265,58021,70286,Queens,6514364.159,St. Albans
21-May,36081035200,4035200,9365,62696,72061,Queens,6514364.159,St. Albans
19-Jun,36081035200,4035200,6964,91748,98712,Queens,6514364.159,St. Albans
21-Jun,36081035200,4035200,16313,78868,95181,Queens,6514364.159,St. Albans
19-Jul,36081035200,4035200,8438,32286,40724,Queens,6514364.159,St. Albans
21-Jul,36081035200,4035200,16170,60395,76565,Queens,6514364.159,St. Albans
19-Aug,36081035200,4035200,11878,14965,26843,Queens,6514364.159,St. Albans
21-Aug,36081035200,4035200,19765,101030,120795,Queens,6514364.159,St. Albans
19-May,36081035300,4035300,5943,67113,73056,Queens,1670746.118,East Elmhurst
21-May,36081035300,4035300,10441,22932,33373,Queens,1670746.118,East Elmhurst
19-Jun,36081035300,4035300,6720,82124,88844,Queens,1670746.118,East Elmhurst
21-Jun,36081035300,4035300,61,112725,112786,Queens,1670746.118,East Elmhurst
19-Jul,36081035300,4035300,11509,86648,98157,Queens,1670746.118,East Elmhurst
21-Jul,36081035300,4035300,13467,118033,131500,Queens,1670746.118,East Elmhurst
19-Aug,36081035300,4035300,10924,63985,74909,Queens,1670746.118,East Elmhurst
21-Aug,36081035300,4035300,12268,72546,84814,Queens,1670746.118,East Elmhurst
19-May,36081035800,4035800,11593,93955,105548,Queens,5641713.927,Laurelton
21-May,36081035800,4035800,3906,71,3977,Queens,5641713.927,Laurelton
19-Jun,36081035800,4035800,16628,59302,75930,Queens,5641713.927,Laurelton
21-Jun,36081035800,4035800,11315,113035,124350,Queens,5641713.927,Laurelton
19-Jul,36081035800,4035800,5779,80368,86147,Queens,5641713.927,Laurelton
21-Jul,36081035800,4035800,0,46547,46547,Queens,5641713.927,Laurelton
19-Aug,36081035800,4035800,14011,102451,116462,Queens,5641713.927,Laurelton
21-Aug,36081035800,4035800,13060,34799,47859,Queens,5641713.927,Laurelton
19-May,36081036100,4036100,5906,5196,11102,Queens,1693935.004,East Elmhurst
21-May,36081036100,4036100,7810,78634,86444,Queens,1693935.004,East Elmhurst
19-Jun,36081036100,4036100,13740,15434,29174,Queens,1693935.004,East Elmhurst
21-Jun,36081036100,4036100,0,34649,34649,Queens,1693935.004,East Elmhurst
19-Jul,36081036100,4036100,7499,28059,35558,Queens,1693935.004,East Elmhurst
21-Jul,36081036100,4036100,6789,50505,57294,Queens,1693935.004,East Elmhurst
19-Aug,36081036100,4036100,8799,123537,132336,Queens,1693935.004,East Elmhurst
21-Aug,36081036100,4036100,4946,89673,94619,Queens,1693935.004,East Elmhurst
19-May,36081036300,4036300,8566,64617,73183,Queens,1449334.821,East Elmhurst
21-May,36081036300,4036300,5371,55119,60490,Queens,1449334.821,East Elmhurst
19-Jun,36081036300,4036300,8895,96945,105840,Queens,1449334.821,East Elmhurst
21-Jun,36081036300,4036300,5045,50473,55518,Queens,1449334.821,East Elmhurst
19-Jul,36081036300,4036300,4092,49997,54089,Queens,1449334.821,East Elmhurst
21-Jul,36081036300,4036300,8831,57879,66710,Queens,1449334.821,East Elmhurst
19-Aug,36081036300,4036300,0,87011,87011,Queens,1449334.821,East Elmhurst
21-Aug,36081036300,4036300,16054,69879,85933,Queens,1449334.821,East Elmhurst
19-May,36081036500,4036500,8869,60713,69582,Queens,1787985.173,East Elmhurst
21-May,36081036500,4036500,5705,117152,122857,Queens,1787985.173,East Elmhurst
19-Jun,36081036500,4036500,5315,66056,71371,Queens,1787985.173,East Elmhurst
21-Jun,36081036500,4036500,8162,94234,102396,Queens,1787985.173,East Elmhurst
19-Jul,36081036500,4036500,8523,50743,59266,Queens,1787985.173,East Elmhurst
21-Jul,36081036500,4036500,0,95690,95690,Queens,1787985.173,East Elmhurst
19-Aug,36081036500,4036500,3703,75108,78811,Queens,1787985.173,East Elmhurst
21-Aug,36081036500,4036500,5145,31615,36760,Queens,1787985.173,East Elmhurst
19-May,36081036600,4036600,7542,94914,102456,Queens,3986950.26,St. Albans
21-May,36081036600,4036600,4842,61899,66741,Queens,3986950.26,St. Albans
19-Jun,36081036600,4036600,17612,26725,44337,Queens,3986950.26,St. Albans
21-Jun,36081036600,4036600,11549,103146,114695,Queens,3986950.26,St. Albans
19-Jul,36081036600,4036600,6815,71,6886,Queens,3986950.26,St. Albans
21-Jul,36081036600,4036600,7423,141959,149382,Queens,3986950.26,St. Albans
19-Aug,36081036600,4036600,0,66820,66820,Queens,3986950.26,St. Albans
21-Aug,36081036600,4036600,6981,139376,146357,Queens,3986950.26,St. Albans
19-May,36081036700,4036700,10152,55297,65449,Queens,2109206.68,East Elmhurst
21-May,36081036700,4036700,2697,113165,115862,Queens,2109206.68,East Elmhurst
19-Jun,36081036700,4036700,10789,79346,90135,Queens,2109206.68,East Elmhurst
21-Jun,36081036700,4036700,0,71527,71527,Queens,2109206.68,East Elmhurst
19-Jul,36081036700,4036700,8968,8425,17393,Queens,2109206.68,East Elmhurst
21-Jul,36081036700,4036700,11234,72130,83364,Queens,2109206.68,East Elmhurst
19-Aug,36081036700,4036700,14686,128372,143058,Queens,2109206.68,East Elmhurst
21-Aug,36081036700,4036700,9966,81070,91036,Queens,2109206.68,East Elmhurst
19-May,36081036800,4036800,2150,46567,48717,Queens,2510060.477,St. Albans
21-May,36081036800,4036800,6281,76411,82692,Queens,2510060.477,St. Albans
19-Jun,36081036800,4036800,10009,90481,100490,Queens,2510060.477,St. Albans
21-Jun,36081036800,4036800,6064,31207,37271,Queens,2510060.477,St. Albans
19-Jul,36081036800,4036800,8485,90656,99141,Queens,2510060.477,St. Albans
21-Jul,36081036800,4036800,7505,70507,78012,Queens,2510060.477,St. Albans
19-Aug,36081036800,4036800,10069,70156,80225,Queens,2510060.477,St. Albans
21-Aug,36081036800,4036800,11309,126466,137775,Queens,2510060.477,St. Albans
19-May,36081037501,4037501,14490,44681,59171,Queens,571221.0672,Corona
21-May,36081037501,4037501,9164,90545,99709,Queens,571221.0672,Corona
19-Jun,36081037501,4037501,15103,46593,61696,Queens,571221.0672,Corona
21-Jun,36081037501,4037501,7203,78740,85943,Queens,571221.0672,Corona
19-Jul,36081037501,4037501,6641,123509,130150,Queens,571221.0672,Corona
21-Jul,36081037501,4037501,4062,50475,54537,Queens,571221.0672,Corona
19-Aug,36081037501,4037501,12900,85377,98277,Queens,571221.0672,Corona
21-Aug,36081037501,4037501,6800,103219,110019,Queens,571221.0672,Corona
19-May,36081037502,4037502,7211,74505,81716,Queens,1077902.411,North Corona
21-May,36081037502,4037502,11276,69581,80857,Queens,1077902.411,North Corona
19-Jun,36081037502,4037502,10448,61604,72052,Queens,1077902.411,North Corona
21-Jun,36081037502,4037502,3486,93863,97349,Queens,1077902.411,North Corona
19-Jul,36081037502,4037502,12901,89011,101912,Queens,1077902.411,North Corona
21-Jul,36081037502,4037502,13779,49053,62832,Queens,1077902.411,North Corona
19-Aug,36081037502,4037502,5583,104267,109850,Queens,1077902.411,North Corona
21-Aug,36081037502,4037502,2433,57645,60078,Queens,1077902.411,North Corona
19-May,36081037600,4037600,8041,96582,104623,Queens,8281319.767,St. Albans
21-May,36081037600,4037600,9004,39838,48842,Queens,8281319.767,St. Albans
19-Jun,36081037600,4037600,6423,45546,51969,Queens,8281319.767,St. Albans
21-Jun,36081037600,4037600,6073,132575,138648,Queens,8281319.767,St. Albans
19-Jul,36081037600,4037600,4772,68573,73345,Queens,8281319.767,St. Albans
21-Jul,36081037600,4037600,11349,83288,94637,Queens,8281319.767,St. Albans
19-Aug,36081037600,4037600,4495,1165,5660,Queens,8281319.767,St. Albans
21-Aug,36081037600,4037600,14846,148279,163125,Queens,8281319.767,St. Albans
19-May,36081037700,4037700,10962,68161,79123,Queens,1580389.314,North Corona
21-May,36081037700,4037700,4359,60338,64697,Queens,1580389.314,North Corona
19-Jun,36081037700,4037700,11167,65260,76427,Queens,1580389.314,North Corona
21-Jun,36081037700,4037700,9895,35268,45163,Queens,1580389.314,North Corona
19-Jul,36081037700,4037700,7099,33516,40615,Queens,1580389.314,North Corona
21-Jul,36081037700,4037700,10326,60375,70701,Queens,1580389.314,North Corona
19-Aug,36081037700,4037700,6552,64710,71262,Queens,1580389.314,North Corona
21-Aug,36081037700,4037700,14078,80077,94155,Queens,1580389.314,North Corona
19-May,36081037900,4037900,9589,106500,116089,Queens,2120846.495,North Corona
21-May,36081037900,4037900,12966,76096,89062,Queens,2120846.495,North Corona
19-Jun,36081037900,4037900,13386,65755,79141,Queens,2120846.495,North Corona
21-Jun,36081037900,4037900,9702,82472,92174,Queens,2120846.495,North Corona
19-Jul,36081037900,4037900,11307,42540,53847,Queens,2120846.495,North Corona
21-Jul,36081037900,4037900,4855,83182,88037,Queens,2120846.495,North Corona
19-Aug,36081037900,4037900,1037,61601,62638,Queens,2120846.495,North Corona
21-Aug,36081037900,4037900,11806,134528,146334,Queens,2120846.495,North Corona
19-May,36081038301,4038301,15021,109654,124675,Queens,6410554.233,Flushing-Willets Point
21-May,36081038301,4038301,20152,55588,75740,Queens,6410554.233,Flushing-Willets Point
19-Jun,36081038301,4038301,14272,27492,41764,Queens,6410554.233,Flushing-Willets Point
21-Jun,36081038301,4038301,5161,65485,70646,Queens,6410554.233,Flushing-Willets Point
19-Jul,36081038301,4038301,1712,29144,30856,Queens,6410554.233,Flushing-Willets Point
21-Jul,36081038301,4038301,6596,30168,36764,Queens,6410554.233,Flushing-Willets Point
19-Aug,36081038301,4038301,14256,149205,163461,Queens,6410554.233,Flushing-Willets Point
21-Aug,36081038301,4038301,12888,58847,71735,Queens,6410554.233,Flushing-Willets Point
19-May,36081038400,4038400,13671,49535,63206,Queens,3206706.309,St. Albans
21-May,36081038400,4038400,9404,125569,134973,Queens,3206706.309,St. Albans
19-Jun,36081038400,4038400,9450,7981,17431,Queens,3206706.309,St. Albans
21-Jun,36081038400,4038400,5665,94665,100330,Queens,3206706.309,St. Albans
19-Jul,36081038400,4038400,10578,27544,38122,Queens,3206706.309,St. Albans
21-Jul,36081038400,4038400,6721,75226,81947,Queens,3206706.309,St. Albans
19-Aug,36081038400,4038400,11374,89958,101332,Queens,3206706.309,St. Albans
21-Aug,36081038400,4038400,10422,43808,54230,Queens,3206706.309,St. Albans
19-May,36081039400,4039400,8728,154256,162984,Queens,3749393.938,St. Albans
21-May,36081039400,4039400,9958,57553,67511,Queens,3749393.938,St. Albans
19-Jun,36081039400,4039400,7102,54907,62009,Queens,3749393.938,St. Albans
21-Jun,36081039400,4039400,5589,1470,7059,Queens,3749393.938,St. Albans
19-Jul,36081039400,4039400,14521,11721,26242,Queens,3749393.938,St. Albans
21-Jul,36081039400,4039400,18950,68571,87521,Queens,3749393.938,St. Albans
19-Aug,36081039400,4039400,20205,132235,152440,Queens,3749393.938,St. Albans
21-Aug,36081039400,4039400,9157,61530,70687,Queens,3749393.938,St. Albans
19-May,36081039800,4039800,6348,103307,109655,Queens,2161239.824,St. Albans
21-May,36081039800,4039800,12216,33773,45989,Queens,2161239.824,St. Albans
19-Jun,36081039800,4039800,12848,105527,118375,Queens,2161239.824,St. Albans
21-Jun,36081039800,4039800,9115,98814,107929,Queens,2161239.824,St. Albans
19-Jul,36081039800,4039800,11900,86307,98207,Queens,2161239.824,St. Albans
21-Jul,36081039800,4039800,6451,44262,50713,Queens,2161239.824,St. Albans
19-Aug,36081039800,4039800,3107,76767,79874,Queens,2161239.824,St. Albans
21-Aug,36081039800,4039800,14193,12379,26572,Queens,2161239.824,St. Albans
19-May,36081039901,4039901,9716,90961,100677,Queens,1135029.447,Corona
21-May,36081039901,4039901,858,84420,85278,Queens,1135029.447,Corona
19-Jun,36081039901,4039901,685,40459,41144,Queens,1135029.447,Corona
21-Jun,36081039901,4039901,6405,74851,81256,Queens,1135029.447,Corona
19-Jul,36081039901,4039901,1661,120010,121671,Queens,1135029.447,Corona
21-Jul,36081039901,4039901,7757,50479,58236,Queens,1135029.447,Corona
19-Aug,36081039901,4039901,11487,42698,54185,Queens,1135029.447,Corona
21-Aug,36081039901,4039901,7598,113987,121585,Queens,1135029.447,Corona
19-May,36081039902,4039902,7499,75113,82612,Queens,681525.4007,North Corona
21-May,36081039902,4039902,4011,51005,55016,Queens,681525.4007,North Corona
19-Jun,36081039902,4039902,8824,82188,91012,Queens,681525.4007,North Corona
21-Jun,36081039902,4039902,8028,109156,117184,Queens,681525.4007,North Corona
19-Jul,36081039902,4039902,9771,97045,106816,Queens,681525.4007,North Corona
21-Jul,36081039902,4039902,4189,107781,111970,Queens,681525.4007,North Corona
19-Aug,36081039902,4039902,10526,73483,84009,Queens,681525.4007,North Corona
21-Aug,36081039902,4039902,5342,73861,79203,Queens,681525.4007,North Corona
19-May,36081040000,4040000,13676,27657,41333,Queens,2112654.215,St. Albans
21-May,36081040000,4040000,2678,126843,129521,Queens,2112654.215,St. Albans
19-Jun,36081040000,4040000,5011,52368,57379,Queens,2112654.215,St. Albans
21-Jun,36081040000,4040000,11123,43412,54535,Queens,2112654.215,St. Albans
19-Jul,36081040000,4040000,3779,89943,93722,Queens,2112654.215,St. Albans
21-Jul,36081040000,4040000,9098,133492,142590,Queens,2112654.215,St. Albans
19-Aug,36081040000,4040000,21118,65283,86401,Queens,2112654.215,St. Albans
21-Aug,36081040000,4040000,10217,63867,74084,Queens,2112654.215,St. Albans
19-May,36081040101,4040101,6676,79308,85984,Queens,931363.8754,Corona
21-May,36081040101,4040101,1275,143038,144313,Queens,931363.8754,Corona
19-Jun,36081040101,4040101,8525,82030,90555,Queens,931363.8754,Corona
21-Jun,36081040101,4040101,15445,75281,90726,Queens,931363.8754,Corona
19-Jul,36081040101,4040101,8977,24117,33094,Queens,931363.8754,Corona
21-Jul,36081040101,4040101,6543,121665,128208,Queens,931363.8754,Corona
19-Aug,36081040101,4040101,1415,47368,48783,Queens,931363.8754,Corona
21-Aug,36081040101,4040101,13950,10834,24784,Queens,931363.8754,Corona
19-May,36081040200,4040200,4913,79414,84327,Queens,2352448.88,St. Albans
21-May,36081040200,4040200,0,61313,61313,Queens,2352448.88,St. Albans
19-Jun,36081040200,4040200,2815,48911,51726,Queens,2352448.88,St. Albans
21-Jun,36081040200,4040200,3608,68623,72231,Queens,2352448.88,St. Albans
19-Jul,36081040200,4040200,12260,53851,66111,Queens,2352448.88,St. Albans
21-Jul,36081040200,4040200,14779,10390,25169,Queens,2352448.88,St. Albans
19-Aug,36081040200,4040200,9894,62780,72674,Queens,2352448.88,St. Albans
21-Aug,36081040200,4040200,4388,82274,86662,Queens,2352448.88,St. Albans
19-May,36081040301,4040301,13633,24594,38227,Queens,940100.8716,Corona
21-May,36081040301,4040301,2393,91229,93622,Queens,940100.8716,Corona
19-Jun,36081040301,4040301,10164,92974,103138,Queens,940100.8716,Corona
21-Jun,36081040301,4040301,6874,73088,79962,Queens,940100.8716,Corona
19-Jul,36081040301,4040301,11022,37011,48033,Queens,940100.8716,Corona
21-Jul,36081040301,4040301,9669,139745,149414,Queens,940100.8716,Corona
19-Aug,36081040301,4040301,4333,184061,188394,Queens,940100.8716,Corona
21-Aug,36081040301,4040301,15582,20977,36559,Queens,940100.8716,Corona
19-May,36081040302,4040302,3364,27059,30423,Queens,1197294.403,North Corona
21-May,36081040302,4040302,12302,107603,119905,Queens,1197294.403,North Corona
19-Jun,36081040302,4040302,6659,40559,47218,Queens,1197294.403,North Corona
21-Jun,36081040302,4040302,12366,16805,29171,Queens,1197294.403,North Corona
19-Jul,36081040302,4040302,17243,52192,69435,Queens,1197294.403,North Corona
21-Jul,36081040302,4040302,14107,32925,47032,Queens,1197294.403,North Corona
19-Aug,36081040302,4040302,2958,41439,44397,Queens,1197294.403,North Corona
21-Aug,36081040302,4040302,17931,88672,106603,Queens,1197294.403,North Corona
19-May,36081040400,4040400,0,98997,98997,Queens,5092779.326,St. Albans
21-May,36081040400,4040400,8014,84506,92520,Queens,5092779.326,St. Albans
19-Jun,36081040400,4040400,4808,109216,114024,Queens,5092779.326,St. Albans
21-Jun,36081040400,4040400,7027,27498,34525,Queens,5092779.326,St. Albans
19-Jul,36081040400,4040400,9549,99825,109374,Queens,5092779.326,St. Albans
21-Jul,36081040400,4040400,7449,111571,119020,Queens,5092779.326,St. Albans
19-Aug,36081040400,4040400,6937,93223,100160,Queens,5092779.326,St. Albans
21-Aug,36081040400,4040400,7396,89088,96484,Queens,5092779.326,St. Albans
19-May,36081040501,4040501,3515,59134,62649,Queens,769154.1435,Corona
21-May,36081040501,4040501,10516,104021,114537,Queens,769154.1435,Corona
19-Jun,36081040501,4040501,974,113862,114836,Queens,769154.1435,Corona
21-Jun,36081040501,4040501,14456,67802,82258,Queens,769154.1435,Corona
19-Jul,36081040501,4040501,5193,127661,132854,Queens,769154.1435,Corona
21-Jul,36081040501,4040501,8412,62959,71371,Queens,769154.1435,Corona
19-Aug,36081040501,4040501,10285,77208,87493,Queens,769154.1435,Corona
21-Aug,36081040501,4040501,904,82566,83470,Queens,769154.1435,Corona
19-May,36081040502,4040502,6852,13416,20268,Queens,624443.9753,North Corona
21-May,36081040502,4040502,19887,78793,98680,Queens,624443.9753,North Corona
19-Jun,36081040502,4040502,0,80535,80535,Queens,624443.9753,North Corona
21-Jun,36081040502,4040502,13211,91925,105136,Queens,624443.9753,North Corona
19-Jul,36081040502,4040502,11231,127697,138928,Queens,624443.9753,North Corona
21-Jul,36081040502,4040502,2310,57472,59782,Queens,624443.9753,North Corona
19-Aug,36081040502,4040502,784,71,855,Queens,624443.9753,North Corona
21-Aug,36081040502,4040502,6187,62120,68307,Queens,624443.9753,North Corona
19-May,36081040701,4040701,5700,90275,95975,Queens,758360.6355,Corona
21-May,36081040701,4040701,6697,87581,94278,Queens,758360.6355,Corona
19-Jun,36081040701,4040701,0,94130,94130,Queens,758360.6355,Corona
21-Jun,36081040701,4040701,964,45420,46384,Queens,758360.6355,Corona
19-Jul,36081040701,4040701,5516,127205,132721,Queens,758360.6355,Corona
21-Jul,36081040701,4040701,8948,31075,40023,Queens,758360.6355,Corona
19-Aug,36081040701,4040701,14107,189125,203232,Queens,758360.6355,Corona
21-Aug,36081040701,4040701,8861,56777,65638,Queens,758360.6355,Corona
19-May,36081040702,4040702,7976,43853,51829,Queens,1389413.93,North Corona
21-May,36081040702,4040702,8289,53256,61545,Queens,1389413.93,North Corona
19-Jun,36081040702,4040702,2082,71,2153,Queens,1389413.93,North Corona
21-Jun,36081040702,4040702,4109,67091,71200,Queens,1389413.93,North Corona
19-Jul,36081040702,4040702,0,47057,47057,Queens,1389413.93,North Corona
21-Jul,36081040702,4040702,0,62973,62973,Queens,1389413.93,North Corona
19-Aug,36081040702,4040702,4865,114015,118880,Queens,1389413.93,North Corona
21-Aug,36081040702,4040702,4109,47468,51577,Queens,1389413.93,North Corona
19-May,36081041100,4041100,9925,78795,88720,Queens,1481730.538,Corona
21-May,36081041100,4041100,9516,56172,65688,Queens,1481730.538,Corona
19-Jun,36081041100,4041100,6659,82983,89642,Queens,1481730.538,Corona
21-Jun,36081041100,4041100,10731,71,10802,Queens,1481730.538,Corona
19-Jul,36081041100,4041100,2477,18281,20758,Queens,1481730.538,Corona
21-Jul,36081041100,4041100,21820,68563,90383,Queens,1481730.538,Corona
19-Aug,36081041100,4041100,4666,91256,95922,Queens,1481730.538,Corona
21-Aug,36081041100,4041100,8366,83693,92059,Queens,1481730.538,Corona
19-May,36081041300,4041300,3891,148122,152013,Queens,1709061.342,Corona
21-May,36081041300,4041300,13785,28129,41914,Queens,1709061.342,Corona
19-Jun,36081041300,4041300,13422,57923,71345,Queens,1709061.342,Corona
21-Jun,36081041300,4041300,3745,58749,62494,Queens,1709061.342,Corona
19-Jul,36081041300,4041300,7277,33626,40903,Queens,1709061.342,Corona
21-Jul,36081041300,4041300,15423,139553,154976,Queens,1709061.342,Corona
19-Aug,36081041300,4041300,1472,69384,70856,Queens,1709061.342,Corona
21-Aug,36081041300,4041300,17181,71629,88810,Queens,1709061.342,Corona
19-May,36081041400,4041400,5721,123821,129542,Queens,5132816.574,South Jamaica
21-May,36081041400,4041400,7703,167257,174960,Queens,5132816.574,South Jamaica
19-Jun,36081041400,4041400,4285,62045,66330,Queens,5132816.574,South Jamaica
21-Jun,36081041400,4041400,6684,73811,80495,Queens,5132816.574,South Jamaica
19-Jul,36081041400,4041400,7595,11038,18633,Queens,5132816.574,South Jamaica
21-Jul,36081041400,4041400,5892,57839,63731,Queens,5132816.574,South Jamaica
19-Aug,36081041400,4041400,11229,32292,43521,Queens,5132816.574,South Jamaica
21-Aug,36081041400,4041400,1305,12436,13741,Queens,5132816.574,South Jamaica
19-May,36081041500,4041500,3229,44626,47855,Queens,1866262.239,Corona
21-May,36081041500,4041500,7099,134518,141617,Queens,1866262.239,Corona
19-Jun,36081041500,4041500,10130,33972,44102,Queens,1866262.239,Corona
21-Jun,36081041500,4041500,12073,101725,113798,Queens,1866262.239,Corona
19-Jul,36081041500,4041500,1026,66792,67818,Queens,1866262.239,Corona
21-Jul,36081041500,4041500,10118,9738,19856,Queens,1866262.239,Corona
19-Aug,36081041500,4041500,11591,81903,93494,Queens,1866262.239,Corona
21-Aug,36081041500,4041500,7748,69891,77639,Queens,1866262.239,Corona
19-May,36081042700,4042700,7487,91526,99013,Queens,1838967.622,Corona
21-May,36081042700,4042700,9008,59501,68509,Queens,1838967.622,Corona
19-Jun,36081042700,4042700,13101,35143,48244,Queens,1838967.622,Corona
21-Jun,36081042700,4042700,1491,91850,93341,Queens,1838967.622,Corona
19-Jul,36081042700,4042700,8500,150068,158568,Queens,1838967.622,Corona
21-Jul,36081042700,4042700,13775,45274,59049,Queens,1838967.622,Corona
19-Aug,36081042700,4042700,8908,132530,141438,Queens,1838967.622,Corona
21-Aug,36081042700,4042700,6591,24751,31342,Queens,1838967.622,Corona
19-May,36081043701,4043701,15956,117074,133030,Queens,1578002.255,Corona
21-May,36081043701,4043701,16395,84463,100858,Queens,1578002.255,Corona
19-Jun,36081043701,4043701,12534,39678,52212,Queens,1578002.255,Corona
21-Jun,36081043701,4043701,1084,119992,121076,Queens,1578002.255,Corona
19-Jul,36081043701,4043701,13699,82434,96133,Queens,1578002.255,Corona
21-Jul,36081043701,4043701,3186,791,3977,Queens,1578002.255,Corona
19-Aug,36081043701,4043701,4370,98532,102902,Queens,1578002.255,Corona
21-Aug,36081043701,4043701,10472,34794,45266,Queens,1578002.255,Corona
19-May,36081043702,4043702,6163,156193,162356,Queens,1886326.407,Corona
21-May,36081043702,4043702,5685,86109,91794,Queens,1886326.407,Corona
19-Jun,36081043702,4043702,11167,163458,174625,Queens,1886326.407,Corona
21-Jun,36081043702,4043702,12804,14371,27175,Queens,1886326.407,Corona
19-Jul,36081043702,4043702,7313,105010,112323,Queens,1886326.407,Corona
21-Jul,36081043702,4043702,14650,74606,89256,Queens,1886326.407,Corona
19-Aug,36081043702,4043702,16533,146184,162717,Queens,1886326.407,Corona
21-Aug,36081043702,4043702,14305,103352,117657,Queens,1886326.407,Corona
19-May,36081043900,4043900,13323,71094,84417,Queens,1772849.165,Corona
21-May,36081043900,4043900,14008,51433,65441,Queens,1772849.165,Corona
19-Jun,36081043900,4043900,5256,122356,127612,Queens,1772849.165,Corona
21-Jun,36081043900,4043900,15320,49150,64470,Queens,1772849.165,Corona
19-Jul,36081043900,4043900,12674,102784,115458,Queens,1772849.165,Corona
21-Jul,36081043900,4043900,5679,71,5750,Queens,1772849.165,Corona
19-Aug,36081043900,4043900,0,54396,54396,Queens,1772849.165,Corona
21-Aug,36081043900,4043900,12783,135678,148461,Queens,1772849.165,Corona
19-May,36081044000,4044000,4897,89553,94450,Queens,4055561.059,South Jamaica
21-May,36081044000,4044000,1960,98230,100190,Queens,4055561.059,South Jamaica
19-Jun,36081044000,4044000,0,49258,49258,Queens,4055561.059,South Jamaica
21-Jun,36081044000,4044000,7551,86874,94425,Queens,4055561.059,South Jamaica
19-Jul,36081044000,4044000,15705,29441,45146,Queens,4055561.059,South Jamaica
21-Jul,36081044000,4044000,13426,52156,65582,Queens,4055561.059,South Jamaica
19-Aug,36081044000,4044000,2324,51174,53498,Queens,4055561.059,South Jamaica
21-Aug,36081044000,4044000,7848,142744,150592,Queens,4055561.059,South Jamaica
19-May,36081044301,4044301,4407,118486,122893,Queens,1437697.824,Corona
21-May,36081044301,4044301,4213,65629,69842,Queens,1437697.824,Corona
19-Jun,36081044301,4044301,1083,69196,70279,Queens,1437697.824,Corona
21-Jun,36081044301,4044301,7738,11697,19435,Queens,1437697.824,Corona
19-Jul,36081044301,4044301,2731,56823,59554,Queens,1437697.824,Corona
21-Jul,36081044301,4044301,7302,115222,122524,Queens,1437697.824,Corona
19-Aug,36081044301,4044301,9573,75870,85443,Queens,1437697.824,Corona
21-Aug,36081044301,4044301,10883,71,10954,Queens,1437697.824,Corona
19-May,36081044302,4044302,1746,38718,40464,Queens,2992542.452,Corona
21-May,36081044302,4044302,8897,20368,29265,Queens,2992542.452,Corona
19-Jun,36081044302,4044302,12274,82155,94429,Queens,2992542.452,Corona
21-Jun,36081044302,4044302,11166,59458,70624,Queens,2992542.452,Corona
19-Jul,36081044302,4044302,13314,43913,57227,Queens,2992542.452,Corona
21-Jul,36081044302,4044302,8144,86513,94657,Queens,2992542.452,Corona
19-Aug,36081044302,4044302,3399,110576,113975,Queens,2992542.452,Corona
21-Aug,36081044302,4044302,0,63437,63437,Queens,2992542.452,Corona
19-May,36081044400,4044400,13640,21798,35438,Queens,9708089.706,Jamaica
21-May,36081044400,4044400,13078,65868,78946,Queens,9708089.706,Jamaica
19-Jun,36081044400,4044400,13902,49576,63478,Queens,9708089.706,Jamaica
21-Jun,36081044400,4044400,4428,102432,106860,Queens,9708089.706,Jamaica
19-Jul,36081044400,4044400,10036,72984,83020,Queens,9708089.706,Jamaica
21-Jul,36081044400,4044400,8462,24169,32631,Queens,9708089.706,Jamaica
19-Aug,36081044400,4044400,8282,68223,76505,Queens,9708089.706,Jamaica
21-Aug,36081044400,4044400,9462,21305,30767,Queens,9708089.706,Jamaica
19-May,36081044601,4044601,13102,139812,152914,Queens,2419639.035,Jamaica
21-May,36081044601,4044601,11144,71,11215,Queens,2419639.035,Jamaica
19-Jun,36081044601,4044601,12798,69299,82097,Queens,2419639.035,Jamaica
21-Jun,36081044601,4044601,0,4546,4546,Queens,2419639.035,Jamaica
19-Jul,36081044601,4044601,11836,53478,65314,Queens,2419639.035,Jamaica
21-Jul,36081044601,4044601,7989,58842,66831,Queens,2419639.035,Jamaica
19-Aug,36081044601,4044601,2331,18062,20393,Queens,2419639.035,Jamaica
21-Aug,36081044601,4044601,0,78317,78317,Queens,2419639.035,Jamaica
19-May,36081044602,4044602,3798,108531,112329,Queens,1830580.374,Jamaica
21-May,36081044602,4044602,855,50291,51146,Queens,1830580.374,Jamaica
19-Jun,36081044602,4044602,8340,88050,96390,Queens,1830580.374,Jamaica
21-Jun,36081044602,4044602,0,119517,119517,Queens,1830580.374,Jamaica
19-Jul,36081044602,4044602,13832,144264,158096,Queens,1830580.374,Jamaica
21-Jul,36081044602,4044602,2692,62716,65408,Queens,1830580.374,Jamaica
19-Aug,36081044602,4044602,2506,43420,45926,Queens,1830580.374,Jamaica
21-Aug,36081044602,4044602,16804,148597,165401,Queens,1830580.374,Jamaica
19-May,36081044800,4044800,13300,61180,74480,Queens,2240965.787,Jamaica Hills-Briarwood
21-May,36081044800,4044800,11103,24090,35193,Queens,2240965.787,Jamaica Hills-Briarwood
19-Jun,36081044800,4044800,6311,50447,56758,Queens,2240965.787,Jamaica Hills-Briarwood
21-Jun,36081044800,4044800,9434,157487,166921,Queens,2240965.787,Jamaica Hills-Briarwood
19-Jul,36081044800,4044800,11767,53657,65424,Queens,2240965.787,Jamaica Hills-Briarwood
21-Jul,36081044800,4044800,4296,64274,68570,Queens,2240965.787,Jamaica Hills-Briarwood
19-Aug,36081044800,4044800,14006,130533,144539,Queens,2240965.787,Jamaica Hills-Briarwood
21-Aug,36081044800,4044800,5435,71,5506,Queens,2240965.787,Jamaica Hills-Briarwood
19-May,36081045000,4045000,14539,74592,89131,Queens,1889459.322,Jamaica Hills-Briarwood
21-May,36081045000,4045000,215,93975,94190,Queens,1889459.322,Jamaica Hills-Briarwood
19-Jun,36081045000,4045000,4994,162170,167164,Queens,1889459.322,Jamaica Hills-Briarwood
21-Jun,36081045000,4045000,7596,85098,92694,Queens,1889459.322,Jamaica Hills-Briarwood
19-Jul,36081045000,4045000,15001,77422,92423,Queens,1889459.322,Jamaica Hills-Briarwood
21-Jul,36081045000,4045000,15641,65812,81453,Queens,1889459.322,Jamaica Hills-Briarwood
19-Aug,36081045000,4045000,5726,101227,106953,Queens,1889459.322,Jamaica Hills-Briarwood
21-Aug,36081045000,4045000,5129,79093,84222,Queens,1889459.322,Jamaica Hills-Briarwood
19-May,36081045600,4045600,2911,82258,85169,Queens,1744395.643,Jamaica Hills-Briarwood
21-May,36081045600,4045600,9745,90671,100416,Queens,1744395.643,Jamaica Hills-Briarwood
19-Jun,36081045600,4045600,6534,97394,103928,Queens,1744395.643,Jamaica Hills-Briarwood
21-Jun,36081045600,4045600,3899,23984,27883,Queens,1744395.643,Jamaica Hills-Briarwood
19-Jul,36081045600,4045600,3422,125826,129248,Queens,1744395.643,Jamaica Hills-Briarwood
21-Jul,36081045600,4045600,8004,92548,100552,Queens,1744395.643,Jamaica Hills-Briarwood
19-Aug,36081045600,4045600,8460,69214,77674,Queens,1744395.643,Jamaica Hills-Briarwood
21-Aug,36081045600,4045600,4101,132623,136724,Queens,1744395.643,Jamaica Hills-Briarwood
19-May,36081045700,4045700,5951,69435,75386,Queens,1620253.942,Elmhurst
21-May,36081045700,4045700,8065,36839,44904,Queens,1620253.942,Elmhurst
19-Jun,36081045700,4045700,5048,130507,135555,Queens,1620253.942,Elmhurst
21-Jun,36081045700,4045700,9977,93800,103777,Queens,1620253.942,Elmhurst
19-Jul,36081045700,4045700,11384,72443,83827,Queens,1620253.942,Elmhurst
21-Jul,36081045700,4045700,2039,96300,98339,Queens,1620253.942,Elmhurst
19-Aug,36081045700,4045700,11682,127454,139136,Queens,1620253.942,Elmhurst
21-Aug,36081045700,4045700,8857,50069,58926,Queens,1620253.942,Elmhurst
19-May,36081045900,4045900,14263,78208,92471,Queens,1473337.182,Elmhurst
21-May,36081045900,4045900,5190,46463,51653,Queens,1473337.182,Elmhurst
19-Jun,36081045900,4045900,8166,123343,131509,Queens,1473337.182,Elmhurst
21-Jun,36081045900,4045900,9033,104754,113787,Queens,1473337.182,Elmhurst
19-Jul,36081045900,4045900,10386,37342,47728,Queens,1473337.182,Elmhurst
21-Jul,36081045900,4045900,12073,91126,103199,Queens,1473337.182,Elmhurst
19-Aug,36081045900,4045900,12871,87991,100862,Queens,1473337.182,Elmhurst
21-Aug,36081045900,4045900,6729,64934,71663,Queens,1473337.182,Elmhurst
19-May,36081046000,4046000,15602,65428,81030,Queens,2381695.25,Jamaica
21-May,36081046000,4046000,0,67725,67725,Queens,2381695.25,Jamaica
19-Jun,36081046000,4046000,14609,114701,129310,Queens,2381695.25,Jamaica
21-Jun,36081046000,4046000,16453,107426,123879,Queens,2381695.25,Jamaica
19-Jul,36081046000,4046000,11869,73625,85494,Queens,2381695.25,Jamaica
21-Jul,36081046000,4046000,11436,74829,86265,Queens,2381695.25,Jamaica
19-Aug,36081046000,4046000,4312,34910,39222,Queens,2381695.25,Jamaica
21-Aug,36081046000,4046000,19501,83500,103001,Queens,2381695.25,Jamaica
19-May,36081046100,4046100,1767,81349,83116,Queens,1226622.505,Elmhurst
21-May,36081046100,4046100,15089,85422,100511,Queens,1226622.505,Elmhurst
19-Jun,36081046100,4046100,8278,71,8349,Queens,1226622.505,Elmhurst
21-Jun,36081046100,4046100,14103,73174,87277,Queens,1226622.505,Elmhurst
19-Jul,36081046100,4046100,12646,61126,73772,Queens,1226622.505,Elmhurst
21-Jul,36081046100,4046100,3352,113964,117316,Queens,1226622.505,Elmhurst
19-Aug,36081046100,4046100,0,86076,86076,Queens,1226622.505,Elmhurst
21-Aug,36081046100,4046100,4453,38820,43273,Queens,1226622.505,Elmhurst
19-May,36081046400,4046400,2499,38836,41335,Queens,2470140.257,Jamaica Estates-Holliswood
21-May,36081046400,4046400,7886,25915,33801,Queens,2470140.257,Jamaica Estates-Holliswood
19-Jun,36081046400,4046400,3982,66391,70373,Queens,2470140.257,Jamaica Estates-Holliswood
21-Jun,36081046400,4046400,2381,35408,37789,Queens,2470140.257,Jamaica Estates-Holliswood
19-Jul,36081046400,4046400,10398,76144,86542,Queens,2470140.257,Jamaica Estates-Holliswood
21-Jul,36081046400,4046400,11931,77988,89919,Queens,2470140.257,Jamaica Estates-Holliswood
19-Aug,36081046400,4046400,6574,64310,70884,Queens,2470140.257,Jamaica Estates-Holliswood
21-Aug,36081046400,4046400,9760,39861,49621,Queens,2470140.257,Jamaica Estates-Holliswood
19-May,36081046500,4046500,6509,35984,42493,Queens,1396723.113,Elmhurst
21-May,36081046500,4046500,1492,72718,74210,Queens,1396723.113,Elmhurst
19-Jun,36081046500,4046500,8519,44695,53214,Queens,1396723.113,Elmhurst
21-Jun,36081046500,4046500,8886,100985,109871,Queens,1396723.113,Elmhurst
19-Jul,36081046500,4046500,9889,133874,143763,Queens,1396723.113,Elmhurst
21-Jul,36081046500,4046500,11566,85254,96820,Queens,1396723.113,Elmhurst
19-Aug,36081046500,4046500,371,127312,127683,Queens,1396723.113,Elmhurst
21-Aug,36081046500,4046500,3185,112195,115380,Queens,1396723.113,Elmhurst
19-May,36081046700,4046700,16596,48755,65351,Queens,1528977.751,Elmhurst
21-May,36081046700,4046700,6168,23166,29334,Queens,1528977.751,Elmhurst
19-Jun,36081046700,4046700,5257,71328,76585,Queens,1528977.751,Elmhurst
21-Jun,36081046700,4046700,10500,100521,111021,Queens,1528977.751,Elmhurst
19-Jul,36081046700,4046700,8024,135124,143148,Queens,1528977.751,Elmhurst
21-Jul,36081046700,4046700,9426,100771,110197,Queens,1528977.751,Elmhurst
19-Aug,36081046700,4046700,10215,39482,49697,Queens,1528977.751,Elmhurst
21-Aug,36081046700,4046700,13193,49362,62555,Queens,1528977.751,Elmhurst
19-May,36081046800,4046800,8653,54915,63568,Queens,2471077.078,Jamaica
21-May,36081046800,4046800,9143,71135,80278,Queens,2471077.078,Jamaica
19-Jun,36081046800,4046800,8531,19571,28102,Queens,2471077.078,Jamaica
21-Jun,36081046800,4046800,8777,4815,13592,Queens,2471077.078,Jamaica
19-Jul,36081046800,4046800,2550,67542,70092,Queens,2471077.078,Jamaica
21-Jul,36081046800,4046800,12289,148966,161255,Queens,2471077.078,Jamaica
19-Aug,36081046800,4046800,4696,73421,78117,Queens,2471077.078,Jamaica
21-Aug,36081046800,4046800,3092,44589,47681,Queens,2471077.078,Jamaica
19-May,36081046901,4046901,0,52064,52064,Queens,803853.2001,Elmhurst
21-May,36081046901,4046901,7012,58601,65613,Queens,803853.2001,Elmhurst
19-Jun,36081046901,4046901,7800,80873,88673,Queens,803853.2001,Elmhurst
21-Jun,36081046901,4046901,11774,160003,171777,Queens,803853.2001,Elmhurst
19-Jul,36081046901,4046901,6815,71,6886,Queens,803853.2001,Elmhurst
21-Jul,36081046901,4046901,6335,77899,84234,Queens,803853.2001,Elmhurst
19-Aug,36081046901,4046901,8761,19078,27839,Queens,803853.2001,Elmhurst
21-Aug,36081046901,4046901,1777,45665,47442,Queens,803853.2001,Elmhurst
19-May,36081046902,4046902,12615,55469,68084,Queens,825704.3946,Elmhurst
21-May,36081046902,4046902,16936,82818,99754,Queens,825704.3946,Elmhurst
19-Jun,36081046902,4046902,17144,54853,71997,Queens,825704.3946,Elmhurst
21-Jun,36081046902,4046902,8041,80631,88672,Queens,825704.3946,Elmhurst
19-Jul,36081046902,4046902,6275,5953,12228,Queens,825704.3946,Elmhurst
21-Jul,36081046902,4046902,1215,69991,71206,Queens,825704.3946,Elmhurst
19-Aug,36081046902,4046902,16457,83541,99998,Queens,825704.3946,Elmhurst
21-Aug,36081046902,4046902,3256,63312,66568,Queens,825704.3946,Elmhurst
19-May,36081047000,4047000,10536,90505,101041,Queens,2473436.553,Jamaica
21-May,36081047000,4047000,10815,14636,25451,Queens,2473436.553,Jamaica
19-Jun,36081047000,4047000,5963,73165,79128,Queens,2473436.553,Jamaica
21-Jun,36081047000,4047000,18795,89223,108018,Queens,2473436.553,Jamaica
19-Jul,36081047000,4047000,4166,61883,66049,Queens,2473436.553,Jamaica
21-Jul,36081047000,4047000,14826,102774,117600,Queens,2473436.553,Jamaica
19-Aug,36081047000,4047000,10249,21108,31357,Queens,2473436.553,Jamaica
21-Aug,36081047000,4047000,5081,82394,87475,Queens,2473436.553,Jamaica
19-May,36081047300,4047300,4780,80057,84837,Queens,2136377.207,Elmhurst
21-May,36081047300,4047300,12062,70710,82772,Queens,2136377.207,Elmhurst
19-Jun,36081047300,4047300,4282,10548,14830,Queens,2136377.207,Elmhurst
21-Jun,36081047300,4047300,17763,74495,92258,Queens,2136377.207,Elmhurst
19-Jul,36081047300,4047300,1176,110190,111366,Queens,2136377.207,Elmhurst
21-Jul,36081047300,4047300,7660,58122,65782,Queens,2136377.207,Elmhurst
19-Aug,36081047300,4047300,10321,22842,33163,Queens,2136377.207,Elmhurst
21-Aug,36081047300,4047300,8392,66719,75111,Queens,2136377.207,Elmhurst
19-May,36081047801,4047801,7923,83080,91003,Queens,5600881.347,Jamaica Estates-Holliswood
21-May,36081047801,4047801,4297,79334,83631,Queens,5600881.347,Jamaica Estates-Holliswood
19-Jun,36081047801,4047801,8729,71,8800,Queens,5600881.347,Jamaica Estates-Holliswood
21-Jun,36081047801,4047801,8684,84255,92939,Queens,5600881.347,Jamaica Estates-Holliswood
19-Jul,36081047801,4047801,15159,92843,108002,Queens,5600881.347,Jamaica Estates-Holliswood
21-Jul,36081047801,4047801,6779,90328,97107,Queens,5600881.347,Jamaica Estates-Holliswood
19-Aug,36081047801,4047801,10737,43399,54136,Queens,5600881.347,Jamaica Estates-Holliswood
21-Aug,36081047801,4047801,20959,48647,69606,Queens,5600881.347,Jamaica Estates-Holliswood
19-May,36081047802,4047802,8169,17521,25690,Queens,1427568.711,Hollis
21-May,36081047802,4047802,10274,20702,30976,Queens,1427568.711,Hollis
19-Jun,36081047802,4047802,10330,82621,92951,Queens,1427568.711,Hollis
21-Jun,36081047802,4047802,7107,102094,109201,Queens,1427568.711,Hollis
19-Jul,36081047802,4047802,7308,76251,83559,Queens,1427568.711,Hollis
21-Jul,36081047802,4047802,4471,65544,70015,Queens,1427568.711,Hollis
19-Aug,36081047802,4047802,7465,137964,145429,Queens,1427568.711,Hollis
21-Aug,36081047802,4047802,5898,119055,124953,Queens,1427568.711,Hollis
19-May,36081048000,4048000,2593,71,2664,Queens,2482350.238,Hollis
21-May,36081048000,4048000,8765,31019,39784,Queens,2482350.238,Hollis
19-Jun,36081048000,4048000,9153,47215,56368,Queens,2482350.238,Hollis
21-Jun,36081048000,4048000,2530,65222,67752,Queens,2482350.238,Hollis
19-Jul,36081048000,4048000,12983,54161,67144,Queens,2482350.238,Hollis
21-Jul,36081048000,4048000,10598,29705,40303,Queens,2482350.238,Hollis
19-Aug,36081048000,4048000,15225,113229,128454,Queens,2482350.238,Hollis
21-Aug,36081048000,4048000,7503,62479,69982,Queens,2482350.238,Hollis
19-May,36081048100,4048100,2059,68154,70213,Queens,1496567.826,Elmhurst
21-May,36081048100,4048100,13663,87299,100962,Queens,1496567.826,Elmhurst
19-Jun,36081048100,4048100,10124,54137,64261,Queens,1496567.826,Elmhurst
21-Jun,36081048100,4048100,1816,66961,68777,Queens,1496567.826,Elmhurst
19-Jul,36081048100,4048100,15208,80580,95788,Queens,1496567.826,Elmhurst
21-Jul,36081048100,4048100,9825,63834,73659,Queens,1496567.826,Elmhurst
19-Aug,36081048100,4048100,8762,160766,169528,Queens,1496567.826,Elmhurst
21-Aug,36081048100,4048100,4362,70562,74924,Queens,1496567.826,Elmhurst
19-May,36081048200,4048200,2945,11559,14504,Queens,2454003.492,Hollis
21-May,36081048200,4048200,8300,89123,97423,Queens,2454003.492,Hollis
19-Jun,36081048200,4048200,4679,61456,66135,Queens,2454003.492,Hollis
21-Jun,36081048200,4048200,2032,54318,56350,Queens,2454003.492,Hollis
19-Jul,36081048200,4048200,204,43857,44061,Queens,2454003.492,Hollis
21-Jul,36081048200,4048200,5533,149600,155133,Queens,2454003.492,Hollis
19-Aug,36081048200,4048200,7902,117560,125462,Queens,2454003.492,Hollis
21-Aug,36081048200,4048200,10604,71,10675,Queens,2454003.492,Hollis
19-May,36081048400,4048400,9152,67509,76661,Queens,4466742.6,Hollis
21-May,36081048400,4048400,8243,30044,38287,Queens,4466742.6,Hollis
19-Jun,36081048400,4048400,16610,78890,95500,Queens,4466742.6,Hollis
21-Jun,36081048400,4048400,14140,55922,70062,Queens,4466742.6,Hollis
19-Jul,36081048400,4048400,16234,114708,130942,Queens,4466742.6,Hollis
21-Jul,36081048400,4048400,8866,59889,68755,Queens,4466742.6,Hollis
19-Aug,36081048400,4048400,12082,48691,60773,Queens,4466742.6,Hollis
21-Aug,36081048400,4048400,8750,35578,44328,Queens,4466742.6,Hollis
19-May,36081049201,4049201,7255,60241,67496,Queens,3169915.087,Jamaica Estates-Holliswood
21-May,36081049201,4049201,1200,66117,67317,Queens,3169915.087,Jamaica Estates-Holliswood
19-Jun,36081049201,4049201,0,87894,87894,Queens,3169915.087,Jamaica Estates-Holliswood
21-Jun,36081049201,4049201,12379,64640,77019,Queens,3169915.087,Jamaica Estates-Holliswood
19-Jul,36081049201,4049201,8682,55803,64485,Queens,3169915.087,Jamaica Estates-Holliswood
21-Jul,36081049201,4049201,0,67369,67369,Queens,3169915.087,Jamaica Estates-Holliswood
19-Aug,36081049201,4049201,7252,155859,163111,Queens,3169915.087,Jamaica Estates-Holliswood
21-Aug,36081049201,4049201,555,71,626,Queens,3169915.087,Jamaica Estates-Holliswood
19-May,36081049202,4049202,7115,99938,107053,Queens,2063107.469,Queens Village
21-May,36081049202,4049202,5431,102787,108218,Queens,2063107.469,Queens Village
19-Jun,36081049202,4049202,3615,58866,62481,Queens,2063107.469,Queens Village
21-Jun,36081049202,4049202,9165,82357,91522,Queens,2063107.469,Queens Village
19-Jul,36081049202,4049202,10820,115660,126480,Queens,2063107.469,Queens Village
21-Jul,36081049202,4049202,6387,130939,137326,Queens,2063107.469,Queens Village
19-Aug,36081049202,4049202,6006,29588,35594,Queens,2063107.469,Queens Village
21-Aug,36081049202,4049202,7476,59719,67195,Queens,2063107.469,Queens Village
19-May,36081049301,4049301,4990,80448,85438,Queens,1764042.719,Maspeth
21-May,36081049301,4049301,8784,123834,132618,Queens,1764042.719,Maspeth
19-Jun,36081049301,4049301,9711,58321,68032,Queens,1764042.719,Maspeth
21-Jun,36081049301,4049301,6330,41286,47616,Queens,1764042.719,Maspeth
19-Jul,36081049301,4049301,10909,44928,55837,Queens,1764042.719,Maspeth
21-Jul,36081049301,4049301,11603,71024,82627,Queens,1764042.719,Maspeth
19-Aug,36081049301,4049301,16700,107555,124255,Queens,1764042.719,Maspeth
21-Aug,36081049301,4049301,3701,14406,18107,Queens,1764042.719,Maspeth
19-May,36081049302,4049302,7926,53836,61762,Queens,2896925.434,Maspeth
21-May,36081049302,4049302,8299,118493,126792,Queens,2896925.434,Maspeth
19-Jun,36081049302,4049302,11621,167260,178881,Queens,2896925.434,Maspeth
21-Jun,36081049302,4049302,8577,78363,86940,Queens,2896925.434,Maspeth
19-Jul,36081049302,4049302,3881,90290,94171,Queens,2896925.434,Maspeth
21-Jul,36081049302,4049302,2794,100965,103759,Queens,2896925.434,Maspeth
19-Aug,36081049302,4049302,6609,55226,61835,Queens,2896925.434,Maspeth
21-Aug,36081049302,4049302,7604,82863,90467,Queens,2896925.434,Maspeth
19-May,36081049500,4049500,15011,71,15082,Queens,1388725.365,Maspeth
21-May,36081049500,4049500,16649,86421,103070,Queens,1388725.365,Maspeth
19-Jun,36081049500,4049500,2674,122691,125365,Queens,1388725.365,Maspeth
21-Jun,36081049500,4049500,6965,95486,102451,Queens,1388725.365,Maspeth
19-Jul,36081049500,4049500,17244,62280,79524,Queens,1388725.365,Maspeth
21-Jul,36081049500,4049500,13435,69279,82714,Queens,1388725.365,Maspeth
19-Aug,36081049500,4049500,7462,112439,119901,Queens,1388725.365,Maspeth
21-Aug,36081049500,4049500,8761,64139,72900,Queens,1388725.365,Maspeth
19-May,36081049600,4049600,8344,71,8415,Queens,2943687.163,Queens Village
21-May,36081049600,4049600,6563,63887,70450,Queens,2943687.163,Queens Village
19-Jun,36081049600,4049600,18024,87204,105228,Queens,2943687.163,Queens Village
21-Jun,36081049600,4049600,8516,42643,51159,Queens,2943687.163,Queens Village
19-Jul,36081049600,4049600,0,66680,66680,Queens,2943687.163,Queens Village
21-Jul,36081049600,4049600,8000,113787,121787,Queens,2943687.163,Queens Village
19-Aug,36081049600,4049600,7335,89680,97015,Queens,2943687.163,Queens Village
21-Aug,36081049600,4049600,21481,40509,61990,Queens,2943687.163,Queens Village
19-May,36081049700,4049700,7897,76717,84614,Queens,2129377.45,Maspeth
21-May,36081049700,4049700,10269,128775,139044,Queens,2129377.45,Maspeth
19-Jun,36081049700,4049700,4424,94211,98635,Queens,2129377.45,Maspeth
21-Jun,36081049700,4049700,5570,31693,37263,Queens,2129377.45,Maspeth
19-Jul,36081049700,4049700,3981,53876,57857,Queens,2129377.45,Maspeth
21-Jul,36081049700,4049700,0,77289,77289,Queens,2129377.45,Maspeth
19-Aug,36081049700,4049700,6066,58615,64681,Queens,2129377.45,Maspeth
21-Aug,36081049700,4049700,11715,38954,50669,Queens,2129377.45,Maspeth
19-May,36081050202,4050202,6403,39409,45812,Queens,1645285.184,Hollis
21-May,36081050202,4050202,9634,105278,114912,Queens,1645285.184,Hollis
19-Jun,36081050202,4050202,12870,89310,102180,Queens,1645285.184,Hollis
21-Jun,36081050202,4050202,3022,46284,49306,Queens,1645285.184,Hollis
19-Jul,36081050202,4050202,14280,108808,123088,Queens,1645285.184,Hollis
21-Jul,36081050202,4050202,11495,5285,16780,Queens,1645285.184,Hollis
19-Aug,36081050202,4050202,13280,52000,65280,Queens,1645285.184,Hollis
21-Aug,36081050202,4050202,12300,116369,128669,Queens,1645285.184,Hollis
19-May,36081050400,4050400,9760,28327,38087,Queens,2328381.509,St. Albans
21-May,36081050400,4050400,8833,83459,92292,Queens,2328381.509,St. Albans
19-Jun,36081050400,4050400,11289,61524,72813,Queens,2328381.509,St. Albans
21-Jun,36081050400,4050400,16766,88571,105337,Queens,2328381.509,St. Albans
19-Jul,36081050400,4050400,0,53644,53644,Queens,2328381.509,St. Albans
21-Jul,36081050400,4050400,11578,139157,150735,Queens,2328381.509,St. Albans
19-Aug,36081050400,4050400,6751,46427,53178,Queens,2328381.509,St. Albans
21-Aug,36081050400,4050400,581,56603,57184,Queens,2328381.509,St. Albans
19-May,36081050600,4050600,6755,105756,112511,Queens,2217542.17,Hollis
21-May,36081050600,4050600,143,64084,64227,Queens,2217542.17,Hollis
19-Jun,36081050600,4050600,8970,78670,87640,Queens,2217542.17,Hollis
21-Jun,36081050600,4050600,8068,58055,66123,Queens,2217542.17,Hollis
19-Jul,36081050600,4050600,11023,50449,61472,Queens,2217542.17,Hollis
21-Jul,36081050600,4050600,3592,20610,24202,Queens,2217542.17,Hollis
19-Aug,36081050600,4050600,10457,44649,55106,Queens,2217542.17,Hollis
21-Aug,36081050600,4050600,9271,31863,41134,Queens,2217542.17,Hollis
19-May,36081050800,4050800,6926,71,6997,Queens,2363416.323,Hollis
21-May,36081050800,4050800,5999,57867,63866,Queens,2363416.323,Hollis
19-Jun,36081050800,4050800,6651,94985,101636,Queens,2363416.323,Hollis
21-Jun,36081050800,4050800,4061,97476,101537,Queens,2363416.323,Hollis
19-Jul,36081050800,4050800,23903,8420,32323,Queens,2363416.323,Hollis
21-Jul,36081050800,4050800,15176,141246,156422,Queens,2363416.323,Hollis
19-Aug,36081050800,4050800,17197,2818,20015,Queens,2363416.323,Hollis
21-Aug,36081050800,4050800,24,114107,114131,Queens,2363416.323,Hollis
19-May,36081051000,4051000,0,252,252,Queens,1989781.172,Hollis
21-May,36081051000,4051000,5810,63664,69474,Queens,1989781.172,Hollis
19-Jun,36081051000,4051000,7742,125166,132908,Queens,1989781.172,Hollis
21-Jun,36081051000,4051000,10906,41772,52678,Queens,1989781.172,Hollis
19-Jul,36081051000,4051000,7149,71,7220,Queens,1989781.172,Hollis
21-Jul,36081051000,4051000,612,74330,74942,Queens,1989781.172,Hollis
19-Aug,36081051000,4051000,16030,104326,120356,Queens,1989781.172,Hollis
21-Aug,36081051000,4051000,4226,116780,121006,Queens,1989781.172,Hollis
19-May,36081051200,4051200,6538,71,6609,Queens,4044798.605,Queens Village
21-May,36081051200,4051200,11969,90910,102879,Queens,4044798.605,Queens Village
19-Jun,36081051200,4051200,1244,111380,112624,Queens,4044798.605,Queens Village
21-Jun,36081051200,4051200,9540,136591,146131,Queens,4044798.605,Queens Village
19-Jul,36081051200,4051200,7157,73085,80242,Queens,4044798.605,Queens Village
21-Jul,36081051200,4051200,15182,71,15253,Queens,4044798.605,Queens Village
19-Aug,36081051200,4051200,8696,42586,51282,Queens,4044798.605,Queens Village
21-Aug,36081051200,4051200,13000,100213,113213,Queens,4044798.605,Queens Village
19-May,36081051600,4051600,5181,96128,101309,Queens,1976764.046,Queens Village
21-May,36081051600,4051600,18221,71,18292,Queens,1976764.046,Queens Village
19-Jun,36081051600,4051600,20994,50505,71499,Queens,1976764.046,Queens Village
21-Jun,36081051600,4051600,5076,35646,40722,Queens,1976764.046,Queens Village
19-Jul,36081051600,4051600,14924,172981,187905,Queens,1976764.046,Queens Village
21-Jul,36081051600,4051600,16214,126577,142791,Queens,1976764.046,Queens Village
19-Aug,36081051600,4051600,23798,28215,52013,Queens,1976764.046,Queens Village
21-Aug,36081051600,4051600,11645,6220,17865,Queens,1976764.046,Queens Village
19-May,36081051800,4051800,7656,156088,163744,Queens,1827884.209,St. Albans
21-May,36081051800,4051800,13599,73957,87556,Queens,1827884.209,St. Albans
19-Jun,36081051800,4051800,13552,123428,136980,Queens,1827884.209,St. Albans
21-Jun,36081051800,4051800,12955,114314,127269,Queens,1827884.209,St. Albans
19-Jul,36081051800,4051800,3128,74035,77163,Queens,1827884.209,St. Albans
21-Jul,36081051800,4051800,0,77834,77834,Queens,1827884.209,St. Albans
19-Aug,36081051800,4051800,10350,79549,89899,Queens,1827884.209,St. Albans
21-Aug,36081051800,4051800,8034,100372,108406,Queens,1827884.209,St. Albans
19-May,36081052000,4052000,11489,133999,145488,Queens,1853858.139,St. Albans
21-May,36081052000,4052000,6028,118472,124500,Queens,1853858.139,St. Albans
19-Jun,36081052000,4052000,15947,33992,49939,Queens,1853858.139,St. Albans
21-Jun,36081052000,4052000,9096,68571,77667,Queens,1853858.139,St. Albans
19-Jul,36081052000,4052000,15525,47379,62904,Queens,1853858.139,St. Albans
21-Jul,36081052000,4052000,5619,110519,116138,Queens,1853858.139,St. Albans
19-Aug,36081052000,4052000,8311,139161,147472,Queens,1853858.139,St. Albans
21-Aug,36081052000,4052000,11401,76271,87672,Queens,1853858.139,St. Albans
19-May,36081052100,4052100,11030,41859,52889,Queens,2033478.652,Maspeth
21-May,36081052100,4052100,11178,103145,114323,Queens,2033478.652,Maspeth
19-Jun,36081052100,4052100,9891,109424,119315,Queens,2033478.652,Maspeth
21-Jun,36081052100,4052100,11849,101159,113008,Queens,2033478.652,Maspeth
19-Jul,36081052100,4052100,11826,49597,61423,Queens,2033478.652,Maspeth
21-Jul,36081052100,4052100,14529,108388,122917,Queens,2033478.652,Maspeth
19-Aug,36081052100,4052100,17480,84583,102063,Queens,2033478.652,Maspeth
21-Aug,36081052100,4052100,15335,111128,126463,Queens,2033478.652,Maspeth
19-May,36081052200,4052200,5950,27294,33244,Queens,1827899.178,St. Albans
21-May,36081052200,4052200,14269,35202,49471,Queens,1827899.178,St. Albans
19-Jun,36081052200,4052200,10618,156489,167107,Queens,1827899.178,St. Albans
21-Jun,36081052200,4052200,12754,139803,152557,Queens,1827899.178,St. Albans
19-Jul,36081052200,4052200,2901,82466,85367,Queens,1827899.178,St. Albans
21-Jul,36081052200,4052200,2636,33623,36259,Queens,1827899.178,St. Albans
19-Aug,36081052200,4052200,7585,37164,44749,Queens,1827899.178,St. Albans
21-Aug,36081052200,4052200,17876,1421,19297,Queens,1827899.178,St. Albans
19-May,36081052400,4052400,11759,79407,91166,Queens,2111656.275,St. Albans
21-May,36081052400,4052400,11699,62428,74127,Queens,2111656.275,St. Albans
19-Jun,36081052400,4052400,8170,127533,135703,Queens,2111656.275,St. Albans
21-Jun,36081052400,4052400,9149,89384,98533,Queens,2111656.275,St. Albans
19-Jul,36081052400,4052400,7485,21093,28578,Queens,2111656.275,St. Albans
21-Jul,36081052400,4052400,6533,127068,133601,Queens,2111656.275,St. Albans
19-Aug,36081052400,4052400,142,42376,42518,Queens,2111656.275,St. Albans
21-Aug,36081052400,4052400,3425,71,3496,Queens,2111656.275,St. Albans
19-May,36081052600,4052600,6962,96752,103714,Queens,1962757.732,St. Albans
21-May,36081052600,4052600,1240,98181,99421,Queens,1962757.732,St. Albans
19-Jun,36081052600,4052600,12643,45835,58478,Queens,1962757.732,St. Albans
21-Jun,36081052600,4052600,7525,76966,84491,Queens,1962757.732,St. Albans
19-Jul,36081052600,4052600,14069,78715,92784,Queens,1962757.732,St. Albans
21-Jul,36081052600,4052600,3584,114141,117725,Queens,1962757.732,St. Albans
19-Aug,36081052600,4052600,11421,56855,68276,Queens,1962757.732,St. Albans
21-Aug,36081052600,4052600,4525,80863,85388,Queens,1962757.732,St. Albans
19-May,36081052800,4052800,6794,123588,130382,Queens,1941579.974,St. Albans
21-May,36081052800,4052800,2895,2594,5489,Queens,1941579.974,St. Albans
19-Jun,36081052800,4052800,9816,146808,156624,Queens,1941579.974,St. Albans
21-Jun,36081052800,4052800,10727,18771,29498,Queens,1941579.974,St. Albans
19-Jul,36081052800,4052800,7696,70625,78321,Queens,1941579.974,St. Albans
21-Jul,36081052800,4052800,11969,58293,70262,Queens,1941579.974,St. Albans
19-Aug,36081052800,4052800,3333,123551,126884,Queens,1941579.974,St. Albans
21-Aug,36081052800,4052800,4010,67308,71318,Queens,1941579.974,St. Albans
19-May,36081053000,4053000,4676,123666,128342,Queens,2477580.919,St. Albans
21-May,36081053000,4053000,14627,81895,96522,Queens,2477580.919,St. Albans
19-Jun,36081053000,4053000,8747,83717,92464,Queens,2477580.919,St. Albans
21-Jun,36081053000,4053000,7557,84719,92276,Queens,2477580.919,St. Albans
19-Jul,36081053000,4053000,14779,11675,26454,Queens,2477580.919,St. Albans
21-Jul,36081053000,4053000,12760,75987,88747,Queens,2477580.919,St. Albans
19-Aug,36081053000,4053000,0,14894,14894,Queens,2477580.919,St. Albans
21-Aug,36081053000,4053000,14154,50999,65153,Queens,2477580.919,St. Albans
19-May,36081053200,4053200,6025,7741,13766,Queens,2043401.988,St. Albans
21-May,36081053200,4053200,4466,88654,93120,Queens,2043401.988,St. Albans
19-Jun,36081053200,4053200,13006,110815,123821,Queens,2043401.988,St. Albans
21-Jun,36081053200,4053200,6185,92361,98546,Queens,2043401.988,St. Albans
19-Jul,36081053200,4053200,7753,80775,88528,Queens,2043401.988,St. Albans
21-Jul,36081053200,4053200,0,76899,76899,Queens,2043401.988,St. Albans
19-Aug,36081053200,4053200,5909,71,5980,Queens,2043401.988,St. Albans
21-Aug,36081053200,4053200,14404,73536,87940,Queens,2043401.988,St. Albans
19-May,36081053601,4053601,6022,17490,23512,Queens,2066594.228,Queens Village
21-May,36081053601,4053601,3760,101808,105568,Queens,2066594.228,Queens Village
19-Jun,36081053601,4053601,3535,116717,120252,Queens,2066594.228,Queens Village
21-Jun,36081053601,4053601,7212,64338,71550,Queens,2066594.228,Queens Village
19-Jul,36081053601,4053601,8401,77401,85802,Queens,2066594.228,Queens Village
21-Jul,36081053601,4053601,8622,79661,88283,Queens,2066594.228,Queens Village
19-Aug,36081053601,4053601,877,56261,57138,Queens,2066594.228,Queens Village
21-Aug,36081053601,4053601,13085,38048,51133,Queens,2066594.228,Queens Village
19-May,36081053800,4053800,7001,71,7072,Queens,2031701.035,Queens Village
21-May,36081053800,4053800,5656,66068,71724,Queens,2031701.035,Queens Village
19-Jun,36081053800,4053800,3704,139611,143315,Queens,2031701.035,Queens Village
21-Jun,36081053800,4053800,7615,128802,136417,Queens,2031701.035,Queens Village
19-Jul,36081053800,4053800,3999,54766,58765,Queens,2031701.035,Queens Village
21-Jul,36081053800,4053800,7290,3460,10750,Queens,2031701.035,Queens Village
19-Aug,36081053800,4053800,5685,63430,69115,Queens,2031701.035,Queens Village
21-Aug,36081053800,4053800,7556,97963,105519,Queens,2031701.035,Queens Village
19-May,36081053901,4053901,11286,49846,61132,Queens,4743330.663,Ridgewood
21-May,36081053901,4053901,15714,92098,107812,Queens,4743330.663,Ridgewood
19-Jun,36081053901,4053901,14060,50043,64103,Queens,4743330.663,Ridgewood
21-Jun,36081053901,4053901,11749,125873,137622,Queens,4743330.663,Ridgewood
19-Jul,36081053901,4053901,0,161900,161900,Queens,4743330.663,Ridgewood
21-Jul,36081053901,4053901,10993,46367,57360,Queens,4743330.663,Ridgewood
19-Aug,36081053901,4053901,11654,79390,91044,Queens,4743330.663,Ridgewood
21-Aug,36081053901,4053901,6203,75524,81727,Queens,4743330.663,Ridgewood
19-May,36081053902,4053902,6435,58689,65124,Queens,1782429.059,Ridgewood
21-May,36081053902,4053902,10168,73511,83679,Queens,1782429.059,Ridgewood
19-Jun,36081053902,4053902,2316,116292,118608,Queens,1782429.059,Ridgewood
21-Jun,36081053902,4053902,5620,96672,102292,Queens,1782429.059,Ridgewood
19-Jul,36081053902,4053902,3087,57302,60389,Queens,1782429.059,Ridgewood
21-Jul,36081053902,4053902,10442,151783,162225,Queens,1782429.059,Ridgewood
19-Aug,36081053902,4053902,5808,7176,12984,Queens,1782429.059,Ridgewood
21-Aug,36081053902,4053902,12522,44310,56832,Queens,1782429.059,Ridgewood
19-May,36081054000,4054000,7460,66679,74139,Queens,5627808.846,Queens Village
21-May,36081054000,4054000,7067,66773,73840,Queens,5627808.846,Queens Village
19-Jun,36081054000,4054000,11498,97904,109402,Queens,5627808.846,Queens Village
21-Jun,36081054000,4054000,10079,12886,22965,Queens,5627808.846,Queens Village
19-Jul,36081054000,4054000,8347,30401,38748,Queens,5627808.846,Queens Village
21-Jul,36081054000,4054000,9918,51318,61236,Queens,5627808.846,Queens Village
19-Aug,36081054000,4054000,6874,79991,86865,Queens,5627808.846,Queens Village
21-Aug,36081054000,4054000,16580,86250,102830,Queens,5627808.846,Queens Village
19-May,36081054200,4054200,4636,117187,121823,Queens,5824785.576,Queens Village
21-May,36081054200,4054200,7753,25723,33476,Queens,5824785.576,Queens Village
19-Jun,36081054200,4054200,8080,35655,43735,Queens,5824785.576,Queens Village
21-Jun,36081054200,4054200,8082,42573,50655,Queens,5824785.576,Queens Village
19-Jul,36081054200,4054200,12303,69426,81729,Queens,5824785.576,Queens Village
21-Jul,36081054200,4054200,9935,88825,98760,Queens,5824785.576,Queens Village
19-Aug,36081054200,4054200,12432,87255,99687,Queens,5824785.576,Queens Village
21-Aug,36081054200,4054200,13760,78041,91801,Queens,5824785.576,Queens Village
19-May,36081054500,4054500,5920,126803,132723,Queens,1221365.647,Ridgewood
21-May,36081054500,4054500,9299,93779,103078,Queens,1221365.647,Ridgewood
19-Jun,36081054500,4054500,11416,94195,105611,Queens,1221365.647,Ridgewood
21-Jun,36081054500,4054500,10042,62236,72278,Queens,1221365.647,Ridgewood
19-Jul,36081054500,4054500,15267,56671,71938,Queens,1221365.647,Ridgewood
21-Jul,36081054500,4054500,1587,23196,24783,Queens,1221365.647,Ridgewood
19-Aug,36081054500,4054500,14583,51044,65627,Queens,1221365.647,Ridgewood
21-Aug,36081054500,4054500,10906,36561,47467,Queens,1221365.647,Ridgewood
19-May,36081054700,4054700,8757,48187,56944,Queens,1390289.285,Ridgewood
21-May,36081054700,4054700,436,52934,53370,Queens,1390289.285,Ridgewood
19-Jun,36081054700,4054700,7987,62746,70733,Queens,1390289.285,Ridgewood
21-Jun,36081054700,4054700,0,161517,161517,Queens,1390289.285,Ridgewood
19-Jul,36081054700,4054700,10161,92141,102302,Queens,1390289.285,Ridgewood
21-Jul,36081054700,4054700,10170,60434,70604,Queens,1390289.285,Ridgewood
19-Aug,36081054700,4054700,7925,46066,53991,Queens,1390289.285,Ridgewood
21-Aug,36081054700,4054700,1604,48339,49943,Queens,1390289.285,Ridgewood
19-May,36081054800,4054800,18660,72939,91599,Queens,2423672.418,Queens Village
21-May,36081054800,4054800,18004,127868,145872,Queens,2423672.418,Queens Village
19-Jun,36081054800,4054800,1845,52916,54761,Queens,2423672.418,Queens Village
21-Jun,36081054800,4054800,6189,88043,94232,Queens,2423672.418,Queens Village
19-Jul,36081054800,4054800,10354,95756,106110,Queens,2423672.418,Queens Village
21-Jul,36081054800,4054800,3361,12230,15591,Queens,2423672.418,Queens Village
19-Aug,36081054800,4054800,6919,71,6990,Queens,2423672.418,Queens Village
21-Aug,36081054800,4054800,8859,91911,100770,Queens,2423672.418,Queens Village
19-May,36081054900,4054900,13402,47419,60821,Queens,1767827.288,Ridgewood
21-May,36081054900,4054900,4778,96475,101253,Queens,1767827.288,Ridgewood
19-Jun,36081054900,4054900,6627,145737,152364,Queens,1767827.288,Ridgewood
21-Jun,36081054900,4054900,12490,118683,131173,Queens,1767827.288,Ridgewood
19-Jul,36081054900,4054900,8308,68611,76919,Queens,1767827.288,Ridgewood
21-Jul,36081054900,4054900,5593,75780,81373,Queens,1767827.288,Ridgewood
19-Aug,36081054900,4054900,16563,49446,66009,Queens,1767827.288,Ridgewood
21-Aug,36081054900,4054900,6551,71198,77749,Queens,1767827.288,Ridgewood
19-May,36081055100,4055100,8666,75402,84068,Queens,1669725.732,Ridgewood
21-May,36081055100,4055100,4307,89374,93681,Queens,1669725.732,Ridgewood
19-Jun,36081055100,4055100,13999,71,14070,Queens,1669725.732,Ridgewood
21-Jun,36081055100,4055100,15267,84335,99602,Queens,1669725.732,Ridgewood
19-Jul,36081055100,4055100,7735,75399,83134,Queens,1669725.732,Ridgewood
21-Jul,36081055100,4055100,9821,82635,92456,Queens,1669725.732,Ridgewood
19-Aug,36081055100,4055100,649,71,720,Queens,1669725.732,Ridgewood
21-Aug,36081055100,4055100,7511,95461,102972,Queens,1669725.732,Ridgewood
19-May,36081055300,4055300,0,53042,53042,Queens,1475828.636,Ridgewood
21-May,36081055300,4055300,15176,27768,42944,Queens,1475828.636,Ridgewood
19-Jun,36081055300,4055300,14785,130301,145086,Queens,1475828.636,Ridgewood
21-Jun,36081055300,4055300,8979,92679,101658,Queens,1475828.636,Ridgewood
19-Jul,36081055300,4055300,6603,78971,85574,Queens,1475828.636,Ridgewood
21-Jul,36081055300,4055300,12434,127583,140017,Queens,1475828.636,Ridgewood
19-Aug,36081055300,4055300,15656,71235,86891,Queens,1475828.636,Ridgewood
21-Aug,36081055300,4055300,8704,69216,77920,Queens,1475828.636,Ridgewood
19-May,36081055400,4055400,7171,44549,51720,Queens,2368771.714,Queens Village
21-May,36081055400,4055400,12566,103077,115643,Queens,2368771.714,Queens Village
19-Jun,36081055400,4055400,2677,108611,111288,Queens,2368771.714,Queens Village
21-Jun,36081055400,4055400,7037,70490,77527,Queens,2368771.714,Queens Village
19-Jul,36081055400,4055400,13253,71,13324,Queens,2368771.714,Queens Village
21-Jul,36081055400,4055400,2056,50740,52796,Queens,2368771.714,Queens Village
19-Aug,36081055400,4055400,0,111426,111426,Queens,2368771.714,Queens Village
21-Aug,36081055400,4055400,20489,122898,143387,Queens,2368771.714,Queens Village
19-May,36081055500,4055500,389,56061,56450,Queens,1654116.307,Ridgewood
21-May,36081055500,4055500,9965,71109,81074,Queens,1654116.307,Ridgewood
19-Jun,36081055500,4055500,5003,105791,110794,Queens,1654116.307,Ridgewood
21-Jun,36081055500,4055500,0,31117,31117,Queens,1654116.307,Ridgewood
19-Jul,36081055500,4055500,12435,33919,46354,Queens,1654116.307,Ridgewood
21-Jul,36081055500,4055500,14341,104121,118462,Queens,1654116.307,Ridgewood
19-Aug,36081055500,4055500,9305,22435,31740,Queens,1654116.307,Ridgewood
21-Aug,36081055500,4055500,2759,66857,69616,Queens,1654116.307,Ridgewood
19-May,36081055600,4055600,1518,91815,93333,Queens,2442153.5,Queens Village
21-May,36081055600,4055600,10838,86681,97519,Queens,2442153.5,Queens Village
19-Jun,36081055600,4055600,5287,74062,79349,Queens,2442153.5,Queens Village
21-Jun,36081055600,4055600,9084,133076,142160,Queens,2442153.5,Queens Village
19-Jul,36081055600,4055600,11434,132616,144050,Queens,2442153.5,Queens Village
21-Jul,36081055600,4055600,14593,16949,31542,Queens,2442153.5,Queens Village
19-Aug,36081055600,4055600,7821,127437,135258,Queens,2442153.5,Queens Village
21-Aug,36081055600,4055600,7372,115697,123069,Queens,2442153.5,Queens Village
19-May,36081055700,4055700,9492,71,9563,Queens,2577353.556,Ridgewood
21-May,36081055700,4055700,14590,140569,155159,Queens,2577353.556,Ridgewood
19-Jun,36081055700,4055700,14515,131458,145973,Queens,2577353.556,Ridgewood
21-Jun,36081055700,4055700,11243,16095,27338,Queens,2577353.556,Ridgewood
19-Jul,36081055700,4055700,4048,136015,140063,Queens,2577353.556,Ridgewood
21-Jul,36081055700,4055700,1231,92020,93251,Queens,2577353.556,Ridgewood
19-Aug,36081055700,4055700,8953,28708,37661,Queens,2577353.556,Ridgewood
21-Aug,36081055700,4055700,9446,50240,59686,Queens,2577353.556,Ridgewood
19-May,36081055800,4055800,7407,58927,66334,Queens,2070613.643,Queens Village
21-May,36081055800,4055800,12789,68003,80792,Queens,2070613.643,Queens Village
19-Jun,36081055800,4055800,16431,72692,89123,Queens,2070613.643,Queens Village
21-Jun,36081055800,4055800,4565,94893,99458,Queens,2070613.643,Queens Village
19-Jul,36081055800,4055800,2655,92640,95295,Queens,2070613.643,Queens Village
21-Jul,36081055800,4055800,14382,36604,50986,Queens,2070613.643,Queens Village
19-Aug,36081055800,4055800,14047,71,14118,Queens,2070613.643,Queens Village
21-Aug,36081055800,4055800,6952,71,7023,Queens,2070613.643,Queens Village
19-May,36081055900,4055900,11334,73052,84386,Queens,1747160.518,Ridgewood
21-May,36081055900,4055900,5421,37236,42657,Queens,1747160.518,Ridgewood
19-Jun,36081055900,4055900,7019,71,7090,Queens,1747160.518,Ridgewood
21-Jun,36081055900,4055900,740,27916,28656,Queens,1747160.518,Ridgewood
19-Jul,36081055900,4055900,8283,21795,30078,Queens,1747160.518,Ridgewood
21-Jul,36081055900,4055900,1090,113577,114667,Queens,1747160.518,Ridgewood
19-Aug,36081055900,4055900,16837,50888,67725,Queens,1747160.518,Ridgewood
21-Aug,36081055900,4055900,5806,130021,135827,Queens,1747160.518,Ridgewood
19-May,36081056100,4056100,16207,145892,162099,Queens,31227050.01,Highland Park-Cypress Hills Cemeteries (North)
21-May,36081056100,4056100,11379,80013,91392,Queens,31227050.01,Highland Park-Cypress Hills Cemeteries (North)
19-Jun,36081056100,4056100,2257,37798,40055,Queens,31227050.01,Highland Park-Cypress Hills Cemeteries (North)
21-Jun,36081056100,4056100,5452,71,5523,Queens,31227050.01,Highland Park-Cypress Hills Cemeteries (North)
19-Jul,36081056100,4056100,6246,79129,85375,Queens,31227050.01,Highland Park-Cypress Hills Cemeteries (North)
21-Jul,36081056100,4056100,773,71558,72331,Queens,31227050.01,Highland Park-Cypress Hills Cemeteries (North)
19-Aug,36081056100,4056100,13891,138200,152091,Queens,31227050.01,Highland Park-Cypress Hills Cemeteries (North)
21-Aug,36081056100,4056100,10394,171509,181903,Queens,31227050.01,Highland Park-Cypress Hills Cemeteries (North)
19-May,36081056200,4056200,3582,130633,134215,Queens,1729177.344,Queens Village
21-May,36081056200,4056200,11055,89908,100963,Queens,1729177.344,Queens Village
19-Jun,36081056200,4056200,3429,64746,68175,Queens,1729177.344,Queens Village
21-Jun,36081056200,4056200,7425,88379,95804,Queens,1729177.344,Queens Village
19-Jul,36081056200,4056200,12018,131080,143098,Queens,1729177.344,Queens Village
21-Jul,36081056200,4056200,11490,48932,60422,Queens,1729177.344,Queens Village
19-Aug,36081056200,4056200,8608,78148,86756,Queens,1729177.344,Queens Village
21-Aug,36081056200,4056200,11001,16838,27839,Queens,1729177.344,Queens Village
19-May,36081056500,4056500,8942,64174,73116,Queens,1304509.434,Glendale
21-May,36081056500,4056500,3102,78506,81608,Queens,1304509.434,Glendale
19-Jun,36081056500,4056500,3762,88610,92372,Queens,1304509.434,Glendale
21-Jun,36081056500,4056500,2720,88692,91412,Queens,1304509.434,Glendale
19-Jul,36081056500,4056500,6207,77165,83372,Queens,1304509.434,Glendale
21-Jul,36081056500,4056500,4575,76692,81267,Queens,1304509.434,Glendale
19-Aug,36081056500,4056500,0,34011,34011,Queens,1304509.434,Glendale
21-Aug,36081056500,4056500,0,88222,88222,Queens,1304509.434,Glendale
19-May,36081056600,4056600,5515,79475,84990,Queens,2098775.466,Queens Village
21-May,36081056600,4056600,0,67060,67060,Queens,2098775.466,Queens Village
19-Jun,36081056600,4056600,11956,42432,54388,Queens,2098775.466,Queens Village
21-Jun,36081056600,4056600,7052,71,7123,Queens,2098775.466,Queens Village
19-Jul,36081056600,4056600,21623,148265,169888,Queens,2098775.466,Queens Village
21-Jul,36081056600,4056600,10168,57618,67786,Queens,2098775.466,Queens Village
19-Aug,36081056600,4056600,17760,91023,108783,Queens,2098775.466,Queens Village
21-Aug,36081056600,4056600,8187,66105,74292,Queens,2098775.466,Queens Village
19-May,36081056700,4056700,16626,10069,26695,Queens,3385675.098,Glendale
21-May,36081056700,4056700,3895,100800,104695,Queens,3385675.098,Glendale
19-Jun,36081056700,4056700,14978,71398,86376,Queens,3385675.098,Glendale
21-Jun,36081056700,4056700,9249,35108,44357,Queens,3385675.098,Glendale
19-Jul,36081056700,4056700,9421,75962,85383,Queens,3385675.098,Glendale
21-Jul,36081056700,4056700,0,58208,58208,Queens,3385675.098,Glendale
19-Aug,36081056700,4056700,0,64621,64621,Queens,3385675.098,Glendale
21-Aug,36081056700,4056700,9246,99086,108332,Queens,3385675.098,Glendale
19-May,36081057700,4057700,20013,67589,87602,Queens,2030058.392,Glendale
21-May,36081057700,4057700,17608,41785,59393,Queens,2030058.392,Glendale
19-Jun,36081057700,4057700,11576,47870,59446,Queens,2030058.392,Glendale
21-Jun,36081057700,4057700,10668,41917,52585,Queens,2030058.392,Glendale
19-Jul,36081057700,4057700,5995,34271,40266,Queens,2030058.392,Glendale
21-Jul,36081057700,4057700,8567,65809,74376,Queens,2030058.392,Glendale
19-Aug,36081057700,4057700,13033,34073,47106,Queens,2030058.392,Glendale
21-Aug,36081057700,4057700,15377,51688,67065,Queens,2030058.392,Glendale
19-May,36081057900,4057900,9374,55753,65127,Queens,743111.0699,Glendale
21-May,36081057900,4057900,17725,74997,92722,Queens,743111.0699,Glendale
19-Jun,36081057900,4057900,8141,117320,125461,Queens,743111.0699,Glendale
21-Jun,36081057900,4057900,11189,82763,93952,Queens,743111.0699,Glendale
19-Jul,36081057900,4057900,13557,125538,139095,Queens,743111.0699,Glendale
21-Jul,36081057900,4057900,17430,141568,158998,Queens,743111.0699,Glendale
19-Aug,36081057900,4057900,13865,114858,128723,Queens,743111.0699,Glendale
21-Aug,36081057900,4057900,9755,69647,79402,Queens,743111.0699,Glendale
19-May,36081058200,4058200,17163,148878,166041,Queens,6066865.061,Queens Village
21-May,36081058200,4058200,9968,71,10039,Queens,6066865.061,Queens Village
19-Jun,36081058200,4058200,2692,64332,67024,Queens,6066865.061,Queens Village
21-Jun,36081058200,4058200,1754,64447,66201,Queens,6066865.061,Queens Village
19-Jul,36081058200,4058200,10393,99439,109832,Queens,6066865.061,Queens Village
21-Jul,36081058200,4058200,2469,97249,99718,Queens,6066865.061,Queens Village
19-Aug,36081058200,4058200,7011,61725,68736,Queens,6066865.061,Queens Village
21-Aug,36081058200,4058200,12970,31917,44887,Queens,6066865.061,Queens Village
19-May,36081058500,4058500,3343,73413,76756,Queens,1842457.057,Ridgewood
21-May,36081058500,4058500,8379,38761,47140,Queens,1842457.057,Ridgewood
19-Jun,36081058500,4058500,15855,54083,69938,Queens,1842457.057,Ridgewood
21-Jun,36081058500,4058500,8506,64509,73015,Queens,1842457.057,Ridgewood
19-Jul,36081058500,4058500,204,73633,73837,Queens,1842457.057,Ridgewood
21-Jul,36081058500,4058500,6096,64203,70299,Queens,1842457.057,Ridgewood
19-Aug,36081058500,4058500,532,133245,133777,Queens,1842457.057,Ridgewood
21-Aug,36081058500,4058500,4418,53035,57453,Queens,1842457.057,Ridgewood
19-May,36081058700,4058700,16121,118540,134661,Queens,1549455.352,Ridgewood
21-May,36081058700,4058700,8831,126182,135013,Queens,1549455.352,Ridgewood
19-Jun,36081058700,4058700,8057,73901,81958,Queens,1549455.352,Ridgewood
21-Jun,36081058700,4058700,6614,1181,7795,Queens,1549455.352,Ridgewood
19-Jul,36081058700,4058700,7744,19151,26895,Queens,1549455.352,Ridgewood
21-Jul,36081058700,4058700,12169,109064,121233,Queens,1549455.352,Ridgewood
19-Aug,36081058700,4058700,14396,87863,102259,Queens,1549455.352,Ridgewood
21-Aug,36081058700,4058700,12954,66494,79448,Queens,1549455.352,Ridgewood
19-May,36081058900,4058900,15402,67407,82809,Queens,1780244.689,Ridgewood
21-May,36081058900,4058900,1158,36704,37862,Queens,1780244.689,Ridgewood
19-Jun,36081058900,4058900,9509,23285,32794,Queens,1780244.689,Ridgewood
21-Jun,36081058900,4058900,20670,89633,110303,Queens,1780244.689,Ridgewood
19-Jul,36081058900,4058900,6222,63922,70144,Queens,1780244.689,Ridgewood
21-Jul,36081058900,4058900,15861,39419,55280,Queens,1780244.689,Ridgewood
19-Aug,36081058900,4058900,4873,142517,147390,Queens,1780244.689,Ridgewood
21-Aug,36081058900,4058900,2901,39367,42268,Queens,1780244.689,Ridgewood
19-May,36081059000,4059000,4536,26206,30742,Queens,1702017.132,Cambria Heights
21-May,36081059000,4059000,9161,29088,38249,Queens,1702017.132,Cambria Heights
19-Jun,36081059000,4059000,5242,68832,74074,Queens,1702017.132,Cambria Heights
21-Jun,36081059000,4059000,11441,121185,132626,Queens,1702017.132,Cambria Heights
19-Jul,36081059000,4059000,7039,19157,26196,Queens,1702017.132,Cambria Heights
21-Jul,36081059000,4059000,15723,87775,103498,Queens,1702017.132,Cambria Heights
19-Aug,36081059000,4059000,7822,122157,129979,Queens,1702017.132,Cambria Heights
21-Aug,36081059000,4059000,7890,36705,44595,Queens,1702017.132,Cambria Heights
19-May,36081059100,4059100,6156,31621,37777,Queens,2174921.346,Ridgewood
21-May,36081059100,4059100,7735,88688,96423,Queens,2174921.346,Ridgewood
19-Jun,36081059100,4059100,10719,105943,116662,Queens,2174921.346,Ridgewood
21-Jun,36081059100,4059100,11889,49343,61232,Queens,2174921.346,Ridgewood
19-Jul,36081059100,4059100,11682,119270,130952,Queens,2174921.346,Ridgewood
21-Jul,36081059100,4059100,1038,110674,111712,Queens,2174921.346,Ridgewood
19-Aug,36081059100,4059100,10004,74413,84417,Queens,2174921.346,Ridgewood
21-Aug,36081059100,4059100,13014,69619,82633,Queens,2174921.346,Ridgewood
19-May,36081059300,4059300,12895,50260,63155,Queens,2719007.541,Ridgewood
21-May,36081059300,4059300,7205,91036,98241,Queens,2719007.541,Ridgewood
19-Jun,36081059300,4059300,16979,104093,121072,Queens,2719007.541,Ridgewood
21-Jun,36081059300,4059300,4616,87718,92334,Queens,2719007.541,Ridgewood
19-Jul,36081059300,4059300,939,116720,117659,Queens,2719007.541,Ridgewood
21-Jul,36081059300,4059300,15281,114112,129393,Queens,2719007.541,Ridgewood
19-Aug,36081059300,4059300,5185,94228,99413,Queens,2719007.541,Ridgewood
21-Aug,36081059300,4059300,13296,54967,68263,Queens,2719007.541,Ridgewood
19-May,36081059501,4059501,18068,138530,156598,Queens,1774156.283,Ridgewood
21-May,36081059501,4059501,6289,94584,100873,Queens,1774156.283,Ridgewood
19-Jun,36081059501,4059501,7537,88167,95704,Queens,1774156.283,Ridgewood
21-Jun,36081059501,4059501,10953,89421,100374,Queens,1774156.283,Ridgewood
19-Jul,36081059501,4059501,10126,126802,136928,Queens,1774156.283,Ridgewood
21-Jul,36081059501,4059501,11643,4597,16240,Queens,1774156.283,Ridgewood
19-Aug,36081059501,4059501,5290,18532,23822,Queens,1774156.283,Ridgewood
21-Aug,36081059501,4059501,1455,52745,54200,Queens,1774156.283,Ridgewood
19-May,36081059900,4059900,7430,128099,135529,Queens,1368119.308,Maspeth
21-May,36081059900,4059900,12462,76215,88677,Queens,1368119.308,Maspeth
19-Jun,36081059900,4059900,5603,65840,71443,Queens,1368119.308,Maspeth
21-Jun,36081059900,4059900,10903,78608,89511,Queens,1368119.308,Maspeth
19-Jul,36081059900,4059900,11620,104968,116588,Queens,1368119.308,Maspeth
21-Jul,36081059900,4059900,3334,37824,41158,Queens,1368119.308,Maspeth
19-Aug,36081059900,4059900,628,71,699,Queens,1368119.308,Maspeth
21-Aug,36081059900,4059900,5869,135783,141652,Queens,1368119.308,Maspeth
19-May,36081060600,4060600,3473,63716,67189,Queens,2317297.211,Cambria Heights
21-May,36081060600,4060600,8093,25579,33672,Queens,2317297.211,Cambria Heights
19-Jun,36081060600,4060600,7240,93091,100331,Queens,2317297.211,Cambria Heights
21-Jun,36081060600,4060600,1077,76634,77711,Queens,2317297.211,Cambria Heights
19-Jul,36081060600,4060600,12341,88382,100723,Queens,2317297.211,Cambria Heights
21-Jul,36081060600,4060600,9096,121749,130845,Queens,2317297.211,Cambria Heights
19-Aug,36081060600,4060600,13576,50649,64225,Queens,2317297.211,Cambria Heights
21-Aug,36081060600,4060600,6908,80935,87843,Queens,2317297.211,Cambria Heights
19-May,36081060800,4060800,4637,63772,68409,Queens,2271701.79,Cambria Heights
21-May,36081060800,4060800,8219,38466,46685,Queens,2271701.79,Cambria Heights
19-Jun,36081060800,4060800,11343,11947,23290,Queens,2271701.79,Cambria Heights
21-Jun,36081060800,4060800,5982,72832,78814,Queens,2271701.79,Cambria Heights
19-Jul,36081060800,4060800,3533,20776,24309,Queens,2271701.79,Cambria Heights
21-Jul,36081060800,4060800,3859,119123,122982,Queens,2271701.79,Cambria Heights
19-Aug,36081060800,4060800,7686,40637,48323,Queens,2271701.79,Cambria Heights
21-Aug,36081060800,4060800,145,39506,39651,Queens,2271701.79,Cambria Heights
19-May,36081061000,4061000,6502,31555,38057,Queens,2616057.49,Cambria Heights
21-May,36081061000,4061000,11862,78206,90068,Queens,2616057.49,Cambria Heights
19-Jun,36081061000,4061000,2085,136470,138555,Queens,2616057.49,Cambria Heights
21-Jun,36081061000,4061000,0,104193,104193,Queens,2616057.49,Cambria Heights
19-Jul,36081061000,4061000,7771,106428,114199,Queens,2616057.49,Cambria Heights
21-Jul,36081061000,4061000,4960,90978,95938,Queens,2616057.49,Cambria Heights
19-Aug,36081061000,4061000,8406,105362,113768,Queens,2616057.49,Cambria Heights
21-Aug,36081061000,4061000,6298,61913,68211,Queens,2616057.49,Cambria Heights
19-May,36081061200,4061200,4849,154426,159275,Queens,2830128.161,Cambria Heights
21-May,36081061200,4061200,4531,14270,18801,Queens,2830128.161,Cambria Heights
19-Jun,36081061200,4061200,11396,69319,80715,Queens,2830128.161,Cambria Heights
21-Jun,36081061200,4061200,12091,73655,85746,Queens,2830128.161,Cambria Heights
19-Jul,36081061200,4061200,12021,85866,97887,Queens,2830128.161,Cambria Heights
21-Jul,36081061200,4061200,10970,67439,78409,Queens,2830128.161,Cambria Heights
19-Aug,36081061200,4061200,13621,145435,159056,Queens,2830128.161,Cambria Heights
21-Aug,36081061200,4061200,4849,87194,92043,Queens,2830128.161,Cambria Heights
19-May,36081061302,4061302,9456,98045,107501,Queens,5511491.134,Middle Village Cemetery
21-May,36081061302,4061302,6518,37152,43670,Queens,5511491.134,Middle Village Cemetery
19-Jun,36081061302,4061302,13824,3239,17063,Queens,5511491.134,Middle Village Cemetery
21-Jun,36081061302,4061302,8279,41094,49373,Queens,5511491.134,Middle Village Cemetery
19-Jul,36081061302,4061302,7504,98669,106173,Queens,5511491.134,Middle Village Cemetery
21-Jul,36081061302,4061302,14995,81327,96322,Queens,5511491.134,Middle Village Cemetery
19-Aug,36081061302,4061302,12191,104397,116588,Queens,5511491.134,Middle Village Cemetery
21-Aug,36081061302,4061302,6832,114572,121404,Queens,5511491.134,Middle Village Cemetery
19-May,36081061400,4061400,7066,70600,77666,Queens,2772036.316,Cambria Heights
21-May,36081061400,4061400,12190,2886,15076,Queens,2772036.316,Cambria Heights
19-Jun,36081061400,4061400,0,41119,41119,Queens,2772036.316,Cambria Heights
21-Jun,36081061400,4061400,11952,54507,66459,Queens,2772036.316,Cambria Heights
19-Jul,36081061400,4061400,3554,37682,41236,Queens,2772036.316,Cambria Heights
21-Jul,36081061400,4061400,12858,116918,129776,Queens,2772036.316,Cambria Heights
19-Aug,36081061400,4061400,2474,83565,86039,Queens,2772036.316,Cambria Heights
21-Aug,36081061400,4061400,10192,93644,103836,Queens,2772036.316,Cambria Heights
19-May,36081061601,4061601,13859,43464,57323,Queens,4117509.642,Laurelton
21-May,36081061601,4061601,6075,143672,149747,Queens,4117509.642,Laurelton
19-Jun,36081061601,4061601,16407,87823,104230,Queens,4117509.642,Laurelton
21-Jun,36081061601,4061601,7143,19581,26724,Queens,4117509.642,Laurelton
19-Jul,36081061601,4061601,8374,27971,36345,Queens,4117509.642,Laurelton
21-Jul,36081061601,4061601,11536,44293,55829,Queens,4117509.642,Laurelton
19-Aug,36081061601,4061601,5160,102445,107605,Queens,4117509.642,Laurelton
21-Aug,36081061601,4061601,13972,29067,43039,Queens,4117509.642,Laurelton
19-May,36081061800,4061800,4065,66885,70950,Queens,2600036.161,Laurelton
21-May,36081061800,4061800,5046,174406,179452,Queens,2600036.161,Laurelton
19-Jun,36081061800,4061800,14590,131423,146013,Queens,2600036.161,Laurelton
21-Jun,36081061800,4061800,7523,104722,112245,Queens,2600036.161,Laurelton
19-Jul,36081061800,4061800,9436,83429,92865,Queens,2600036.161,Laurelton
21-Jul,36081061800,4061800,10170,59155,69325,Queens,2600036.161,Laurelton
19-Aug,36081061800,4061800,7802,11126,18928,Queens,2600036.161,Laurelton
21-Aug,36081061800,4061800,6197,116087,122284,Queens,2600036.161,Laurelton
19-May,36081062300,4062300,11544,94541,106085,Queens,1688804.113,Glendale
21-May,36081062300,4062300,1984,63075,65059,Queens,1688804.113,Glendale
19-Jun,36081062300,4062300,0,24447,24447,Queens,1688804.113,Glendale
21-Jun,36081062300,4062300,5998,32570,38568,Queens,1688804.113,Glendale
19-Jul,36081062300,4062300,12690,60542,73232,Queens,1688804.113,Glendale
21-Jul,36081062300,4062300,6508,32944,39452,Queens,1688804.113,Glendale
19-Aug,36081062300,4062300,6579,66475,73054,Queens,1688804.113,Glendale
21-Aug,36081062300,4062300,628,11588,12216,Queens,1688804.113,Glendale
19-May,36081062500,4062500,6159,68137,74296,Queens,2137199.262,Glendale
21-May,36081062500,4062500,16314,103747,120061,Queens,2137199.262,Glendale
19-Jun,36081062500,4062500,0,54157,54157,Queens,2137199.262,Glendale
21-Jun,36081062500,4062500,16117,54123,70240,Queens,2137199.262,Glendale
19-Jul,36081062500,4062500,15260,57802,73062,Queens,2137199.262,Glendale
21-Jul,36081062500,4062500,5421,81155,86576,Queens,2137199.262,Glendale
19-Aug,36081062500,4062500,10351,33537,43888,Queens,2137199.262,Glendale
21-Aug,36081062500,4062500,15151,21966,37117,Queens,2137199.262,Glendale
19-May,36081062600,4062600,18494,71,18565,Queens,4651585.202,Laurelton
21-May,36081062600,4062600,2501,90736,93237,Queens,4651585.202,Laurelton
19-Jun,36081062600,4062600,8659,66609,75268,Queens,4651585.202,Laurelton
21-Jun,36081062600,4062600,15244,22782,38026,Queens,4651585.202,Laurelton
19-Jul,36081062600,4062600,7332,104410,111742,Queens,4651585.202,Laurelton
21-Jul,36081062600,4062600,13194,109320,122514,Queens,4651585.202,Laurelton
19-Aug,36081062600,4062600,745,60198,60943,Queens,4651585.202,Laurelton
21-Aug,36081062600,4062600,0,52116,52116,Queens,4651585.202,Laurelton
19-May,36081062700,4062700,1330,77142,78472,Queens,1693386.235,Glendale
21-May,36081062700,4062700,9869,23848,33717,Queens,1693386.235,Glendale
19-Jun,36081062700,4062700,15162,25644,40806,Queens,1693386.235,Glendale
21-Jun,36081062700,4062700,6239,10183,16422,Queens,1693386.235,Glendale
19-Jul,36081062700,4062700,18870,111544,130414,Queens,1693386.235,Glendale
21-Jul,36081062700,4062700,0,97036,97036,Queens,1693386.235,Glendale
19-Aug,36081062700,4062700,4968,102023,106991,Queens,1693386.235,Glendale
21-Aug,36081062700,4062700,9029,4085,13114,Queens,1693386.235,Glendale
19-May,36081062900,4062900,10111,115323,125434,Queens,1987938.261,Glendale
21-May,36081062900,4062900,4760,82954,87714,Queens,1987938.261,Glendale
19-Jun,36081062900,4062900,3969,105577,109546,Queens,1987938.261,Glendale
21-Jun,36081062900,4062900,6579,77583,84162,Queens,1987938.261,Glendale
19-Jul,36081062900,4062900,5533,91314,96847,Queens,1987938.261,Glendale
21-Jul,36081062900,4062900,9156,76646,85802,Queens,1987938.261,Glendale
19-Aug,36081062900,4062900,8344,82920,91264,Queens,1987938.261,Glendale
21-Aug,36081062900,4062900,9375,106461,115836,Queens,1987938.261,Glendale
19-May,36081063200,4063200,6772,71,6843,Queens,3192812.087,Laurelton
21-May,36081063200,4063200,15611,64938,80549,Queens,3192812.087,Laurelton
19-Jun,36081063200,4063200,12390,81051,93441,Queens,3192812.087,Laurelton
21-Jun,36081063200,4063200,10144,91462,101606,Queens,3192812.087,Laurelton
19-Jul,36081063200,4063200,11219,58754,69973,Queens,3192812.087,Laurelton
21-Jul,36081063200,4063200,10567,128322,138889,Queens,3192812.087,Laurelton
19-Aug,36081063200,4063200,10251,74503,84754,Queens,3192812.087,Laurelton
21-Aug,36081063200,4063200,0,111557,111557,Queens,3192812.087,Laurelton
19-May,36081064101,4064101,8736,53083,61819,Queens,888496.1547,Woodhaven
21-May,36081064101,4064101,12273,66587,78860,Queens,888496.1547,Woodhaven
19-Jun,36081064101,4064101,6624,99700,106324,Queens,888496.1547,Woodhaven
21-Jun,36081064101,4064101,3848,150814,154662,Queens,888496.1547,Woodhaven
19-Jul,36081064101,4064101,11330,61335,72665,Queens,888496.1547,Woodhaven
21-Jul,36081064101,4064101,2497,20412,22909,Queens,888496.1547,Woodhaven
19-Aug,36081064101,4064101,19457,97374,116831,Queens,888496.1547,Woodhaven
21-Aug,36081064101,4064101,7555,106776,114331,Queens,888496.1547,Woodhaven
19-May,36081064500,4064500,12736,140138,152874,Queens,3401293.313,Forest Hills
21-May,36081064500,4064500,5664,99623,105287,Queens,3401293.313,Forest Hills
19-Jun,36081064500,4064500,17153,145059,162212,Queens,3401293.313,Forest Hills
21-Jun,36081064500,4064500,11404,63474,74878,Queens,3401293.313,Forest Hills
19-Jul,36081064500,4064500,8057,142872,150929,Queens,3401293.313,Forest Hills
21-Jul,36081064500,4064500,10265,87539,97804,Queens,3401293.313,Forest Hills
19-Aug,36081064500,4064500,4942,50493,55435,Queens,3401293.313,Forest Hills
21-Aug,36081064500,4064500,5649,2635,8284,Queens,3401293.313,Forest Hills
19-May,36081064600,4064600,16617,90537,107154,Queens,4431420.371,Laurelton
21-May,36081064600,4064600,2223,71,2294,Queens,4431420.371,Laurelton
19-Jun,36081064600,4064600,3856,52920,56776,Queens,4431420.371,Laurelton
21-Jun,36081064600,4064600,8621,84824,93445,Queens,4431420.371,Laurelton
19-Jul,36081064600,4064600,10971,97075,108046,Queens,4431420.371,Laurelton
21-Jul,36081064600,4064600,12928,141199,154127,Queens,4431420.371,Laurelton
19-Aug,36081064600,4064600,6656,102088,108744,Queens,4431420.371,Laurelton
21-Aug,36081064600,4064600,10537,65297,75834,Queens,4431420.371,Laurelton
19-May,36081065000,4065000,12618,36123,48741,Queens,4304601.872,Laurelton
21-May,36081065000,4065000,3138,108786,111924,Queens,4304601.872,Laurelton
19-Jun,36081065000,4065000,5511,102800,108311,Queens,4304601.872,Laurelton
21-Jun,36081065000,4065000,11473,73564,85037,Queens,4304601.872,Laurelton
19-Jul,36081065000,4065000,0,40573,40573,Queens,4304601.872,Laurelton
21-Jul,36081065000,4065000,7392,33284,40676,Queens,4304601.872,Laurelton
19-Aug,36081065000,4065000,919,84327,85246,Queens,4304601.872,Laurelton
21-Aug,36081065000,4065000,952,117766,118718,Queens,4304601.872,Laurelton
19-May,36081065401,4065401,14325,80163,94488,Queens,4637075.524,Rosedale
21-May,36081065401,4065401,11332,32131,43463,Queens,4637075.524,Rosedale
19-Jun,36081065401,4065401,6809,79127,85936,Queens,4637075.524,Rosedale
21-Jun,36081065401,4065401,5675,140118,145793,Queens,4637075.524,Rosedale
19-Jul,36081065401,4065401,6687,49487,56174,Queens,4637075.524,Rosedale
21-Jul,36081065401,4065401,1201,85052,86253,Queens,4637075.524,Rosedale
19-Aug,36081065401,4065401,9293,43213,52506,Queens,4637075.524,Rosedale
21-Aug,36081065401,4065401,10603,152824,163427,Queens,4637075.524,Rosedale
19-May,36081065402,4065402,20828,49692,70520,Queens,2865941.962,Springfield Gardens (South)-Brookville
21-May,36081065402,4065402,2196,50719,52915,Queens,2865941.962,Springfield Gardens (South)-Brookville
19-Jun,36081065402,4065402,5460,131290,136750,Queens,2865941.962,Springfield Gardens (South)-Brookville
21-Jun,36081065402,4065402,5368,103100,108468,Queens,2865941.962,Springfield Gardens (South)-Brookville
19-Jul,36081065402,4065402,2023,89487,91510,Queens,2865941.962,Springfield Gardens (South)-Brookville
21-Jul,36081065402,4065402,14150,58745,72895,Queens,2865941.962,Springfield Gardens (South)-Brookville
19-Aug,36081065402,4065402,8266,85735,94001,Queens,2865941.962,Springfield Gardens (South)-Brookville
21-Aug,36081065402,4065402,8341,82755,91096,Queens,2865941.962,Springfield Gardens (South)-Brookville
19-May,36081065600,4065600,15785,67204,82989,Queens,6346461.906,Rosedale
21-May,36081065600,4065600,8945,115504,124449,Queens,6346461.906,Rosedale
19-Jun,36081065600,4065600,969,46406,47375,Queens,6346461.906,Rosedale
21-Jun,36081065600,4065600,10040,22283,32323,Queens,6346461.906,Rosedale
19-Jul,36081065600,4065600,8973,108646,117619,Queens,6346461.906,Rosedale
21-Jul,36081065600,4065600,12044,131675,143719,Queens,6346461.906,Rosedale
19-Aug,36081065600,4065600,11785,12375,24160,Queens,6346461.906,Rosedale
21-Aug,36081065600,4065600,0,71,71,Queens,6346461.906,Rosedale
19-May,36081065702,4065702,14413,66251,80664,Queens,1547771.975,Middle Village
21-May,36081065702,4065702,12474,3144,15618,Queens,1547771.975,Middle Village
19-Jun,36081065702,4065702,2785,52502,55287,Queens,1547771.975,Middle Village
21-Jun,36081065702,4065702,6540,61081,67621,Queens,1547771.975,Middle Village
19-Jul,36081065702,4065702,10746,109411,120157,Queens,1547771.975,Middle Village
21-Jul,36081065702,4065702,2446,125836,128282,Queens,1547771.975,Middle Village
19-Aug,36081065702,4065702,6965,65008,71973,Queens,1547771.975,Middle Village
21-Aug,36081065702,4065702,5962,63365,69327,Queens,1547771.975,Middle Village
19-May,36081065703,4065703,10026,112586,122612,Queens,2889534.899,Middle Village
21-May,36081065703,4065703,4691,96047,100738,Queens,2889534.899,Middle Village
19-Jun,36081065703,4065703,11791,31200,42991,Queens,2889534.899,Middle Village
21-Jun,36081065703,4065703,15167,34682,49849,Queens,2889534.899,Middle Village
19-Jul,36081065703,4065703,9400,35083,44483,Queens,2889534.899,Middle Village
21-Jul,36081065703,4065703,12004,46401,58405,Queens,2889534.899,Middle Village
19-Aug,36081065703,4065703,7514,82506,90020,Queens,2889534.899,Middle Village
21-Aug,36081065703,4065703,8090,52264,60354,Queens,2889534.899,Middle Village
19-May,36081066000,4066000,4116,32346,36462,Queens,4160670.397,Rosedale
21-May,36081066000,4066000,4355,26849,31204,Queens,4160670.397,Rosedale
19-Jun,36081066000,4066000,6769,80994,87763,Queens,4160670.397,Rosedale
21-Jun,36081066000,4066000,2004,126314,128318,Queens,4160670.397,Rosedale
19-Jul,36081066000,4066000,6608,81118,87726,Queens,4160670.397,Rosedale
21-Jul,36081066000,4066000,11228,144954,156182,Queens,4160670.397,Rosedale
19-Aug,36081066000,4066000,1981,62222,64203,Queens,4160670.397,Rosedale
21-Aug,36081066000,4066000,4900,119504,124404,Queens,4160670.397,Rosedale
19-May,36081066301,4066301,6212,57830,64042,Queens,3017250.413,Middle Village
21-May,36081066301,4066301,9311,29808,39119,Queens,3017250.413,Middle Village
19-Jun,36081066301,4066301,10164,27085,37249,Queens,3017250.413,Middle Village
21-Jun,36081066301,4066301,9083,153188,162271,Queens,3017250.413,Middle Village
19-Jul,36081066301,4066301,13158,130204,143362,Queens,3017250.413,Middle Village
21-Jul,36081066301,4066301,10061,137806,147867,Queens,3017250.413,Middle Village
19-Aug,36081066301,4066301,18168,111457,129625,Queens,3017250.413,Middle Village
21-Aug,36081066301,4066301,14130,99902,114032,Queens,3017250.413,Middle Village
19-May,36081066302,4066302,11152,168295,179447,Queens,2656996.368,Middle Village
21-May,36081066302,4066302,1388,34027,35415,Queens,2656996.368,Middle Village
19-Jun,36081066302,4066302,5452,73195,78647,Queens,2656996.368,Middle Village
21-Jun,36081066302,4066302,13537,105242,118779,Queens,2656996.368,Middle Village
19-Jul,36081066302,4066302,10563,50757,61320,Queens,2656996.368,Middle Village
21-Jul,36081066302,4066302,13990,24695,38685,Queens,2656996.368,Middle Village
19-Aug,36081066302,4066302,3875,55907,59782,Queens,2656996.368,Middle Village
21-Aug,36081066302,4066302,11752,62332,74084,Queens,2656996.368,Middle Village
19-May,36081066402,4066402,8214,94026,102240,Queens,4232911.464,Rosedale
21-May,36081066402,4066402,13469,91656,105125,Queens,4232911.464,Rosedale
19-Jun,36081066402,4066402,5109,42864,47973,Queens,4232911.464,Rosedale
21-Jun,36081066402,4066402,2591,130007,132598,Queens,4232911.464,Rosedale
19-Jul,36081066402,4066402,5654,89227,94881,Queens,4232911.464,Rosedale
21-Jul,36081066402,4066402,17639,25999,43638,Queens,4232911.464,Rosedale
19-Aug,36081066402,4066402,13348,49344,62692,Queens,4232911.464,Rosedale
21-Aug,36081066402,4066402,9555,100003,109558,Queens,4232911.464,Rosedale
19-May,36081066403,4066403,5310,76898,82208,Queens,3916205.365,Rosedale
21-May,36081066403,4066403,4105,65951,70056,Queens,3916205.365,Rosedale
19-Jun,36081066403,4066403,18761,152486,171247,Queens,3916205.365,Rosedale
21-Jun,36081066403,4066403,864,78586,79450,Queens,3916205.365,Rosedale
19-Jul,36081066403,4066403,8872,54875,63747,Queens,3916205.365,Rosedale
21-Jul,36081066403,4066403,13631,68387,82018,Queens,3916205.365,Rosedale
19-Aug,36081066403,4066403,2536,78029,80565,Queens,3916205.365,Rosedale
21-Aug,36081066403,4066403,6551,58302,64853,Queens,3916205.365,Rosedale
19-May,36081066701,4066701,4752,57009,61761,Queens,2769361.346,Maspeth
21-May,36081066701,4066701,7176,111993,119169,Queens,2769361.346,Maspeth
19-Jun,36081066701,4066701,8208,70062,78270,Queens,2769361.346,Maspeth
21-Jun,36081066701,4066701,10644,51892,62536,Queens,2769361.346,Maspeth
19-Jul,36081066701,4066701,10530,22519,33049,Queens,2769361.346,Maspeth
21-Jul,36081066701,4066701,9077,96464,105541,Queens,2769361.346,Maspeth
19-Aug,36081066701,4066701,15643,40732,56375,Queens,2769361.346,Maspeth
21-Aug,36081066701,4066701,9300,51198,60498,Queens,2769361.346,Maspeth
19-May,36081067100,4067100,18291,101701,119992,Queens,2465973.964,Middle Village
21-May,36081067100,4067100,5884,146779,152663,Queens,2465973.964,Middle Village
19-Jun,36081067100,4067100,10285,115828,126113,Queens,2465973.964,Middle Village
21-Jun,36081067100,4067100,14033,50059,64092,Queens,2465973.964,Middle Village
19-Jul,36081067100,4067100,9432,47539,56971,Queens,2465973.964,Middle Village
21-Jul,36081067100,4067100,10402,113435,123837,Queens,2465973.964,Middle Village
19-Aug,36081067100,4067100,4351,129780,134131,Queens,2465973.964,Middle Village
21-Aug,36081067100,4067100,2200,92865,95065,Queens,2465973.964,Middle Village
19-May,36081067700,4067700,6013,94032,100045,Queens,2001637.183,Middle Village
21-May,36081067700,4067700,19657,51176,70833,Queens,2001637.183,Middle Village
19-Jun,36081067700,4067700,9369,65989,75358,Queens,2001637.183,Middle Village
21-Jun,36081067700,4067700,5691,71994,77685,Queens,2001637.183,Middle Village
19-Jul,36081067700,4067700,6354,75329,81683,Queens,2001637.183,Middle Village
21-Jul,36081067700,4067700,4853,65557,70410,Queens,2001637.183,Middle Village
19-Aug,36081067700,4067700,3691,62106,65797,Queens,2001637.183,Middle Village
21-Aug,36081067700,4067700,15782,36919,52701,Queens,2001637.183,Middle Village
19-May,36081068200,4068200,6470,105044,111514,Queens,2492489.824,Laurelton
21-May,36081068200,4068200,9905,92218,102123,Queens,2492489.824,Laurelton
19-Jun,36081068200,4068200,10677,142534,153211,Queens,2492489.824,Laurelton
21-Jun,36081068200,4068200,9652,102109,111761,Queens,2492489.824,Laurelton
19-Jul,36081068200,4068200,11146,96648,107794,Queens,2492489.824,Laurelton
21-Jul,36081068200,4068200,14422,20741,35163,Queens,2492489.824,Laurelton
19-Aug,36081068200,4068200,1477,125789,127266,Queens,2492489.824,Laurelton
21-Aug,36081068200,4068200,12581,74817,87398,Queens,2492489.824,Laurelton
19-May,36081068300,4068300,6434,94595,101029,Queens,2632326.655,Elmhurst
21-May,36081068300,4068300,10102,117683,127785,Queens,2632326.655,Elmhurst
19-Jun,36081068300,4068300,4568,27955,32523,Queens,2632326.655,Elmhurst
21-Jun,36081068300,4068300,5109,87714,92823,Queens,2632326.655,Elmhurst
19-Jul,36081068300,4068300,6082,28385,34467,Queens,2632326.655,Elmhurst
21-Jul,36081068300,4068300,11717,166082,177799,Queens,2632326.655,Elmhurst
19-Aug,36081068300,4068300,18884,95874,114758,Queens,2632326.655,Elmhurst
21-Aug,36081068300,4068300,10427,60726,71153,Queens,2632326.655,Elmhurst
19-May,36081069300,4069300,8497,72050,80547,Queens,1538773.714,Rego Park
21-May,36081069300,4069300,7577,155834,163411,Queens,1538773.714,Rego Park
19-Jun,36081069300,4069300,4715,46519,51234,Queens,1538773.714,Rego Park
21-Jun,36081069300,4069300,9440,112110,121550,Queens,1538773.714,Rego Park
19-Jul,36081069300,4069300,301,53346,53647,Queens,1538773.714,Rego Park
21-Jul,36081069300,4069300,8850,118011,126861,Queens,1538773.714,Rego Park
19-Aug,36081069300,4069300,16681,26433,43114,Queens,1538773.714,Rego Park
21-Aug,36081069300,4069300,22845,73832,96677,Queens,1538773.714,Rego Park
19-May,36081069500,4069500,10510,43677,54187,Queens,2295318.78,Rego Park
21-May,36081069500,4069500,12632,65205,77837,Queens,2295318.78,Rego Park
19-Jun,36081069500,4069500,4919,99628,104547,Queens,2295318.78,Rego Park
21-Jun,36081069500,4069500,7950,62238,70188,Queens,2295318.78,Rego Park
19-Jul,36081069500,4069500,13046,98418,111464,Queens,2295318.78,Rego Park
21-Jul,36081069500,4069500,6595,68251,74846,Queens,2295318.78,Rego Park
19-Aug,36081069500,4069500,8570,20729,29299,Queens,2295318.78,Rego Park
21-Aug,36081069500,4069500,5219,105588,110807,Queens,2295318.78,Rego Park
19-May,36081069701,4069701,3961,113338,117299,Queens,1432171.615,Rego Park
21-May,36081069701,4069701,7609,82258,89867,Queens,1432171.615,Rego Park
19-Jun,36081069701,4069701,7135,71,7206,Queens,1432171.615,Rego Park
21-Jun,36081069701,4069701,16977,86204,103181,Queens,1432171.615,Rego Park
19-Jul,36081069701,4069701,10047,42876,52923,Queens,1432171.615,Rego Park
21-Jul,36081069701,4069701,5057,27593,32650,Queens,1432171.615,Rego Park
19-Aug,36081069701,4069701,0,68885,68885,Queens,1432171.615,Rego Park
21-Aug,36081069701,4069701,4542,70766,75308,Queens,1432171.615,Rego Park
19-May,36081070700,4070700,7980,82921,90901,Queens,2389558.694,Forest Hills
21-May,36081070700,4070700,6461,24147,30608,Queens,2389558.694,Forest Hills
19-Jun,36081070700,4070700,12134,74177,86311,Queens,2389558.694,Forest Hills
21-Jun,36081070700,4070700,13077,93530,106607,Queens,2389558.694,Forest Hills
19-Jul,36081070700,4070700,8406,92259,100665,Queens,2389558.694,Forest Hills
21-Jul,36081070700,4070700,13112,38296,51408,Queens,2389558.694,Forest Hills
19-Aug,36081070700,4070700,0,79900,79900,Queens,2389558.694,Forest Hills
21-Aug,36081070700,4070700,6186,83229,89415,Queens,2389558.694,Forest Hills
19-May,36081071303,4071303,7541,20000,27541,Queens,1524257.972,Forest Hills
21-May,36081071303,4071303,9563,74979,84542,Queens,1524257.972,Forest Hills
19-Jun,36081071303,4071303,7493,35616,43109,Queens,1524257.972,Forest Hills
21-Jun,36081071303,4071303,3823,130028,133851,Queens,1524257.972,Forest Hills
19-Jul,36081071303,4071303,8071,71,8142,Queens,1524257.972,Forest Hills
21-Jul,36081071303,4071303,4758,68831,73589,Queens,1524257.972,Forest Hills
19-Aug,36081071303,4071303,1901,200969,202870,Queens,1524257.972,Forest Hills
21-Aug,36081071303,4071303,11687,130997,142684,Queens,1524257.972,Forest Hills
19-May,36081071304,4071304,11683,26577,38260,Queens,1680454.998,Forest Hills
21-May,36081071304,4071304,12886,107184,120070,Queens,1680454.998,Forest Hills
19-Jun,36081071304,4071304,9321,81874,91195,Queens,1680454.998,Forest Hills
21-Jun,36081071304,4071304,2920,147137,150057,Queens,1680454.998,Forest Hills
19-Jul,36081071304,4071304,1095,55373,56468,Queens,1680454.998,Forest Hills
21-Jul,36081071304,4071304,16878,86638,103516,Queens,1680454.998,Forest Hills
19-Aug,36081071304,4071304,10409,62694,73103,Queens,1680454.998,Forest Hills
21-Aug,36081071304,4071304,8411,5337,13748,Queens,1680454.998,Forest Hills
19-May,36081071305,4071305,6611,73818,80429,Queens,1441518.45,Forest Hills
21-May,36081071305,4071305,7040,72277,79317,Queens,1441518.45,Forest Hills
19-Jun,36081071305,4071305,7049,54875,61924,Queens,1441518.45,Forest Hills
21-Jun,36081071305,4071305,13326,74477,87803,Queens,1441518.45,Forest Hills
19-Jul,36081071305,4071305,10945,224626,235571,Queens,1441518.45,Forest Hills
21-Jul,36081071305,4071305,7591,27714,35305,Queens,1441518.45,Forest Hills
19-Aug,36081071305,4071305,11830,115315,127145,Queens,1441518.45,Forest Hills
21-Aug,36081071305,4071305,15665,40091,55756,Queens,1441518.45,Forest Hills
19-May,36081071701,4071701,7760,63717,71477,Queens,2044997.987,Rego Park
21-May,36081071701,4071701,11723,60271,71994,Queens,2044997.987,Rego Park
19-Jun,36081071701,4071701,4287,79442,83729,Queens,2044997.987,Rego Park
21-Jun,36081071701,4071701,7466,138007,145473,Queens,2044997.987,Rego Park
19-Jul,36081071701,4071701,13290,17392,30682,Queens,2044997.987,Rego Park
21-Jul,36081071701,4071701,4932,84155,89087,Queens,2044997.987,Rego Park
19-Aug,36081071701,4071701,8642,38168,46810,Queens,2044997.987,Rego Park
21-Aug,36081071701,4071701,9752,32859,42611,Queens,2044997.987,Rego Park
19-May,36081071900,4071900,5222,95643,100865,Queens,1783745.51,Forest Hills
21-May,36081071900,4071900,3621,73638,77259,Queens,1783745.51,Forest Hills
19-Jun,36081071900,4071900,9955,120902,130857,Queens,1783745.51,Forest Hills
21-Jun,36081071900,4071900,14771,6279,21050,Queens,1783745.51,Forest Hills
19-Jul,36081071900,4071900,6265,21028,27293,Queens,1783745.51,Forest Hills
21-Jul,36081071900,4071900,5609,75125,80734,Queens,1783745.51,Forest Hills
19-Aug,36081071900,4071900,8109,26825,34934,Queens,1783745.51,Forest Hills
21-Aug,36081071900,4071900,16509,75610,92119,Queens,1783745.51,Forest Hills
19-May,36081072100,4072100,8577,91603,100180,Queens,1818395.472,Forest Hills
21-May,36081072100,4072100,12004,123020,135024,Queens,1818395.472,Forest Hills
19-Jun,36081072100,4072100,10356,57820,68176,Queens,1818395.472,Forest Hills
21-Jun,36081072100,4072100,476,138793,139269,Queens,1818395.472,Forest Hills
19-Jul,36081072100,4072100,13061,96585,109646,Queens,1818395.472,Forest Hills
21-Jul,36081072100,4072100,10623,75556,86179,Queens,1818395.472,Forest Hills
19-Aug,36081072100,4072100,5934,7432,13366,Queens,1818395.472,Forest Hills
21-Aug,36081072100,4072100,5182,40174,45356,Queens,1818395.472,Forest Hills
19-May,36081072300,4072300,6203,85908,92111,Queens,5060335.891,Forest Hills
21-May,36081072300,4072300,6095,57398,63493,Queens,5060335.891,Forest Hills
19-Jun,36081072300,4072300,6360,50176,56536,Queens,5060335.891,Forest Hills
21-Jun,36081072300,4072300,4951,148259,153210,Queens,5060335.891,Forest Hills
19-Jul,36081072300,4072300,9379,47809,57188,Queens,5060335.891,Forest Hills
21-Jul,36081072300,4072300,7712,55663,63375,Queens,5060335.891,Forest Hills
19-Aug,36081072300,4072300,4843,29380,34223,Queens,5060335.891,Forest Hills
21-Aug,36081072300,4072300,13763,81430,95193,Queens,5060335.891,Forest Hills
19-May,36081072900,4072900,19222,95614,114836,Queens,2085109.025,Forest Hills
21-May,36081072900,4072900,2572,71165,73737,Queens,2085109.025,Forest Hills
19-Jun,36081072900,4072900,14702,101979,116681,Queens,2085109.025,Forest Hills
21-Jun,36081072900,4072900,14352,55293,69645,Queens,2085109.025,Forest Hills
19-Jul,36081072900,4072900,0,54350,54350,Queens,2085109.025,Forest Hills
21-Jul,36081072900,4072900,3760,72505,76265,Queens,2085109.025,Forest Hills
19-Aug,36081072900,4072900,20482,124203,144685,Queens,2085109.025,Forest Hills
21-Aug,36081072900,4072900,2211,35565,37776,Queens,2085109.025,Forest Hills
19-May,36081073700,4073700,20054,5927,25981,Queens,2268850.492,Forest Hills
21-May,36081073700,4073700,7815,153627,161442,Queens,2268850.492,Forest Hills
19-Jun,36081073700,4073700,14096,29776,43872,Queens,2268850.492,Forest Hills
21-Jun,36081073700,4073700,10436,29883,40319,Queens,2268850.492,Forest Hills
19-Jul,36081073700,4073700,8756,75082,83838,Queens,2268850.492,Forest Hills
21-Jul,36081073700,4073700,5136,75987,81123,Queens,2268850.492,Forest Hills
19-Aug,36081073700,4073700,0,35974,35974,Queens,2268850.492,Forest Hills
21-Aug,36081073700,4073700,10938,97702,108640,Queens,2268850.492,Forest Hills
19-May,36081073900,4073900,6692,87027,93719,Queens,2410955.737,Forest Hills
21-May,36081073900,4073900,8439,45011,53450,Queens,2410955.737,Forest Hills
19-Jun,36081073900,4073900,1146,80941,82087,Queens,2410955.737,Forest Hills
21-Jun,36081073900,4073900,10153,62320,72473,Queens,2410955.737,Forest Hills
19-Jul,36081073900,4073900,6174,92288,98462,Queens,2410955.737,Forest Hills
21-Jul,36081073900,4073900,12767,14007,26774,Queens,2410955.737,Forest Hills
19-Aug,36081073900,4073900,7525,98447,105972,Queens,2410955.737,Forest Hills
21-Aug,36081073900,4073900,5896,108119,114015,Queens,2410955.737,Forest Hills
19-May,36081074100,4074100,0,88619,88619,Queens,1850016.892,Forest Hills
21-May,36081074100,4074100,8859,64601,73460,Queens,1850016.892,Forest Hills
19-Jun,36081074100,4074100,11914,52443,64357,Queens,1850016.892,Forest Hills
21-Jun,36081074100,4074100,8697,104895,113592,Queens,1850016.892,Forest Hills
19-Jul,36081074100,4074100,1921,105396,107317,Queens,1850016.892,Forest Hills
21-Jul,36081074100,4074100,9012,112965,121977,Queens,1850016.892,Forest Hills
19-Aug,36081074100,4074100,7030,107088,114118,Queens,1850016.892,Forest Hills
21-Aug,36081074100,4074100,397,85281,85678,Queens,1850016.892,Forest Hills
19-May,36081074300,4074300,8539,17072,25611,Queens,2083264.303,Forest Hills
21-May,36081074300,4074300,15260,34311,49571,Queens,2083264.303,Forest Hills
19-Jun,36081074300,4074300,3751,93033,96784,Queens,2083264.303,Forest Hills
21-Jun,36081074300,4074300,6150,137039,143189,Queens,2083264.303,Forest Hills
19-Jul,36081074300,4074300,11364,73218,84582,Queens,2083264.303,Forest Hills
21-Jul,36081074300,4074300,8501,125214,133715,Queens,2083264.303,Forest Hills
19-Aug,36081074300,4074300,11767,102796,114563,Queens,2083264.303,Forest Hills
21-Aug,36081074300,4074300,3549,60104,63653,Queens,2083264.303,Forest Hills
19-May,36081074500,4074500,943,135453,136396,Queens,1878207.946,Forest Hills
21-May,36081074500,4074500,6283,87160,93443,Queens,1878207.946,Forest Hills
19-Jun,36081074500,4074500,4242,71,4313,Queens,1878207.946,Forest Hills
21-Jun,36081074500,4074500,0,70053,70053,Queens,1878207.946,Forest Hills
19-Jul,36081074500,4074500,12500,42686,55186,Queens,1878207.946,Forest Hills
21-Jul,36081074500,4074500,11540,117454,128994,Queens,1878207.946,Forest Hills
19-Aug,36081074500,4074500,2843,111849,114692,Queens,1878207.946,Forest Hills
21-Aug,36081074500,4074500,4188,105913,110101,Queens,1878207.946,Forest Hills
19-May,36081074700,4074700,3909,136868,140777,Queens,3175255.142,Forest Hills
21-May,36081074700,4074700,5977,37017,42994,Queens,3175255.142,Forest Hills
19-Jun,36081074700,4074700,6923,92445,99368,Queens,3175255.142,Forest Hills
21-Jun,36081074700,4074700,14859,91025,105884,Queens,3175255.142,Forest Hills
19-Jul,36081074700,4074700,2075,42045,44120,Queens,3175255.142,Forest Hills
21-Jul,36081074700,4074700,13144,107148,120292,Queens,3175255.142,Forest Hills
19-Aug,36081074700,4074700,9354,32952,42306,Queens,3175255.142,Forest Hills
21-Aug,36081074700,4074700,9517,95694,105211,Queens,3175255.142,Forest Hills
19-May,36081075701,4075701,0,82641,82641,Queens,2126567.857,Forest Hills
21-May,36081075701,4075701,8318,150183,158501,Queens,2126567.857,Forest Hills
19-Jun,36081075701,4075701,2654,65079,67733,Queens,2126567.857,Forest Hills
21-Jun,36081075701,4075701,7739,95624,103363,Queens,2126567.857,Forest Hills
19-Jul,36081075701,4075701,13747,68697,82444,Queens,2126567.857,Forest Hills
21-Jul,36081075701,4075701,1094,85558,86652,Queens,2126567.857,Forest Hills
19-Aug,36081075701,4075701,4056,67241,71297,Queens,2126567.857,Forest Hills
21-Aug,36081075701,4075701,4311,117292,121603,Queens,2126567.857,Forest Hills
19-May,36081075702,4075702,9923,26481,36404,Queens,3781074.758,Forest Hills
21-May,36081075702,4075702,7153,73912,81065,Queens,3781074.758,Forest Hills
19-Jun,36081075702,4075702,11663,79244,90907,Queens,3781074.758,Forest Hills
21-Jun,36081075702,4075702,8182,91504,99686,Queens,3781074.758,Forest Hills
19-Jul,36081075702,4075702,3433,54350,57783,Queens,3781074.758,Forest Hills
21-Jul,36081075702,4075702,10205,7534,17739,Queens,3781074.758,Forest Hills
19-Aug,36081075702,4075702,164,37374,37538,Queens,3781074.758,Forest Hills
21-Aug,36081075702,4075702,8489,40831,49320,Queens,3781074.758,Forest Hills
19-May,36081077902,4077902,7421,43457,50878,Queens,6023219.057,Kew Gardens Hills
21-May,36081077902,4077902,8490,61721,70211,Queens,6023219.057,Kew Gardens Hills
19-Jun,36081077902,4077902,0,105195,105195,Queens,6023219.057,Kew Gardens Hills
21-Jun,36081077902,4077902,11799,65314,77113,Queens,6023219.057,Kew Gardens Hills
19-Jul,36081077902,4077902,6758,132021,138779,Queens,6023219.057,Kew Gardens Hills
21-Jul,36081077902,4077902,9885,7998,17883,Queens,6023219.057,Kew Gardens Hills
19-Aug,36081077902,4077902,4641,108512,113153,Queens,6023219.057,Kew Gardens Hills
21-Aug,36081077902,4077902,6213,86094,92307,Queens,6023219.057,Kew Gardens Hills
19-May,36081077903,4077903,5242,61785,67027,Queens,2829805.699,Kew Gardens Hills
21-May,36081077903,4077903,2739,125558,128297,Queens,2829805.699,Kew Gardens Hills
19-Jun,36081077903,4077903,7565,42185,49750,Queens,2829805.699,Kew Gardens Hills
21-Jun,36081077903,4077903,1843,44030,45873,Queens,2829805.699,Kew Gardens Hills
19-Jul,36081077903,4077903,2198,87373,89571,Queens,2829805.699,Kew Gardens Hills
21-Jul,36081077903,4077903,10191,133256,143447,Queens,2829805.699,Kew Gardens Hills
19-Aug,36081077903,4077903,5320,122302,127622,Queens,2829805.699,Kew Gardens Hills
21-Aug,36081077903,4077903,2749,14356,17105,Queens,2829805.699,Kew Gardens Hills
19-May,36081077904,4077904,8152,52624,60776,Queens,4162642.572,Kew Gardens Hills
21-May,36081077904,4077904,10666,36808,47474,Queens,4162642.572,Kew Gardens Hills
19-Jun,36081077904,4077904,11970,66449,78419,Queens,4162642.572,Kew Gardens Hills
21-Jun,36081077904,4077904,11184,52577,63761,Queens,4162642.572,Kew Gardens Hills
19-Jul,36081077904,4077904,12330,1371,13701,Queens,4162642.572,Kew Gardens Hills
21-Jul,36081077904,4077904,7078,88830,95908,Queens,4162642.572,Kew Gardens Hills
19-Aug,36081077904,4077904,6605,71,6676,Queens,4162642.572,Kew Gardens Hills
21-Aug,36081077904,4077904,9322,102898,112220,Queens,4162642.572,Kew Gardens Hills
19-May,36081077906,4077906,11555,78799,90354,Queens,3108729.127,Kew Gardens Hills
21-May,36081077906,4077906,21122,33265,54387,Queens,3108729.127,Kew Gardens Hills
19-Jun,36081077906,4077906,17314,101570,118884,Queens,3108729.127,Kew Gardens Hills
21-Jun,36081077906,4077906,10152,27738,37890,Queens,3108729.127,Kew Gardens Hills
19-Jul,36081077906,4077906,20822,96570,117392,Queens,3108729.127,Kew Gardens Hills
21-Jul,36081077906,4077906,7273,126299,133572,Queens,3108729.127,Kew Gardens Hills
19-Aug,36081077906,4077906,4447,87276,91723,Queens,3108729.127,Kew Gardens Hills
21-Aug,36081077906,4077906,10138,71,10209,Queens,3108729.127,Kew Gardens Hills
19-May,36081077907,4077907,0,46993,46993,Queens,2330099.659,Kew Gardens Hills
21-May,36081077907,4077907,10599,71,10670,Queens,2330099.659,Kew Gardens Hills
19-Jun,36081077907,4077907,863,92392,93255,Queens,2330099.659,Kew Gardens Hills
21-Jun,36081077907,4077907,8833,41539,50372,Queens,2330099.659,Kew Gardens Hills
19-Jul,36081077907,4077907,2325,97619,99944,Queens,2330099.659,Kew Gardens Hills
21-Jul,36081077907,4077907,980,72405,73385,Queens,2330099.659,Kew Gardens Hills
19-Aug,36081077907,4077907,6382,55487,61869,Queens,2330099.659,Kew Gardens Hills
21-Aug,36081077907,4077907,11928,79021,90949,Queens,2330099.659,Kew Gardens Hills
19-May,36081077908,4077908,1985,76269,78254,Queens,2156618.581,Kew Gardens Hills
21-May,36081077908,4077908,7054,46492,53546,Queens,2156618.581,Kew Gardens Hills
19-Jun,36081077908,4077908,12407,71,12478,Queens,2156618.581,Kew Gardens Hills
21-Jun,36081077908,4077908,12079,97698,109777,Queens,2156618.581,Kew Gardens Hills
19-Jul,36081077908,4077908,15492,36626,52118,Queens,2156618.581,Kew Gardens Hills
21-Jul,36081077908,4077908,12084,9956,22040,Queens,2156618.581,Kew Gardens Hills
19-Aug,36081077908,4077908,2806,71120,73926,Queens,2156618.581,Kew Gardens Hills
21-Aug,36081077908,4077908,8079,132073,140152,Queens,2156618.581,Kew Gardens Hills
19-May,36081078800,4078800,4197,67529,71726,Queens,2075692.369,Baisley Park
21-May,36081078800,4078800,6968,22352,29320,Queens,2075692.369,Baisley Park
19-Jun,36081078800,4078800,9046,51670,60716,Queens,2075692.369,Baisley Park
21-Jun,36081078800,4078800,14722,94932,109654,Queens,2075692.369,Baisley Park
19-Jul,36081078800,4078800,13569,2935,16504,Queens,2075692.369,Baisley Park
21-Jul,36081078800,4078800,15356,73346,88702,Queens,2075692.369,Baisley Park
19-Aug,36081078800,4078800,0,71,71,Queens,2075692.369,Baisley Park
21-Aug,36081078800,4078800,2000,80179,82179,Queens,2075692.369,Baisley Park
19-May,36081079000,4079000,16229,17236,33465,Queens,2799200.274,Baisley Park
21-May,36081079000,4079000,9068,3301,12369,Queens,2799200.274,Baisley Park
19-Jun,36081079000,4079000,6568,89590,96158,Queens,2799200.274,Baisley Park
21-Jun,36081079000,4079000,10936,58745,69681,Queens,2799200.274,Baisley Park
19-Jul,36081079000,4079000,9542,71,9613,Queens,2799200.274,Baisley Park
21-Jul,36081079000,4079000,12300,33075,45375,Queens,2799200.274,Baisley Park
19-Aug,36081079000,4079000,6948,26838,33786,Queens,2799200.274,Baisley Park
21-Aug,36081079000,4079000,7207,99811,107018,Queens,2799200.274,Baisley Park
19-May,36081079200,4079200,12407,68390,80797,Queens,3932343.859,Baisley Park
21-May,36081079200,4079200,9024,141413,150437,Queens,3932343.859,Baisley Park
19-Jun,36081079200,4079200,4689,29797,34486,Queens,3932343.859,Baisley Park
21-Jun,36081079200,4079200,5778,71705,77483,Queens,3932343.859,Baisley Park
19-Jul,36081079200,4079200,16710,64815,81525,Queens,3932343.859,Baisley Park
21-Jul,36081079200,4079200,0,145122,145122,Queens,3932343.859,Baisley Park
19-Aug,36081079200,4079200,1135,53438,54573,Queens,3932343.859,Baisley Park
21-Aug,36081079200,4079200,9555,43544,53099,Queens,3932343.859,Baisley Park
19-May,36081079300,4079300,5381,31304,36685,Queens,9208957.997,Mount Hebron & Cedar Grove Cemeteries
21-May,36081079300,4079300,9780,109864,119644,Queens,9208957.997,Mount Hebron & Cedar Grove Cemeteries
19-Jun,36081079300,4079300,6979,73922,80901,Queens,9208957.997,Mount Hebron & Cedar Grove Cemeteries
21-Jun,36081079300,4079300,9254,40480,49734,Queens,9208957.997,Mount Hebron & Cedar Grove Cemeteries
19-Jul,36081079300,4079300,8132,5380,13512,Queens,9208957.997,Mount Hebron & Cedar Grove Cemeteries
21-Jul,36081079300,4079300,5027,87165,92192,Queens,9208957.997,Mount Hebron & Cedar Grove Cemeteries
19-Aug,36081079300,4079300,6156,96274,102430,Queens,9208957.997,Mount Hebron & Cedar Grove Cemeteries
21-Aug,36081079300,4079300,13801,90679,104480,Queens,9208957.997,Mount Hebron & Cedar Grove Cemeteries
19-May,36081079701,4079701,3679,101451,105130,Queens,1199494.68,Flushing-Willets Point
21-May,36081079701,4079701,11124,76811,87935,Queens,1199494.68,Flushing-Willets Point
19-Jun,36081079701,4079701,12936,110076,123012,Queens,1199494.68,Flushing-Willets Point
21-Jun,36081079701,4079701,6471,84266,90737,Queens,1199494.68,Flushing-Willets Point
19-Jul,36081079701,4079701,9854,71,9925,Queens,1199494.68,Flushing-Willets Point
21-Jul,36081079701,4079701,6283,39142,45425,Queens,1199494.68,Flushing-Willets Point
19-Aug,36081079701,4079701,5120,128935,134055,Queens,1199494.68,Flushing-Willets Point
21-Aug,36081079701,4079701,14675,98636,113311,Queens,1199494.68,Flushing-Willets Point
19-May,36081079702,4079702,13300,71,13371,Queens,3075801.504,Flushing-Willets Point
21-May,36081079702,4079702,14690,75916,90606,Queens,3075801.504,Flushing-Willets Point
19-Jun,36081079702,4079702,3523,71,3594,Queens,3075801.504,Flushing-Willets Point
21-Jun,36081079702,4079702,19476,37623,57099,Queens,3075801.504,Flushing-Willets Point
19-Jul,36081079702,4079702,17201,1399,18600,Queens,3075801.504,Flushing-Willets Point
21-Jul,36081079702,4079702,17361,84717,102078,Queens,3075801.504,Flushing-Willets Point
19-Aug,36081079702,4079702,9638,65396,75034,Queens,3075801.504,Flushing-Willets Point
21-Aug,36081079702,4079702,2981,24364,27345,Queens,3075801.504,Flushing-Willets Point
19-May,36081079900,4079900,7747,33231,40978,Queens,3090324.216,Queensboro Hill
21-May,36081079900,4079900,16602,103821,120423,Queens,3090324.216,Queensboro Hill
19-Jun,36081079900,4079900,5413,53796,59209,Queens,3090324.216,Queensboro Hill
21-Jun,36081079900,4079900,12377,68920,81297,Queens,3090324.216,Queensboro Hill
19-Jul,36081079900,4079900,7846,89209,97055,Queens,3090324.216,Queensboro Hill
21-Jul,36081079900,4079900,3362,50541,53903,Queens,3090324.216,Queensboro Hill
19-Aug,36081079900,4079900,6223,18101,24324,Queens,3090324.216,Queensboro Hill
21-Aug,36081079900,4079900,4342,57494,61836,Queens,3090324.216,Queensboro Hill
19-May,36081080301,4080301,7752,18661,26413,Queens,3400298.644,Queensboro Hill
21-May,36081080301,4080301,3038,116422,119460,Queens,3400298.644,Queensboro Hill
19-Jun,36081080301,4080301,11978,111781,123759,Queens,3400298.644,Queensboro Hill
21-Jun,36081080301,4080301,0,122086,122086,Queens,3400298.644,Queensboro Hill
19-Jul,36081080301,4080301,4792,51711,56503,Queens,3400298.644,Queensboro Hill
21-Jul,36081080301,4080301,11970,34362,46332,Queens,3400298.644,Queensboro Hill
19-Aug,36081080301,4080301,2854,39770,42624,Queens,3400298.644,Queensboro Hill
21-Aug,36081080301,4080301,11316,3933,15249,Queens,3400298.644,Queensboro Hill
19-May,36081080302,4080302,15567,117722,133289,Queens,4732483.531,Queensboro Hill
21-May,36081080302,4080302,3092,71,3163,Queens,4732483.531,Queensboro Hill
19-Jun,36081080302,4080302,6912,59339,66251,Queens,4732483.531,Queensboro Hill
21-Jun,36081080302,4080302,0,144798,144798,Queens,4732483.531,Queensboro Hill
19-Jul,36081080302,4080302,10678,50972,61650,Queens,4732483.531,Queensboro Hill
21-Jul,36081080302,4080302,13047,39558,52605,Queens,4732483.531,Queensboro Hill
19-Aug,36081080302,4080302,10206,50848,61054,Queens,4732483.531,Queensboro Hill
21-Aug,36081080302,4080302,15424,120325,135749,Queens,4732483.531,Queensboro Hill
19-May,36081081800,4081800,8000,20445,28445,Queens,4045500.888,South Ozone Park
21-May,36081081800,4081800,11369,85767,97136,Queens,4045500.888,South Ozone Park
19-Jun,36081081800,4081800,2979,108109,111088,Queens,4045500.888,South Ozone Park
21-Jun,36081081800,4081800,11468,102603,114071,Queens,4045500.888,South Ozone Park
19-Jul,36081081800,4081800,14800,71,14871,Queens,4045500.888,South Ozone Park
21-Jul,36081081800,4081800,6847,66829,73676,Queens,4045500.888,South Ozone Park
19-Aug,36081081800,4081800,0,111432,111432,Queens,4045500.888,South Ozone Park
21-Aug,36081081800,4081800,5730,61730,67460,Queens,4045500.888,South Ozone Park
19-May,36081083700,4083700,10577,55657,66234,Queens,8398314.327,Queensboro Hill
21-May,36081083700,4083700,12722,30922,43644,Queens,8398314.327,Queensboro Hill
19-Jun,36081083700,4083700,6481,75214,81695,Queens,8398314.327,Queensboro Hill
21-Jun,36081083700,4083700,12041,35437,47478,Queens,8398314.327,Queensboro Hill
19-Jul,36081083700,4083700,9710,78385,88095,Queens,8398314.327,Queensboro Hill
21-Jul,36081083700,4083700,4633,44793,49426,Queens,8398314.327,Queensboro Hill
19-Aug,36081083700,4083700,10820,58756,69576,Queens,8398314.327,Queensboro Hill
21-Aug,36081083700,4083700,1024,79747,80771,Queens,8398314.327,Queensboro Hill
19-May,36081083800,4083800,13555,101721,115276,Queens,5332408.365,South Ozone Park
21-May,36081083800,4083800,9855,101334,111189,Queens,5332408.365,South Ozone Park
19-Jun,36081083800,4083800,2724,73114,75838,Queens,5332408.365,South Ozone Park
21-Jun,36081083800,4083800,0,90048,90048,Queens,5332408.365,South Ozone Park
19-Jul,36081083800,4083800,3599,150678,154277,Queens,5332408.365,South Ozone Park
21-Jul,36081083800,4083800,6459,82210,88669,Queens,5332408.365,South Ozone Park
19-Aug,36081083800,4083800,11373,172885,184258,Queens,5332408.365,South Ozone Park
21-Aug,36081083800,4083800,7728,42551,50279,Queens,5332408.365,South Ozone Park
19-May,36081084000,4084000,10861,82985,93846,Queens,6119171.684,South Ozone Park
21-May,36081084000,4084000,11741,110983,122724,Queens,6119171.684,South Ozone Park
19-Jun,36081084000,4084000,13319,108920,122239,Queens,6119171.684,South Ozone Park
21-Jun,36081084000,4084000,9182,83583,92765,Queens,6119171.684,South Ozone Park
19-Jul,36081084000,4084000,6695,50497,57192,Queens,6119171.684,South Ozone Park
21-Jul,36081084000,4084000,5918,19517,25435,Queens,6119171.684,South Ozone Park
19-Aug,36081084000,4084000,1560,92554,94114,Queens,6119171.684,South Ozone Park
21-Aug,36081084000,4084000,9093,80512,89605,Queens,6119171.684,South Ozone Park
19-May,36081084500,4084500,7912,44642,52554,Queens,2034223.677,East Flushing
21-May,36081084500,4084500,7252,46872,54124,Queens,2034223.677,East Flushing
19-Jun,36081084500,4084500,8778,110559,119337,Queens,2034223.677,East Flushing
21-Jun,36081084500,4084500,5205,104500,109705,Queens,2034223.677,East Flushing
19-Jul,36081084500,4084500,5598,66238,71836,Queens,2034223.677,East Flushing
21-Jul,36081084500,4084500,12268,68224,80492,Queens,2034223.677,East Flushing
19-Aug,36081084500,4084500,6599,35265,41864,Queens,2034223.677,East Flushing
21-Aug,36081084500,4084500,7395,98738,106133,Queens,2034223.677,East Flushing
19-May,36081084601,4084601,8496,47481,55977,Queens,3567137.644,South Ozone Park
21-May,36081084601,4084601,12951,86336,99287,Queens,3567137.644,South Ozone Park
19-Jun,36081084601,4084601,11070,83445,94515,Queens,3567137.644,South Ozone Park
21-Jun,36081084601,4084601,7683,37318,45001,Queens,3567137.644,South Ozone Park
19-Jul,36081084601,4084601,4600,73445,78045,Queens,3567137.644,South Ozone Park
21-Jul,36081084601,4084601,14913,86605,101518,Queens,3567137.644,South Ozone Park
19-Aug,36081084601,4084601,17164,71,17235,Queens,3567137.644,South Ozone Park
21-Aug,36081084601,4084601,9019,130094,139113,Queens,3567137.644,South Ozone Park
19-May,36081084901,4084901,6362,35383,41745,Queens,2201218.835,Flushing-Willets Point
21-May,36081084901,4084901,2205,173362,175567,Queens,2201218.835,Flushing-Willets Point
19-Jun,36081084901,4084901,15936,864,16800,Queens,2201218.835,Flushing-Willets Point
21-Jun,36081084901,4084901,11280,82839,94119,Queens,2201218.835,Flushing-Willets Point
19-Jul,36081084901,4084901,6219,85073,91292,Queens,2201218.835,Flushing-Willets Point
21-Jul,36081084901,4084901,5704,146841,152545,Queens,2201218.835,Flushing-Willets Point
19-Aug,36081084901,4084901,4457,112289,116746,Queens,2201218.835,Flushing-Willets Point
21-Aug,36081084901,4084901,8654,156639,165293,Queens,2201218.835,Flushing-Willets Point
19-May,36081084902,4084902,14115,62255,76370,Queens,1071584.323,Flushing-Willets Point
21-May,36081084902,4084902,7532,99122,106654,Queens,1071584.323,Flushing-Willets Point
19-Jun,36081084902,4084902,12022,40521,52543,Queens,1071584.323,Flushing-Willets Point
21-Jun,36081084902,4084902,9159,149921,159080,Queens,1071584.323,Flushing-Willets Point
19-Jul,36081084902,4084902,15867,70166,86033,Queens,1071584.323,Flushing-Willets Point
21-Jul,36081084902,4084902,10932,74452,85384,Queens,1071584.323,Flushing-Willets Point
19-Aug,36081084902,4084902,6369,49906,56275,Queens,1071584.323,Flushing-Willets Point
21-Aug,36081084902,4084902,7473,93530,101003,Queens,1071584.323,Flushing-Willets Point
19-May,36081085700,4085700,16351,66529,82880,Queens,1425026.45,Flushing-Willets Point
21-May,36081085700,4085700,2682,56094,58776,Queens,1425026.45,Flushing-Willets Point
19-Jun,36081085700,4085700,5477,115798,121275,Queens,1425026.45,Flushing-Willets Point
21-Jun,36081085700,4085700,8692,10710,19402,Queens,1425026.45,Flushing-Willets Point
19-Jul,36081085700,4085700,4945,103965,108910,Queens,1425026.45,Flushing-Willets Point
21-Jul,36081085700,4085700,9981,90906,100887,Queens,1425026.45,Flushing-Willets Point
19-Aug,36081085700,4085700,4378,32747,37125,Queens,1425026.45,Flushing-Willets Point
21-Aug,36081085700,4085700,4460,48370,52830,Queens,1425026.45,Flushing-Willets Point
19-May,36081085900,4085900,7342,16297,23639,Queens,1570941.137,Flushing-Willets Point
21-May,36081085900,4085900,8679,64028,72707,Queens,1570941.137,Flushing-Willets Point
19-Jun,36081085900,4085900,10128,47054,57182,Queens,1570941.137,Flushing-Willets Point
21-Jun,36081085900,4085900,0,124692,124692,Queens,1570941.137,Flushing-Willets Point
19-Jul,36081085900,4085900,6033,50778,56811,Queens,1570941.137,Flushing-Willets Point
21-Jul,36081085900,4085900,6369,63711,70080,Queens,1570941.137,Flushing-Willets Point
19-Aug,36081085900,4085900,8544,39960,48504,Queens,1570941.137,Flushing-Willets Point
21-Aug,36081085900,4085900,12431,14342,26773,Queens,1570941.137,Flushing-Willets Point
19-May,36081086400,4086400,1856,62001,63857,Queens,12090470.8,South Ozone Park
21-May,36081086400,4086400,7180,79856,87036,Queens,12090470.8,South Ozone Park
19-Jun,36081086400,4086400,5148,51383,56531,Queens,12090470.8,South Ozone Park
21-Jun,36081086400,4086400,19045,42731,61776,Queens,12090470.8,South Ozone Park
19-Jul,36081086400,4086400,12228,72220,84448,Queens,12090470.8,South Ozone Park
21-Jul,36081086400,4086400,7843,149116,156959,Queens,12090470.8,South Ozone Park
19-Aug,36081086400,4086400,14356,79389,93745,Queens,12090470.8,South Ozone Park
21-Aug,36081086400,4086400,22094,25447,47541,Queens,12090470.8,South Ozone Park
19-May,36081086500,4086500,10041,89850,99891,Queens,1702759.709,Flushing-Willets Point
21-May,36081086500,4086500,11136,83824,94960,Queens,1702759.709,Flushing-Willets Point
19-Jun,36081086500,4086500,11840,67826,79666,Queens,1702759.709,Flushing-Willets Point
21-Jun,36081086500,4086500,0,89719,89719,Queens,1702759.709,Flushing-Willets Point
19-Jul,36081086500,4086500,8208,44177,52385,Queens,1702759.709,Flushing-Willets Point
21-Jul,36081086500,4086500,1024,68738,69762,Queens,1702759.709,Flushing-Willets Point
19-Aug,36081086500,4086500,8800,71,8871,Queens,1702759.709,Flushing-Willets Point
21-Aug,36081086500,4086500,9617,68296,77913,Queens,1702759.709,Flushing-Willets Point
19-May,36081086900,4086900,8384,63683,72067,Queens,6618402.907,Flushing-Willets Point
21-May,36081086900,4086900,8570,125137,133707,Queens,6618402.907,Flushing-Willets Point
19-Jun,36081086900,4086900,5431,20058,25489,Queens,6618402.907,Flushing-Willets Point
21-Jun,36081086900,4086900,6653,10353,17006,Queens,6618402.907,Flushing-Willets Point
19-Jul,36081086900,4086900,7988,88103,96091,Queens,6618402.907,Flushing-Willets Point
21-Jul,36081086900,4086900,7769,12945,20714,Queens,6618402.907,Flushing-Willets Point
19-Aug,36081086900,4086900,3357,107349,110706,Queens,6618402.907,Flushing-Willets Point
21-Aug,36081086900,4086900,6710,111440,118150,Queens,6618402.907,Flushing-Willets Point
19-May,36081087100,4087100,14145,151001,165146,Queens,4757781.574,Flushing-Willets Point
21-May,36081087100,4087100,10430,98994,109424,Queens,4757781.574,Flushing-Willets Point
19-Jun,36081087100,4087100,12944,59128,72072,Queens,4757781.574,Flushing-Willets Point
21-Jun,36081087100,4087100,11473,120283,131756,Queens,4757781.574,Flushing-Willets Point
19-Jul,36081087100,4087100,16074,121016,137090,Queens,4757781.574,Flushing-Willets Point
21-Jul,36081087100,4087100,5116,66750,71866,Queens,4757781.574,Flushing-Willets Point
19-Aug,36081087100,4087100,8768,152720,161488,Queens,4757781.574,Flushing-Willets Point
21-Aug,36081087100,4087100,5103,99236,104339,Queens,4757781.574,Flushing-Willets Point
19-May,36081088902,4088902,13635,40506,54141,Queens,3109873.953,Flushing-Willets Point
21-May,36081088902,4088902,9655,86494,96149,Queens,3109873.953,Flushing-Willets Point
19-Jun,36081088902,4088902,4824,65698,70522,Queens,3109873.953,Flushing-Willets Point
21-Jun,36081088902,4088902,2618,91820,94438,Queens,3109873.953,Flushing-Willets Point
19-Jul,36081088902,4088902,3727,8781,12508,Queens,3109873.953,Flushing-Willets Point
21-Jul,36081088902,4088902,11210,41132,52342,Queens,3109873.953,Flushing-Willets Point
19-Aug,36081088902,4088902,17063,48007,65070,Queens,3109873.953,Flushing-Willets Point
21-Aug,36081088902,4088902,2417,88571,90988,Queens,3109873.953,Flushing-Willets Point
19-May,36081088903,4088903,15040,40346,55386,Queens,3964421.109,Murray Hill-Broadway Flushing
21-May,36081088903,4088903,13332,131126,144458,Queens,3964421.109,Murray Hill-Broadway Flushing
19-Jun,36081088903,4088903,16602,111658,128260,Queens,3964421.109,Murray Hill-Broadway Flushing
21-Jun,36081088903,4088903,9384,36579,45963,Queens,3964421.109,Murray Hill-Broadway Flushing
19-Jul,36081088903,4088903,0,76101,76101,Queens,3964421.109,Murray Hill-Broadway Flushing
21-Jul,36081088903,4088903,23105,50270,73375,Queens,3964421.109,Murray Hill-Broadway Flushing
19-Aug,36081088903,4088903,8072,36025,44097,Queens,3964421.109,Murray Hill-Broadway Flushing
21-Aug,36081088903,4088903,6098,97222,103320,Queens,3964421.109,Murray Hill-Broadway Flushing
19-May,36081089202,4089202,9845,89768,99613,Queens,11848150.58,Spring Creek Park
21-May,36081089202,4089202,10047,139442,149489,Queens,11848150.58,Spring Creek Park
19-Jun,36081089202,4089202,8054,436,8490,Queens,11848150.58,Spring Creek Park
21-Jun,36081089202,4089202,3362,71154,74516,Queens,11848150.58,Spring Creek Park
19-Jul,36081089202,4089202,6352,62482,68834,Queens,11848150.58,Spring Creek Park
21-Jul,36081089202,4089202,5196,81982,87178,Queens,11848150.58,Spring Creek Park
19-Aug,36081089202,4089202,8932,91799,100731,Queens,11848150.58,Spring Creek Park
21-Aug,36081089202,4089202,12900,85805,98705,Queens,11848150.58,Spring Creek Park
19-May,36081091602,4091602,9616,41641,51257,Queens,13697953.48,Jacob Riis Park-Fort Tilden-Breezy Point Tip
21-May,36081091602,4091602,9348,68864,78212,Queens,13697953.48,Jacob Riis Park-Fort Tilden-Breezy Point Tip
19-Jun,36081091602,4091602,18093,91318,109411,Queens,13697953.48,Jacob Riis Park-Fort Tilden-Breezy Point Tip
21-Jun,36081091602,4091602,2608,71,2679,Queens,13697953.48,Jacob Riis Park-Fort Tilden-Breezy Point Tip
19-Jul,36081091602,4091602,7375,2195,9570,Queens,13697953.48,Jacob Riis Park-Fort Tilden-Breezy Point Tip
21-Jul,36081091602,4091602,10828,82024,92852,Queens,13697953.48,Jacob Riis Park-Fort Tilden-Breezy Point Tip
19-Aug,36081091602,4091602,0,94063,94063,Queens,13697953.48,Jacob Riis Park-Fort Tilden-Breezy Point Tip
21-Aug,36081091602,4091602,6683,106293,112976,Queens,13697953.48,Jacob Riis Park-Fort Tilden-Breezy Point Tip
19-May,36081091603,4091603,7052,46495,53547,Queens,20167953.79,Breezy Point-Belle Harbor-Rockaway Park-Broad Channel
21-May,36081091603,4091603,10410,29855,40265,Queens,20167953.79,Breezy Point-Belle Harbor-Rockaway Park-Broad Channel
19-Jun,36081091603,4091603,15064,132027,147091,Queens,20167953.79,Breezy Point-Belle Harbor-Rockaway Park-Broad Channel
21-Jun,36081091603,4091603,0,35355,35355,Queens,20167953.79,Breezy Point-Belle Harbor-Rockaway Park-Broad Channel
19-Jul,36081091603,4091603,9155,15870,25025,Queens,20167953.79,Breezy Point-Belle Harbor-Rockaway Park-Broad Channel
21-Jul,36081091603,4091603,10434,51372,61806,Queens,20167953.79,Breezy Point-Belle Harbor-Rockaway Park-Broad Channel
19-Aug,36081091603,4091603,13297,18301,31598,Queens,20167953.79,Breezy Point-Belle Harbor-Rockaway Park-Broad Channel
21-Aug,36081091603,4091603,1820,18021,19841,Queens,20167953.79,Breezy Point-Belle Harbor-Rockaway Park-Broad Channel
19-May,36081091604,4091604,8816,68409,77225,Queens,26842877.37,Jacob Riis Park-Fort Tilden-Breezy Point Tip
21-May,36081091604,4091604,4075,94705,98780,Queens,26842877.37,Jacob Riis Park-Fort Tilden-Breezy Point Tip
19-Jun,36081091604,4091604,9055,110148,119203,Queens,26842877.37,Jacob Riis Park-Fort Tilden-Breezy Point Tip
21-Jun,36081091604,4091604,12697,45334,58031,Queens,26842877.37,Jacob Riis Park-Fort Tilden-Breezy Point Tip
19-Jul,36081091604,4091604,4872,69063,73935,Queens,26842877.37,Jacob Riis Park-Fort Tilden-Breezy Point Tip
21-Jul,36081091604,4091604,16423,41762,58185,Queens,26842877.37,Jacob Riis Park-Fort Tilden-Breezy Point Tip
19-Aug,36081091604,4091604,657,43034,43691,Queens,26842877.37,Jacob Riis Park-Fort Tilden-Breezy Point Tip
21-Aug,36081091604,4091604,9202,89015,98217,Queens,26842877.37,Jacob Riis Park-Fort Tilden-Breezy Point Tip
19-May,36081092500,4092500,8390,133997,142387,Queens,3362669.211,College Point
21-May,36081092500,4092500,11157,66230,77387,Queens,3362669.211,College Point
19-Jun,36081092500,4092500,10049,33321,43370,Queens,3362669.211,College Point
21-Jun,36081092500,4092500,19703,59420,79123,Queens,3362669.211,College Point
19-Jul,36081092500,4092500,5172,52331,57503,Queens,3362669.211,College Point
21-Jul,36081092500,4092500,12379,57294,69673,Queens,3362669.211,College Point
19-Aug,36081092500,4092500,5737,11371,17108,Queens,3362669.211,College Point
21-Aug,36081092500,4092500,11028,38418,49446,Queens,3362669.211,College Point
19-May,36081092800,4092800,6591,106664,113255,Queens,8209412.739,Breezy Point-Belle Harbor-Rockaway Park-Broad Channel
21-May,36081092800,4092800,2783,133546,136329,Queens,8209412.739,Breezy Point-Belle Harbor-Rockaway Park-Broad Channel
19-Jun,36081092800,4092800,4401,77337,81738,Queens,8209412.739,Breezy Point-Belle Harbor-Rockaway Park-Broad Channel
21-Jun,36081092800,4092800,3708,97742,101450,Queens,8209412.739,Breezy Point-Belle Harbor-Rockaway Park-Broad Channel
19-Jul,36081092800,4092800,0,49208,49208,Queens,8209412.739,Breezy Point-Belle Harbor-Rockaway Park-Broad Channel
21-Jul,36081092800,4092800,15340,111704,127044,Queens,8209412.739,Breezy Point-Belle Harbor-Rockaway Park-Broad Channel
19-Aug,36081092800,4092800,0,116417,116417,Queens,8209412.739,Breezy Point-Belle Harbor-Rockaway Park-Broad Channel
21-Aug,36081092800,4092800,13263,42961,56224,Queens,8209412.739,Breezy Point-Belle Harbor-Rockaway Park-Broad Channel
19-May,36081093401,4093401,3776,132664,136440,Queens,5833409.643,Breezy Point-Belle Harbor-Rockaway Park-Broad Channel
21-May,36081093401,4093401,10102,89617,99719,Queens,5833409.643,Breezy Point-Belle Harbor-Rockaway Park-Broad Channel
19-Jun,36081093401,4093401,15941,106566,122507,Queens,5833409.643,Breezy Point-Belle Harbor-Rockaway Park-Broad Channel
21-Jun,36081093401,4093401,6658,108152,114810,Queens,5833409.643,Breezy Point-Belle Harbor-Rockaway Park-Broad Channel
19-Jul,36081093401,4093401,6578,67410,73988,Queens,5833409.643,Breezy Point-Belle Harbor-Rockaway Park-Broad Channel
21-Jul,36081093401,4093401,15108,93850,108958,Queens,5833409.643,Breezy Point-Belle Harbor-Rockaway Park-Broad Channel
19-Aug,36081093401,4093401,3950,109243,113193,Queens,5833409.643,Breezy Point-Belle Harbor-Rockaway Park-Broad Channel
21-Aug,36081093401,4093401,3331,53905,57236,Queens,5833409.643,Breezy Point-Belle Harbor-Rockaway Park-Broad Channel
19-May,36081093402,4093402,4022,111632,115654,Queens,4251505.126,Breezy Point-Belle Harbor-Rockaway Park-Broad Channel
21-May,36081093402,4093402,13795,109788,123583,Queens,4251505.126,Breezy Point-Belle Harbor-Rockaway Park-Broad Channel
19-Jun,36081093402,4093402,10643,19476,30119,Queens,4251505.126,Breezy Point-Belle Harbor-Rockaway Park-Broad Channel
21-Jun,36081093402,4093402,6579,1917,8496,Queens,4251505.126,Breezy Point-Belle Harbor-Rockaway Park-Broad Channel
19-Jul,36081093402,4093402,7681,69707,77388,Queens,4251505.126,Breezy Point-Belle Harbor-Rockaway Park-Broad Channel
21-Jul,36081093402,4093402,0,51806,51806,Queens,4251505.126,Breezy Point-Belle Harbor-Rockaway Park-Broad Channel
19-Aug,36081093402,4093402,1165,56591,57756,Queens,4251505.126,Breezy Point-Belle Harbor-Rockaway Park-Broad Channel
21-Aug,36081093402,4093402,8353,92004,100357,Queens,4251505.126,Breezy Point-Belle Harbor-Rockaway Park-Broad Channel
19-May,36081093800,4093800,2094,77910,80004,Queens,8709737.465,Breezy Point-Belle Harbor-Rockaway Park-Broad Channel
21-May,36081093800,4093800,12111,33923,46034,Queens,8709737.465,Breezy Point-Belle Harbor-Rockaway Park-Broad Channel
19-Jun,36081093800,4093800,20326,92278,112604,Queens,8709737.465,Breezy Point-Belle Harbor-Rockaway Park-Broad Channel
21-Jun,36081093800,4093800,17255,34344,51599,Queens,8709737.465,Breezy Point-Belle Harbor-Rockaway Park-Broad Channel
19-Jul,36081093800,4093800,8796,71,8867,Queens,8709737.465,Breezy Point-Belle Harbor-Rockaway Park-Broad Channel
21-Jul,36081093800,4093800,7816,61461,69277,Queens,8709737.465,Breezy Point-Belle Harbor-Rockaway Park-Broad Channel
19-Aug,36081093800,4093800,13054,47129,60183,Queens,8709737.465,Breezy Point-Belle Harbor-Rockaway Park-Broad Channel
21-Aug,36081093800,4093800,11010,77724,88734,Queens,8709737.465,Breezy Point-Belle Harbor-Rockaway Park-Broad Channel
19-May,36081094500,4094500,5727,48308,54035,Queens,16470123.14,College Point
21-May,36081094500,4094500,11290,39232,50522,Queens,16470123.14,College Point
19-Jun,36081094500,4094500,9228,71947,81175,Queens,16470123.14,College Point
21-Jun,36081094500,4094500,6581,164428,171009,Queens,16470123.14,College Point
19-Jul,36081094500,4094500,0,61754,61754,Queens,16470123.14,College Point
21-Jul,36081094500,4094500,9421,71,9492,Queens,16470123.14,College Point
19-Aug,36081094500,4094500,3580,80649,84229,Queens,16470123.14,College Point
21-Aug,36081094500,4094500,15053,54356,69409,Queens,16470123.14,College Point
19-May,36081094700,4094700,7393,71,7464,Queens,2935620.744,College Point
21-May,36081094700,4094700,7697,130481,138178,Queens,2935620.744,College Point
19-Jun,36081094700,4094700,14283,54604,68887,Queens,2935620.744,College Point
21-Jun,36081094700,4094700,6604,42130,48734,Queens,2935620.744,College Point
19-Jul,36081094700,4094700,12588,126677,139265,Queens,2935620.744,College Point
21-Jul,36081094700,4094700,4964,95291,100255,Queens,2935620.744,College Point
19-Aug,36081094700,4094700,10547,58284,68831,Queens,2935620.744,College Point
21-Aug,36081094700,4094700,16865,69415,86280,Queens,2935620.744,College Point
19-May,36081097204,4097204,8518,113376,121894,Queens,4214119.94,Rockaway Beach-Arverne-Edgemere
21-May,36081097204,4097204,15042,74764,89806,Queens,4214119.94,Rockaway Beach-Arverne-Edgemere
19-Jun,36081097204,4097204,4896,77801,82697,Queens,4214119.94,Rockaway Beach-Arverne-Edgemere
21-Jun,36081097204,4097204,12968,87950,100918,Queens,4214119.94,Rockaway Beach-Arverne-Edgemere
19-Jul,36081097204,4097204,13333,123006,136339,Queens,4214119.94,Rockaway Beach-Arverne-Edgemere
21-Jul,36081097204,4097204,6640,39002,45642,Queens,4214119.94,Rockaway Beach-Arverne-Edgemere
19-Aug,36081097204,4097204,11316,71,11387,Queens,4214119.94,Rockaway Beach-Arverne-Edgemere
21-Aug,36081097204,4097204,6431,71,6502,Queens,4214119.94,Rockaway Beach-Arverne-Edgemere
19-May,36081097205,4097205,7823,111352,119175,Queens,1896045.966,Rockaway Beach-Arverne-Edgemere
21-May,36081097205,4097205,1132,70502,71634,Queens,1896045.966,Rockaway Beach-Arverne-Edgemere
19-Jun,36081097205,4097205,3819,85098,88917,Queens,1896045.966,Rockaway Beach-Arverne-Edgemere
21-Jun,36081097205,4097205,6301,101168,107469,Queens,1896045.966,Rockaway Beach-Arverne-Edgemere
19-Jul,36081097205,4097205,13910,33852,47762,Queens,1896045.966,Rockaway Beach-Arverne-Edgemere
21-Jul,36081097205,4097205,12786,71,12857,Queens,1896045.966,Rockaway Beach-Arverne-Edgemere
19-Aug,36081097205,4097205,2719,3468,6187,Queens,1896045.966,Rockaway Beach-Arverne-Edgemere
21-Aug,36081097205,4097205,7138,145610,152748,Queens,1896045.966,Rockaway Beach-Arverne-Edgemere
19-May,36081097206,4097206,4150,71,4221,Queens,3307274.094,Rockaway Beach-Arverne-Edgemere
21-May,36081097206,4097206,10339,13598,23937,Queens,3307274.094,Rockaway Beach-Arverne-Edgemere
19-Jun,36081097206,4097206,14443,110228,124671,Queens,3307274.094,Rockaway Beach-Arverne-Edgemere
21-Jun,36081097206,4097206,14978,90492,105470,Queens,3307274.094,Rockaway Beach-Arverne-Edgemere
19-Jul,36081097206,4097206,9206,65604,74810,Queens,3307274.094,Rockaway Beach-Arverne-Edgemere
21-Jul,36081097206,4097206,13399,29967,43366,Queens,3307274.094,Rockaway Beach-Arverne-Edgemere
19-Aug,36081097206,4097206,11075,78599,89674,Queens,3307274.094,Rockaway Beach-Arverne-Edgemere
21-Aug,36081097206,4097206,2419,59545,61964,Queens,3307274.094,Rockaway Beach-Arverne-Edgemere
19-May,36081097207,4097207,13661,141343,155004,Queens,8929707.74,Rockaway Community Park
21-May,36081097207,4097207,3621,127009,130630,Queens,8929707.74,Rockaway Community Park
19-Jun,36081097207,4097207,4067,57534,61601,Queens,8929707.74,Rockaway Community Park
21-Jun,36081097207,4097207,9661,43723,53384,Queens,8929707.74,Rockaway Community Park
19-Jul,36081097207,4097207,10732,123373,134105,Queens,8929707.74,Rockaway Community Park
21-Jul,36081097207,4097207,2013,101562,103575,Queens,8929707.74,Rockaway Community Park
19-Aug,36081097207,4097207,3571,49842,53413,Queens,8929707.74,Rockaway Community Park
21-Aug,36081097207,4097207,17412,93149,110561,Queens,8929707.74,Rockaway Community Park
19-May,36081099703,4099703,486,105060,105546,Queens,6202992.873,Bay Terrace-Clearview
21-May,36081099703,4099703,7693,51835,59528,Queens,6202992.873,Bay Terrace-Clearview
19-Jun,36081099703,4099703,6033,36336,42369,Queens,6202992.873,Bay Terrace-Clearview
21-Jun,36081099703,4099703,8180,74238,82418,Queens,6202992.873,Bay Terrace-Clearview
19-Jul,36081099703,4099703,0,61310,61310,Queens,6202992.873,Bay Terrace-Clearview
21-Jul,36081099703,4099703,1033,71,1104,Queens,6202992.873,Bay Terrace-Clearview
19-Aug,36081099703,4099703,7621,47065,54686,Queens,6202992.873,Bay Terrace-Clearview
21-Aug,36081099703,4099703,7651,92424,100075,Queens,6202992.873,Bay Terrace-Clearview
19-May,36081099704,4099704,18987,26222,45209,Queens,7247413.852,Bay Terrace-Clearview
21-May,36081099704,4099704,12809,49601,62410,Queens,7247413.852,Bay Terrace-Clearview
19-Jun,36081099704,4099704,12142,84866,97008,Queens,7247413.852,Bay Terrace-Clearview
21-Jun,36081099704,4099704,21218,81152,102370,Queens,7247413.852,Bay Terrace-Clearview
19-Jul,36081099704,4099704,332,90729,91061,Queens,7247413.852,Bay Terrace-Clearview
21-Jul,36081099704,4099704,11740,39584,51324,Queens,7247413.852,Bay Terrace-Clearview
19-Aug,36081099704,4099704,4838,41113,45951,Queens,7247413.852,Bay Terrace-Clearview
21-Aug,36081099704,4099704,5775,67952,73727,Queens,7247413.852,Bay Terrace-Clearview
19-May,36081099801,4099801,5512,121974,127486,Queens,4916319.374,Far Rockaway-Bayswater
21-May,36081099801,4099801,14734,48191,62925,Queens,4916319.374,Far Rockaway-Bayswater
19-Jun,36081099801,4099801,14857,54480,69337,Queens,4916319.374,Far Rockaway-Bayswater
21-Jun,36081099801,4099801,11704,64223,75927,Queens,4916319.374,Far Rockaway-Bayswater
19-Jul,36081099801,4099801,8954,43778,52732,Queens,4916319.374,Far Rockaway-Bayswater
21-Jul,36081099801,4099801,6201,64349,70550,Queens,4916319.374,Far Rockaway-Bayswater
19-Aug,36081099801,4099801,9038,71,9109,Queens,4916319.374,Far Rockaway-Bayswater
21-Aug,36081099801,4099801,4992,73887,78879,Queens,4916319.374,Far Rockaway-Bayswater
19-May,36081099900,4099900,594,82338,82932,Queens,6957321.571,Fort Totten
21-May,36081099900,4099900,15229,124618,139847,Queens,6957321.571,Fort Totten
19-Jun,36081099900,4099900,9092,62806,71898,Queens,6957321.571,Fort Totten
21-Jun,36081099900,4099900,7532,18745,26277,Queens,6957321.571,Fort Totten
19-Jul,36081099900,4099900,10164,32395,42559,Queens,6957321.571,Fort Totten
21-Jul,36081099900,4099900,5474,75984,81458,Queens,6957321.571,Fort Totten
19-Aug,36081099900,4099900,3944,126074,130018,Queens,6957321.571,Fort Totten
21-Aug,36081099900,4099900,0,150824,150824,Queens,6957321.571,Fort Totten
19-May,36081100801,4100801,19645,76031,95676,Queens,6931019.215,Far Rockaway-Bayswater
21-May,36081100801,4100801,6123,71,6194,Queens,6931019.215,Far Rockaway-Bayswater
19-Jun,36081100801,4100801,2895,48703,51598,Queens,6931019.215,Far Rockaway-Bayswater
21-Jun,36081100801,4100801,4845,81550,86395,Queens,6931019.215,Far Rockaway-Bayswater
19-Jul,36081100801,4100801,18958,71,19029,Queens,6931019.215,Far Rockaway-Bayswater
21-Jul,36081100801,4100801,7319,121802,129121,Queens,6931019.215,Far Rockaway-Bayswater
19-Aug,36081100801,4100801,9399,94568,103967,Queens,6931019.215,Far Rockaway-Bayswater
21-Aug,36081100801,4100801,4302,23193,27495,Queens,6931019.215,Far Rockaway-Bayswater
19-May,36081100803,4100803,14559,53239,67798,Queens,3741127.136,Far Rockaway-Bayswater
21-May,36081100803,4100803,17572,131611,149183,Queens,3741127.136,Far Rockaway-Bayswater
19-Jun,36081100803,4100803,6547,59302,65849,Queens,3741127.136,Far Rockaway-Bayswater
21-Jun,36081100803,4100803,6009,78336,84345,Queens,3741127.136,Far Rockaway-Bayswater
19-Jul,36081100803,4100803,0,109926,109926,Queens,3741127.136,Far Rockaway-Bayswater
21-Jul,36081100803,4100803,3378,46085,49463,Queens,3741127.136,Far Rockaway-Bayswater
19-Aug,36081100803,4100803,5369,50777,56146,Queens,3741127.136,Far Rockaway-Bayswater
21-Aug,36081100803,4100803,14303,106637,120940,Queens,3741127.136,Far Rockaway-Bayswater
19-May,36081100804,4100804,9048,129569,138617,Queens,7453660.948,Far Rockaway-Bayswater
21-May,36081100804,4100804,12525,44778,57303,Queens,7453660.948,Far Rockaway-Bayswater
19-Jun,36081100804,4100804,6297,57516,63813,Queens,7453660.948,Far Rockaway-Bayswater
21-Jun,36081100804,4100804,10611,112498,123109,Queens,7453660.948,Far Rockaway-Bayswater
19-Jul,36081100804,4100804,10423,163764,174187,Queens,7453660.948,Far Rockaway-Bayswater
21-Jul,36081100804,4100804,1032,51946,52978,Queens,7453660.948,Far Rockaway-Bayswater
19-Aug,36081100804,4100804,7267,91454,98721,Queens,7453660.948,Far Rockaway-Bayswater
21-Aug,36081100804,4100804,6040,101761,107801,Queens,7453660.948,Far Rockaway-Bayswater
19-May,36081101002,4101002,12129,57742,69871,Queens,5796453.187,Far Rockaway-Bayswater
21-May,36081101002,4101002,1268,48219,49487,Queens,5796453.187,Far Rockaway-Bayswater
19-Jun,36081101002,4101002,5501,159907,165408,Queens,5796453.187,Far Rockaway-Bayswater
21-Jun,36081101002,4101002,2710,117781,120491,Queens,5796453.187,Far Rockaway-Bayswater
19-Jul,36081101002,4101002,3636,114796,118432,Queens,5796453.187,Far Rockaway-Bayswater
21-Jul,36081101002,4101002,7312,29695,37007,Queens,5796453.187,Far Rockaway-Bayswater
19-Aug,36081101002,4101002,9681,74545,84226,Queens,5796453.187,Far Rockaway-Bayswater
21-Aug,36081101002,4101002,10627,107325,117952,Queens,5796453.187,Far Rockaway-Bayswater
19-May,36081101003,4101003,11302,44255,55557,Queens,2517591.737,Far Rockaway-Bayswater
21-May,36081101003,4101003,10873,91019,101892,Queens,2517591.737,Far Rockaway-Bayswater
19-Jun,36081101003,4101003,2374,48643,51017,Queens,2517591.737,Far Rockaway-Bayswater
21-Jun,36081101003,4101003,6992,89294,96286,Queens,2517591.737,Far Rockaway-Bayswater
19-Jul,36081101003,4101003,10226,71,10297,Queens,2517591.737,Far Rockaway-Bayswater
21-Jul,36081101003,4101003,8203,35864,44067,Queens,2517591.737,Far Rockaway-Bayswater
19-Aug,36081101003,4101003,19625,19926,39551,Queens,2517591.737,Far Rockaway-Bayswater
21-Aug,36081101003,4101003,1742,67599,69341,Queens,2517591.737,Far Rockaway-Bayswater
19-May,36081101004,4101004,11530,95930,107460,Queens,6199308.086,Far Rockaway-Bayswater
21-May,36081101004,4101004,2691,39757,42448,Queens,6199308.086,Far Rockaway-Bayswater
19-Jun,36081101004,4101004,10616,66223,76839,Queens,6199308.086,Far Rockaway-Bayswater
21-Jun,36081101004,4101004,3712,71846,75558,Queens,6199308.086,Far Rockaway-Bayswater
19-Jul,36081101004,4101004,11335,112498,123833,Queens,6199308.086,Far Rockaway-Bayswater
21-Jul,36081101004,4101004,13815,21545,35360,Queens,6199308.086,Far Rockaway-Bayswater
19-Aug,36081101004,4101004,9202,105089,114291,Queens,6199308.086,Far Rockaway-Bayswater
21-Aug,36081101004,4101004,10400,44135,54535,Queens,6199308.086,Far Rockaway-Bayswater
19-May,36081103300,4103300,6230,83752,89982,Queens,6525351.578,Whitestone-Beechhurst
21-May,36081103300,4103300,13972,6695,20667,Queens,6525351.578,Whitestone-Beechhurst
19-Jun,36081103300,4103300,10730,76365,87095,Queens,6525351.578,Whitestone-Beechhurst
21-Jun,36081103300,4103300,5953,72495,78448,Queens,6525351.578,Whitestone-Beechhurst
19-Jul,36081103300,4103300,16194,74396,90590,Queens,6525351.578,Whitestone-Beechhurst
21-Jul,36081103300,4103300,15007,67135,82142,Queens,6525351.578,Whitestone-Beechhurst
19-Aug,36081103300,4103300,15753,10073,25826,Queens,6525351.578,Whitestone-Beechhurst
21-Aug,36081103300,4103300,5920,51951,57871,Queens,6525351.578,Whitestone-Beechhurst
19-May,36081103900,4103900,14863,153137,168000,Queens,9352835.788,Whitestone-Beechhurst
21-May,36081103900,4103900,2405,64563,66968,Queens,9352835.788,Whitestone-Beechhurst
19-Jun,36081103900,4103900,11733,62082,73815,Queens,9352835.788,Whitestone-Beechhurst
21-Jun,36081103900,4103900,4558,59389,63947,Queens,9352835.788,Whitestone-Beechhurst
19-Jul,36081103900,4103900,8514,135698,144212,Queens,9352835.788,Whitestone-Beechhurst
21-Jul,36081103900,4103900,20073,86826,106899,Queens,9352835.788,Whitestone-Beechhurst
19-Aug,36081103900,4103900,5682,81214,86896,Queens,9352835.788,Whitestone-Beechhurst
21-Aug,36081103900,4103900,9020,82197,91217,Queens,9352835.788,Whitestone-Beechhurst
19-May,36081104700,4104700,7189,71,7260,Queens,9061045.619,Murray Hill-Broadway Flushing
21-May,36081104700,4104700,10346,95157,105503,Queens,9061045.619,Murray Hill-Broadway Flushing
19-Jun,36081104700,4104700,11270,57794,69064,Queens,9061045.619,Murray Hill-Broadway Flushing
21-Jun,36081104700,4104700,14452,42303,56755,Queens,9061045.619,Murray Hill-Broadway Flushing
19-Jul,36081104700,4104700,9514,32077,41591,Queens,9061045.619,Murray Hill-Broadway Flushing
21-Jul,36081104700,4104700,19422,105747,125169,Queens,9061045.619,Murray Hill-Broadway Flushing
19-Aug,36081104700,4104700,12067,38335,50402,Queens,9061045.619,Murray Hill-Broadway Flushing
21-Aug,36081104700,4104700,11545,78630,90175,Queens,9061045.619,Murray Hill-Broadway Flushing
19-May,36081105900,4105900,12968,122965,135933,Queens,7005038.864,Murray Hill-Broadway Flushing
21-May,36081105900,4105900,10002,115463,125465,Queens,7005038.864,Murray Hill-Broadway Flushing
19-Jun,36081105900,4105900,13395,92486,105881,Queens,7005038.864,Murray Hill-Broadway Flushing
21-Jun,36081105900,4105900,13701,49841,63542,Queens,7005038.864,Murray Hill-Broadway Flushing
19-Jul,36081105900,4105900,4791,82009,86800,Queens,7005038.864,Murray Hill-Broadway Flushing
21-Jul,36081105900,4105900,11010,79284,90294,Queens,7005038.864,Murray Hill-Broadway Flushing
19-Aug,36081105900,4105900,2478,42420,44898,Queens,7005038.864,Murray Hill-Broadway Flushing
21-Aug,36081105900,4105900,14819,43802,58621,Queens,7005038.864,Murray Hill-Broadway Flushing
19-May,36081108500,4108500,9402,173638,183040,Queens,4792436.903,Auburndale
21-May,36081108500,4108500,14282,67289,81571,Queens,4792436.903,Auburndale
19-Jun,36081108500,4108500,14532,113125,127657,Queens,4792436.903,Auburndale
21-Jun,36081108500,4108500,10920,139404,150324,Queens,4792436.903,Auburndale
19-Jul,36081108500,4108500,10936,28829,39765,Queens,4792436.903,Auburndale
21-Jul,36081108500,4108500,4067,27584,31651,Queens,4792436.903,Auburndale
19-Aug,36081108500,4108500,4352,102475,106827,Queens,4792436.903,Auburndale
21-Aug,36081108500,4108500,9690,123039,132729,Queens,4792436.903,Auburndale
19-May,36081109300,4109300,3284,109396,112680,Queens,11521331.99,Bayside
21-May,36081109300,4109300,1847,53736,55583,Queens,11521331.99,Bayside
19-Jun,36081109300,4109300,9180,50027,59207,Queens,11521331.99,Bayside
21-Jun,36081109300,4109300,3591,63433,67024,Queens,11521331.99,Bayside
19-Jul,36081109300,4109300,15404,58381,73785,Queens,11521331.99,Bayside
21-Jul,36081109300,4109300,3911,108300,112211,Queens,11521331.99,Bayside
19-Aug,36081109300,4109300,1466,141593,143059,Queens,11521331.99,Bayside
21-Aug,36081109300,4109300,9996,49175,59171,Queens,11521331.99,Bayside
19-May,36081109700,4109700,9190,61759,70949,Queens,4792217.515,Bayside
21-May,36081109700,4109700,17479,112725,130204,Queens,4792217.515,Bayside
19-Jun,36081109700,4109700,5495,63495,68990,Queens,4792217.515,Bayside
21-Jun,36081109700,4109700,11618,170108,181726,Queens,4792217.515,Bayside
19-Jul,36081109700,4109700,3695,64006,67701,Queens,4792217.515,Bayside
21-Jul,36081109700,4109700,6864,10263,17127,Queens,4792217.515,Bayside
19-Aug,36081109700,4109700,7187,123409,130596,Queens,4792217.515,Bayside
21-Aug,36081109700,4109700,2775,95250,98025,Queens,4792217.515,Bayside
19-May,36081109900,4109900,17729,110991,128720,Queens,4073754.586,Auburndale
21-May,36081109900,4109900,9150,27757,36907,Queens,4073754.586,Auburndale
19-Jun,36081109900,4109900,10358,75624,85982,Queens,4073754.586,Auburndale
21-Jun,36081109900,4109900,12869,71,12940,Queens,4073754.586,Auburndale
19-Jul,36081109900,4109900,0,57201,57201,Queens,4073754.586,Auburndale
21-Jul,36081109900,4109900,12972,55055,68027,Queens,4073754.586,Auburndale
19-Aug,36081109900,4109900,11961,21397,33358,Queens,4073754.586,Auburndale
21-Aug,36081109900,4109900,17514,105594,123108,Queens,4073754.586,Auburndale
19-May,36081113300,4113300,22199,82843,105042,Queens,2746668.25,Auburndale
21-May,36081113300,4113300,14211,133759,147970,Queens,2746668.25,Auburndale
19-Jun,36081113300,4113300,10711,62996,73707,Queens,2746668.25,Auburndale
21-Jun,36081113300,4113300,14557,71723,86280,Queens,2746668.25,Auburndale
19-Jul,36081113300,4113300,9437,83467,92904,Queens,2746668.25,Auburndale
21-Jul,36081113300,4113300,305,110715,111020,Queens,2746668.25,Auburndale
19-Aug,36081113300,4113300,0,91316,91316,Queens,2746668.25,Auburndale
21-Aug,36081113300,4113300,12384,51234,63618,Queens,2746668.25,Auburndale
19-May,36081113900,4113900,11124,106221,117345,Queens,4132815.95,Auburndale
21-May,36081113900,4113900,8002,15716,23718,Queens,4132815.95,Auburndale
19-Jun,36081113900,4113900,12797,83466,96263,Queens,4132815.95,Auburndale
21-Jun,36081113900,4113900,12297,104867,117164,Queens,4132815.95,Auburndale
19-Jul,36081113900,4113900,5141,108991,114132,Queens,4132815.95,Auburndale
21-Jul,36081113900,4113900,9344,62334,71678,Queens,4132815.95,Auburndale
19-Aug,36081113900,4113900,6160,70101,76261,Queens,4132815.95,Auburndale
21-Aug,36081113900,4113900,7645,80483,88128,Queens,4132815.95,Auburndale
19-May,36081114100,4114100,17300,60458,77758,Queens,4816036.145,Murray Hill-Broadway Flushing
21-May,36081114100,4114100,18059,38273,56332,Queens,4816036.145,Murray Hill-Broadway Flushing
19-Jun,36081114100,4114100,13433,83264,96697,Queens,4816036.145,Murray Hill-Broadway Flushing
21-Jun,36081114100,4114100,8309,112944,121253,Queens,4816036.145,Murray Hill-Broadway Flushing
19-Jul,36081114100,4114100,8981,66071,75052,Queens,4816036.145,Murray Hill-Broadway Flushing
21-Jul,36081114100,4114100,4424,70998,75422,Queens,4816036.145,Murray Hill-Broadway Flushing
19-Aug,36081114100,4114100,11155,71,11226,Queens,4816036.145,Murray Hill-Broadway Flushing
21-Aug,36081114100,4114100,13037,116880,129917,Queens,4816036.145,Murray Hill-Broadway Flushing
19-May,36081114700,4114700,8021,18437,26458,Queens,3311049.748,Murray Hill-Broadway Flushing
21-May,36081114700,4114700,2847,107983,110830,Queens,3311049.748,Murray Hill-Broadway Flushing
19-Jun,36081114700,4114700,0,91155,91155,Queens,3311049.748,Murray Hill-Broadway Flushing
21-Jun,36081114700,4114700,5522,100427,105949,Queens,3311049.748,Murray Hill-Broadway Flushing
19-Jul,36081114700,4114700,14131,85107,99238,Queens,3311049.748,Murray Hill-Broadway Flushing
21-Jul,36081114700,4114700,6372,134001,140373,Queens,3311049.748,Murray Hill-Broadway Flushing
19-Aug,36081114700,4114700,9186,71,9257,Queens,3311049.748,Murray Hill-Broadway Flushing
21-Aug,36081114700,4114700,17944,45614,63558,Queens,3311049.748,Murray Hill-Broadway Flushing
19-May,36081115100,4115100,5942,27290,33232,Queens,3190090.113,Murray Hill-Broadway Flushing
21-May,36081115100,4115100,8240,57325,65565,Queens,3190090.113,Murray Hill-Broadway Flushing
19-Jun,36081115100,4115100,7579,117266,124845,Queens,3190090.113,Murray Hill-Broadway Flushing
21-Jun,36081115100,4115100,12711,79762,92473,Queens,3190090.113,Murray Hill-Broadway Flushing
19-Jul,36081115100,4115100,5766,62030,67796,Queens,3190090.113,Murray Hill-Broadway Flushing
21-Jul,36081115100,4115100,9339,62121,71460,Queens,3190090.113,Murray Hill-Broadway Flushing
19-Aug,36081115100,4115100,6673,51609,58282,Queens,3190090.113,Murray Hill-Broadway Flushing
21-Aug,36081115100,4115100,11772,130652,142424,Queens,3190090.113,Murray Hill-Broadway Flushing
19-May,36081115500,4115500,9972,79958,89930,Queens,2013039.548,Murray Hill-Broadway Flushing
21-May,36081115500,4115500,3780,57545,61325,Queens,2013039.548,Murray Hill-Broadway Flushing
19-Jun,36081115500,4115500,11223,32175,43398,Queens,2013039.548,Murray Hill-Broadway Flushing
21-Jun,36081115500,4115500,9058,101041,110099,Queens,2013039.548,Murray Hill-Broadway Flushing
19-Jul,36081115500,4115500,8466,20806,29272,Queens,2013039.548,Murray Hill-Broadway Flushing
21-Jul,36081115500,4115500,0,14467,14467,Queens,2013039.548,Murray Hill-Broadway Flushing
19-Aug,36081115500,4115500,7980,109124,117104,Queens,2013039.548,Murray Hill-Broadway Flushing
21-Aug,36081115500,4115500,11670,49462,61132,Queens,2013039.548,Murray Hill-Broadway Flushing
19-May,36081115700,4115700,7251,99349,106600,Queens,3386397.368,Murray Hill-Broadway Flushing
21-May,36081115700,4115700,13561,73770,87331,Queens,3386397.368,Murray Hill-Broadway Flushing
19-Jun,36081115700,4115700,10149,31621,41770,Queens,3386397.368,Murray Hill-Broadway Flushing
21-Jun,36081115700,4115700,7949,71,8020,Queens,3386397.368,Murray Hill-Broadway Flushing
19-Jul,36081115700,4115700,5406,61020,66426,Queens,3386397.368,Murray Hill-Broadway Flushing
21-Jul,36081115700,4115700,7343,20978,28321,Queens,3386397.368,Murray Hill-Broadway Flushing
19-Aug,36081115700,4115700,9536,99465,109001,Queens,3386397.368,Murray Hill-Broadway Flushing
21-Aug,36081115700,4115700,245,90804,91049,Queens,3386397.368,Murray Hill-Broadway Flushing
19-May,36081115900,4115900,12876,98476,111352,Queens,3326142.617,Murray Hill-Broadway Flushing
21-May,36081115900,4115900,14983,3691,18674,Queens,3326142.617,Murray Hill-Broadway Flushing
19-Jun,36081115900,4115900,4609,88754,93363,Queens,3326142.617,Murray Hill-Broadway Flushing
21-Jun,36081115900,4115900,6709,88230,94939,Queens,3326142.617,Murray Hill-Broadway Flushing
19-Jul,36081115900,4115900,8384,140586,148970,Queens,3326142.617,Murray Hill-Broadway Flushing
21-Jul,36081115900,4115900,0,98176,98176,Queens,3326142.617,Murray Hill-Broadway Flushing
19-Aug,36081115900,4115900,8369,44875,53244,Queens,3326142.617,Murray Hill-Broadway Flushing
21-Aug,36081115900,4115900,0,43622,43622,Queens,3326142.617,Murray Hill-Broadway Flushing
19-May,36081116100,4116100,2972,68553,71525,Queens,1891158.368,Flushing-Willets Point
21-May,36081116100,4116100,0,61724,61724,Queens,1891158.368,Flushing-Willets Point
19-Jun,36081116100,4116100,19,71924,71943,Queens,1891158.368,Flushing-Willets Point
21-Jun,36081116100,4116100,7379,119128,126507,Queens,1891158.368,Flushing-Willets Point
19-Jul,36081116100,4116100,12655,35944,48599,Queens,1891158.368,Flushing-Willets Point
21-Jul,36081116100,4116100,7712,64874,72586,Queens,1891158.368,Flushing-Willets Point
19-Aug,36081116100,4116100,12747,97836,110583,Queens,1891158.368,Flushing-Willets Point
21-Aug,36081116100,4116100,5047,107762,112809,Queens,1891158.368,Flushing-Willets Point
19-May,36081116301,4116301,17110,53923,71033,Queens,1435920.782,Murray Hill-Broadway Flushing
21-May,36081116301,4116301,5797,62501,68298,Queens,1435920.782,Murray Hill-Broadway Flushing
19-Jun,36081116301,4116301,0,98254,98254,Queens,1435920.782,Murray Hill-Broadway Flushing
21-Jun,36081116301,4116301,9038,100533,109571,Queens,1435920.782,Murray Hill-Broadway Flushing
19-Jul,36081116301,4116301,9326,174502,183828,Queens,1435920.782,Murray Hill-Broadway Flushing
21-Jul,36081116301,4116301,14711,61064,75775,Queens,1435920.782,Murray Hill-Broadway Flushing
19-Aug,36081116301,4116301,7104,66792,73896,Queens,1435920.782,Murray Hill-Broadway Flushing
21-Aug,36081116301,4116301,6593,37376,43969,Queens,1435920.782,Murray Hill-Broadway Flushing
19-May,36081117100,4117100,9713,48085,57798,Queens,4280909.678,Murray Hill-Broadway Flushing
21-May,36081117100,4117100,874,92809,93683,Queens,4280909.678,Murray Hill-Broadway Flushing
19-Jun,36081117100,4117100,9987,69979,79966,Queens,4280909.678,Murray Hill-Broadway Flushing
21-Jun,36081117100,4117100,9599,82213,91812,Queens,4280909.678,Murray Hill-Broadway Flushing
19-Jul,36081117100,4117100,17606,104817,122423,Queens,4280909.678,Murray Hill-Broadway Flushing
21-Jul,36081117100,4117100,12328,136475,148803,Queens,4280909.678,Murray Hill-Broadway Flushing
19-Aug,36081117100,4117100,5590,132545,138135,Queens,4280909.678,Murray Hill-Broadway Flushing
21-Aug,36081117100,4117100,0,102561,102561,Queens,4280909.678,Murray Hill-Broadway Flushing
19-May,36081117500,4117500,0,29459,29459,Queens,6052324.028,Murray Hill-Broadway Flushing
21-May,36081117500,4117500,7240,150496,157736,Queens,6052324.028,Murray Hill-Broadway Flushing
19-Jun,36081117500,4117500,9901,42890,52791,Queens,6052324.028,Murray Hill-Broadway Flushing
21-Jun,36081117500,4117500,12252,136794,149046,Queens,6052324.028,Murray Hill-Broadway Flushing
19-Jul,36081117500,4117500,13907,129983,143890,Queens,6052324.028,Murray Hill-Broadway Flushing
21-Jul,36081117500,4117500,1889,72514,74403,Queens,6052324.028,Murray Hill-Broadway Flushing
19-Aug,36081117500,4117500,5362,95643,101005,Queens,6052324.028,Murray Hill-Broadway Flushing
21-Aug,36081117500,4117500,5240,5190,10430,Queens,6052324.028,Murray Hill-Broadway Flushing
19-May,36081118100,4118100,4252,71,4323,Queens,2098923.484,Auburndale
21-May,36081118100,4118100,19452,91586,111038,Queens,2098923.484,Auburndale
19-Jun,36081118100,4118100,10288,80192,90480,Queens,2098923.484,Auburndale
21-Jun,36081118100,4118100,11457,92120,103577,Queens,2098923.484,Auburndale
19-Jul,36081118100,4118100,0,74067,74067,Queens,2098923.484,Auburndale
21-Jul,36081118100,4118100,1477,20774,22251,Queens,2098923.484,Auburndale
19-Aug,36081118100,4118100,8324,53387,61711,Queens,2098923.484,Auburndale
21-Aug,36081118100,4118100,18551,52703,71254,Queens,2098923.484,Auburndale
19-May,36081118500,4118500,2281,56956,59237,Queens,1665902.067,East Flushing
21-May,36081118500,4118500,2442,69934,72376,Queens,1665902.067,East Flushing
19-Jun,36081118500,4118500,441,47304,47745,Queens,1665902.067,East Flushing
21-Jun,36081118500,4118500,0,36311,36311,Queens,1665902.067,East Flushing
19-Jul,36081118500,4118500,5492,104987,110479,Queens,1665902.067,East Flushing
21-Jul,36081118500,4118500,6427,88474,94901,Queens,1665902.067,East Flushing
19-Aug,36081118500,4118500,10638,34633,45271,Queens,1665902.067,East Flushing
21-Aug,36081118500,4118500,17283,104421,121704,Queens,1665902.067,East Flushing
19-May,36081118700,4118700,8666,80035,88701,Queens,2015272.437,East Flushing
21-May,36081118700,4118700,2233,78541,80774,Queens,2015272.437,East Flushing
19-Jun,36081118700,4118700,0,62523,62523,Queens,2015272.437,East Flushing
21-Jun,36081118700,4118700,15951,61957,77908,Queens,2015272.437,East Flushing
19-Jul,36081118700,4118700,15355,71555,86910,Queens,2015272.437,East Flushing
21-Jul,36081118700,4118700,2655,103447,106102,Queens,2015272.437,East Flushing
19-Aug,36081118700,4118700,14346,63456,77802,Queens,2015272.437,East Flushing
21-Aug,36081118700,4118700,8530,114767,123297,Queens,2015272.437,East Flushing
19-May,36081119100,4119100,13937,71,14008,Queens,2342906.774,East Flushing
21-May,36081119100,4119100,10165,8331,18496,Queens,2342906.774,East Flushing
19-Jun,36081119100,4119100,14720,96373,111093,Queens,2342906.774,East Flushing
21-Jun,36081119100,4119100,8892,139494,148386,Queens,2342906.774,East Flushing
19-Jul,36081119100,4119100,2564,104450,107014,Queens,2342906.774,East Flushing
21-Jul,36081119100,4119100,1488,64660,66148,Queens,2342906.774,East Flushing
19-Aug,36081119100,4119100,13329,35111,48440,Queens,2342906.774,East Flushing
21-Aug,36081119100,4119100,10972,79764,90736,Queens,2342906.774,East Flushing
19-May,36081119300,4119300,5531,95480,101011,Queens,2275552.373,East Flushing
21-May,36081119300,4119300,5293,79143,84436,Queens,2275552.373,East Flushing
19-Jun,36081119300,4119300,9231,115806,125037,Queens,2275552.373,East Flushing
21-Jun,36081119300,4119300,5563,79906,85469,Queens,2275552.373,East Flushing
19-Jul,36081119300,4119300,8966,159285,168251,Queens,2275552.373,East Flushing
21-Jul,36081119300,4119300,9877,126763,136640,Queens,2275552.373,East Flushing
19-Aug,36081119300,4119300,14679,85182,99861,Queens,2275552.373,East Flushing
21-Aug,36081119300,4119300,8048,24206,32254,Queens,2275552.373,East Flushing
19-May,36081119500,4119500,1747,89226,90973,Queens,2037041.605,East Flushing
21-May,36081119500,4119500,5526,117780,123306,Queens,2037041.605,East Flushing
19-Jun,36081119500,4119500,7702,126924,134626,Queens,2037041.605,East Flushing
21-Jun,36081119500,4119500,8641,93301,101942,Queens,2037041.605,East Flushing
19-Jul,36081119500,4119500,7660,123710,131370,Queens,2037041.605,East Flushing
21-Jul,36081119500,4119500,12396,124018,136414,Queens,2037041.605,East Flushing
19-Aug,36081119500,4119500,7827,82894,90721,Queens,2037041.605,East Flushing
21-Aug,36081119500,4119500,0,34263,34263,Queens,2037041.605,East Flushing
19-May,36081119900,4119900,16795,121300,138095,Queens,1983090.666,East Flushing
21-May,36081119900,4119900,5997,88844,94841,Queens,1983090.666,East Flushing
19-Jun,36081119900,4119900,5615,91995,97610,Queens,1983090.666,East Flushing
21-Jun,36081119900,4119900,6394,117287,123681,Queens,1983090.666,East Flushing
19-Jul,36081119900,4119900,8388,79374,87762,Queens,1983090.666,East Flushing
21-Jul,36081119900,4119900,2839,108289,111128,Queens,1983090.666,East Flushing
19-Aug,36081119900,4119900,9685,84726,94411,Queens,1983090.666,East Flushing
21-Aug,36081119900,4119900,11921,31931,43852,Queens,1983090.666,East Flushing
19-May,36081120300,4120300,6485,18091,24576,Queens,1980421.637,East Flushing
21-May,36081120300,4120300,885,76733,77618,Queens,1980421.637,East Flushing
19-Jun,36081120300,4120300,2492,77827,80319,Queens,1980421.637,East Flushing
21-Jun,36081120300,4120300,13406,85202,98608,Queens,1980421.637,East Flushing
19-Jul,36081120300,4120300,9604,53209,62813,Queens,1980421.637,East Flushing
21-Jul,36081120300,4120300,0,100757,100757,Queens,1980421.637,East Flushing
19-Aug,36081120300,4120300,5949,61949,67898,Queens,1980421.637,East Flushing
21-Aug,36081120300,4120300,12044,83448,95492,Queens,1980421.637,East Flushing
19-May,36081120500,4120500,9122,57096,66218,Queens,2176840.292,East Flushing
21-May,36081120500,4120500,9103,16859,25962,Queens,2176840.292,East Flushing
19-Jun,36081120500,4120500,0,59249,59249,Queens,2176840.292,East Flushing
21-Jun,36081120500,4120500,10170,63737,73907,Queens,2176840.292,East Flushing
19-Jul,36081120500,4120500,9242,64924,74166,Queens,2176840.292,East Flushing
21-Jul,36081120500,4120500,16239,105358,121597,Queens,2176840.292,East Flushing
19-Aug,36081120500,4120500,9521,74133,83654,Queens,2176840.292,East Flushing
21-Aug,36081120500,4120500,11248,115491,126739,Queens,2176840.292,East Flushing
19-May,36081120701,4120701,10566,102184,112750,Queens,4246353.888,East Flushing
21-May,36081120701,4120701,14320,61179,75499,Queens,4246353.888,East Flushing
19-Jun,36081120701,4120701,5035,75843,80878,Queens,4246353.888,East Flushing
21-Jun,36081120701,4120701,16942,105781,122723,Queens,4246353.888,East Flushing
19-Jul,36081120701,4120701,10290,135027,145317,Queens,4246353.888,East Flushing
21-Jul,36081120701,4120701,1290,66901,68191,Queens,4246353.888,East Flushing
19-Aug,36081120701,4120701,15743,63978,79721,Queens,4246353.888,East Flushing
21-Aug,36081120701,4120701,14344,48561,62905,Queens,4246353.888,East Flushing
19-May,36081120702,4120702,16432,102836,119268,Queens,3365736.355,East Flushing
21-May,36081120702,4120702,6769,65146,71915,Queens,3365736.355,East Flushing
19-Jun,36081120702,4120702,10392,25020,35412,Queens,3365736.355,East Flushing
21-Jun,36081120702,4120702,3539,10188,13727,Queens,3365736.355,East Flushing
19-Jul,36081120702,4120702,19307,142527,161834,Queens,3365736.355,East Flushing
21-Jul,36081120702,4120702,12781,12064,24845,Queens,3365736.355,East Flushing
19-Aug,36081120702,4120702,2571,33996,36567,Queens,3365736.355,East Flushing
21-Aug,36081120702,4120702,8515,100590,109105,Queens,3365736.355,East Flushing
19-May,36081121500,4121500,5972,125265,131237,Queens,6806317.261,Queensboro Hill
21-May,36081121500,4121500,3258,40611,43869,Queens,6806317.261,Queensboro Hill
19-Jun,36081121500,4121500,10603,91630,102233,Queens,6806317.261,Queensboro Hill
21-Jun,36081121500,4121500,2912,77397,80309,Queens,6806317.261,Queensboro Hill
19-Jul,36081121500,4121500,1996,28791,30787,Queens,6806317.261,Queensboro Hill
21-Jul,36081121500,4121500,3792,74745,78537,Queens,6806317.261,Queensboro Hill
19-Aug,36081121500,4121500,5666,49404,55070,Queens,6806317.261,Queensboro Hill
21-Aug,36081121500,4121500,4093,42330,46423,Queens,6806317.261,Queensboro Hill
19-May,36081122300,4122300,982,65814,66796,Queens,5312336.882,Fresh Meadows-Utopia
21-May,36081122300,4122300,2714,54169,56883,Queens,5312336.882,Fresh Meadows-Utopia
19-Jun,36081122300,4122300,5801,46190,51991,Queens,5312336.882,Fresh Meadows-Utopia
21-Jun,36081122300,4122300,5780,49691,55471,Queens,5312336.882,Fresh Meadows-Utopia
19-Jul,36081122300,4122300,8873,115352,124225,Queens,5312336.882,Fresh Meadows-Utopia
21-Jul,36081122300,4122300,6950,138899,145849,Queens,5312336.882,Fresh Meadows-Utopia
19-Aug,36081122300,4122300,615,72180,72795,Queens,5312336.882,Fresh Meadows-Utopia
21-Aug,36081122300,4122300,6163,119932,126095,Queens,5312336.882,Fresh Meadows-Utopia
19-May,36081122703,4122703,14044,203287,217331,Queens,4734221.406,Pomonok-Electchester-Hillcrest
21-May,36081122703,4122703,0,141570,141570,Queens,4734221.406,Pomonok-Electchester-Hillcrest
19-Jun,36081122703,4122703,16964,94584,111548,Queens,4734221.406,Pomonok-Electchester-Hillcrest
21-Jun,36081122703,4122703,16606,129036,145642,Queens,4734221.406,Pomonok-Electchester-Hillcrest
19-Jul,36081122703,4122703,7503,11050,18553,Queens,4734221.406,Pomonok-Electchester-Hillcrest
21-Jul,36081122703,4122703,8166,113587,121753,Queens,4734221.406,Pomonok-Electchester-Hillcrest
19-Aug,36081122703,4122703,3397,63100,66497,Queens,4734221.406,Pomonok-Electchester-Hillcrest
21-Aug,36081122703,4122703,8266,87264,95530,Queens,4734221.406,Pomonok-Electchester-Hillcrest
19-May,36081122704,4122704,14888,50433,65321,Queens,2820261.535,Pomonok-Electchester-Hillcrest
21-May,36081122704,4122704,9103,50434,59537,Queens,2820261.535,Pomonok-Electchester-Hillcrest
19-Jun,36081122704,4122704,4451,20290,24741,Queens,2820261.535,Pomonok-Electchester-Hillcrest
21-Jun,36081122704,4122704,6686,114394,121080,Queens,2820261.535,Pomonok-Electchester-Hillcrest
19-Jul,36081122704,4122704,5178,85738,90916,Queens,2820261.535,Pomonok-Electchester-Hillcrest
21-Jul,36081122704,4122704,11020,45571,56591,Queens,2820261.535,Pomonok-Electchester-Hillcrest
19-Aug,36081122704,4122704,14616,93950,108566,Queens,2820261.535,Pomonok-Electchester-Hillcrest
21-Aug,36081122704,4122704,11229,63931,75160,Queens,2820261.535,Pomonok-Electchester-Hillcrest
19-May,36081124100,4124100,5113,66242,71355,Queens,5369893.925,Pomonok-Electchester-Hillcrest
21-May,36081124100,4124100,9057,56057,65114,Queens,5369893.925,Pomonok-Electchester-Hillcrest
19-Jun,36081124100,4124100,10819,64998,75817,Queens,5369893.925,Pomonok-Electchester-Hillcrest
21-Jun,36081124100,4124100,9672,50911,60583,Queens,5369893.925,Pomonok-Electchester-Hillcrest
19-Jul,36081124100,4124100,4434,94000,98434,Queens,5369893.925,Pomonok-Electchester-Hillcrest
21-Jul,36081124100,4124100,12266,37304,49570,Queens,5369893.925,Pomonok-Electchester-Hillcrest
19-Aug,36081124100,4124100,5946,53079,59025,Queens,5369893.925,Pomonok-Electchester-Hillcrest
21-Aug,36081124100,4124100,10882,13315,24197,Queens,5369893.925,Pomonok-Electchester-Hillcrest
19-May,36081124700,4124700,2832,85660,88492,Queens,5206785.825,Pomonok-Electchester-Hillcrest
21-May,36081124700,4124700,6568,35522,42090,Queens,5206785.825,Pomonok-Electchester-Hillcrest
19-Jun,36081124700,4124700,4075,97189,101264,Queens,5206785.825,Pomonok-Electchester-Hillcrest
21-Jun,36081124700,4124700,5042,77457,82499,Queens,5206785.825,Pomonok-Electchester-Hillcrest
19-Jul,36081124700,4124700,13997,41170,55167,Queens,5206785.825,Pomonok-Electchester-Hillcrest
21-Jul,36081124700,4124700,8583,43084,51667,Queens,5206785.825,Pomonok-Electchester-Hillcrest
19-Aug,36081124700,4124700,6483,31837,38320,Queens,5206785.825,Pomonok-Electchester-Hillcrest
21-Aug,36081124700,4124700,16955,82559,99514,Queens,5206785.825,Pomonok-Electchester-Hillcrest
19-May,36081126500,4126500,7568,62137,69705,Queens,2156793.586,Pomonok-Electchester-Hillcrest
21-May,36081126500,4126500,5388,20491,25879,Queens,2156793.586,Pomonok-Electchester-Hillcrest
19-Jun,36081126500,4126500,1076,102041,103117,Queens,2156793.586,Pomonok-Electchester-Hillcrest
21-Jun,36081126500,4126500,14889,42686,57575,Queens,2156793.586,Pomonok-Electchester-Hillcrest
19-Jul,36081126500,4126500,3800,66226,70026,Queens,2156793.586,Pomonok-Electchester-Hillcrest
21-Jul,36081126500,4126500,8419,40009,48428,Queens,2156793.586,Pomonok-Electchester-Hillcrest
19-Aug,36081126500,4126500,8617,43175,51792,Queens,2156793.586,Pomonok-Electchester-Hillcrest
21-Aug,36081126500,4126500,2814,55082,57896,Queens,2156793.586,Pomonok-Electchester-Hillcrest
19-May,36081129104,4129104,11746,79214,90960,Queens,7620707.741,Oakland Gardens-Hollis Hills
21-May,36081129104,4129104,4998,16687,21685,Queens,7620707.741,Oakland Gardens-Hollis Hills
19-Jun,36081129104,4129104,193,57256,57449,Queens,7620707.741,Oakland Gardens-Hollis Hills
21-Jun,36081129104,4129104,2859,156563,159422,Queens,7620707.741,Oakland Gardens-Hollis Hills
19-Jul,36081129104,4129104,518,113679,114197,Queens,7620707.741,Oakland Gardens-Hollis Hills
21-Jul,36081129104,4129104,6553,68193,74746,Queens,7620707.741,Oakland Gardens-Hollis Hills
19-Aug,36081129104,4129104,0,113358,113358,Queens,7620707.741,Oakland Gardens-Hollis Hills
21-Aug,36081129104,4129104,4647,50034,54681,Queens,7620707.741,Oakland Gardens-Hollis Hills
19-May,36081133900,4133900,15727,71014,86741,Queens,2434847.622,Fresh Meadows-Utopia
21-May,36081133900,4133900,4935,132417,137352,Queens,2434847.622,Fresh Meadows-Utopia
19-Jun,36081133900,4133900,13175,48564,61739,Queens,2434847.622,Fresh Meadows-Utopia
21-Jun,36081133900,4133900,9692,71,9763,Queens,2434847.622,Fresh Meadows-Utopia
19-Jul,36081133900,4133900,3089,36210,39299,Queens,2434847.622,Fresh Meadows-Utopia
21-Jul,36081133900,4133900,1443,48588,50031,Queens,2434847.622,Fresh Meadows-Utopia
19-Aug,36081133900,4133900,3310,8647,11957,Queens,2434847.622,Fresh Meadows-Utopia
21-Aug,36081133900,4133900,4082,71,4153,Queens,2434847.622,Fresh Meadows-Utopia
19-May,36081134100,4134100,12444,1781,14225,Queens,6391295.159,Fresh Meadows-Utopia
21-May,36081134100,4134100,12078,81592,93670,Queens,6391295.159,Fresh Meadows-Utopia
19-Jun,36081134100,4134100,3626,103335,106961,Queens,6391295.159,Fresh Meadows-Utopia
21-Jun,36081134100,4134100,7361,40931,48292,Queens,6391295.159,Fresh Meadows-Utopia
19-Jul,36081134100,4134100,7760,100469,108229,Queens,6391295.159,Fresh Meadows-Utopia
21-Jul,36081134100,4134100,0,71,71,Queens,6391295.159,Fresh Meadows-Utopia
19-Aug,36081134100,4134100,18187,19069,37256,Queens,6391295.159,Fresh Meadows-Utopia
21-Aug,36081134100,4134100,9349,48569,57918,Queens,6391295.159,Fresh Meadows-Utopia
19-May,36081134701,4134701,1098,152556,153654,Queens,4996949.422,Fresh Meadows-Utopia
21-May,36081134701,4134701,5280,31603,36883,Queens,4996949.422,Fresh Meadows-Utopia
19-Jun,36081134701,4134701,17770,68153,85923,Queens,4996949.422,Fresh Meadows-Utopia
21-Jun,36081134701,4134701,18949,61092,80041,Queens,4996949.422,Fresh Meadows-Utopia
19-Jul,36081134701,4134701,10890,130454,141344,Queens,4996949.422,Fresh Meadows-Utopia
21-Jul,36081134701,4134701,8333,67076,75409,Queens,4996949.422,Fresh Meadows-Utopia
19-Aug,36081134701,4134701,6452,148819,155271,Queens,4996949.422,Fresh Meadows-Utopia
21-Aug,36081134701,4134701,13348,38287,51635,Queens,4996949.422,Fresh Meadows-Utopia
19-May,36081134702,4134702,2200,49621,51821,Queens,6621400.35,Fresh Meadows-Utopia
21-May,36081134702,4134702,5480,91329,96809,Queens,6621400.35,Fresh Meadows-Utopia
19-Jun,36081134702,4134702,17526,119037,136563,Queens,6621400.35,Fresh Meadows-Utopia
21-Jun,36081134702,4134702,12506,36199,48705,Queens,6621400.35,Fresh Meadows-Utopia
19-Jul,36081134702,4134702,5227,8447,13674,Queens,6621400.35,Fresh Meadows-Utopia
21-Jul,36081134702,4134702,12822,72021,84843,Queens,6621400.35,Fresh Meadows-Utopia
19-Aug,36081134702,4134702,9902,36374,46276,Queens,6621400.35,Fresh Meadows-Utopia
21-Aug,36081134702,4134702,8683,117076,125759,Queens,6621400.35,Fresh Meadows-Utopia
19-May,36081136700,4136700,6278,3227,9505,Queens,8318759.164,Oakland Gardens-Hollis Hills
21-May,36081136700,4136700,14125,92669,106794,Queens,8318759.164,Oakland Gardens-Hollis Hills
19-Jun,36081136700,4136700,4462,17263,21725,Queens,8318759.164,Oakland Gardens-Hollis Hills
21-Jun,36081136700,4136700,8887,159785,168672,Queens,8318759.164,Oakland Gardens-Hollis Hills
19-Jul,36081136700,4136700,6669,42729,49398,Queens,8318759.164,Oakland Gardens-Hollis Hills
21-Jul,36081136700,4136700,10100,37648,47748,Queens,8318759.164,Oakland Gardens-Hollis Hills
19-Aug,36081136700,4136700,4511,90036,94547,Queens,8318759.164,Oakland Gardens-Hollis Hills
21-Aug,36081136700,4136700,2358,88605,90963,Queens,8318759.164,Oakland Gardens-Hollis Hills
19-May,36081137700,4137700,8068,38557,46625,Queens,8081409.273,Oakland Gardens-Hollis Hills
21-May,36081137700,4137700,8763,36893,45656,Queens,8081409.273,Oakland Gardens-Hollis Hills
19-Jun,36081137700,4137700,7337,84687,92024,Queens,8081409.273,Oakland Gardens-Hollis Hills
21-Jun,36081137700,4137700,9886,127064,136950,Queens,8081409.273,Oakland Gardens-Hollis Hills
19-Jul,36081137700,4137700,590,71,661,Queens,8081409.273,Oakland Gardens-Hollis Hills
21-Jul,36081137700,4137700,4426,80007,84433,Queens,8081409.273,Oakland Gardens-Hollis Hills
19-Aug,36081137700,4137700,11108,28178,39286,Queens,8081409.273,Oakland Gardens-Hollis Hills
21-Aug,36081137700,4137700,1240,103827,105067,Queens,8081409.273,Oakland Gardens-Hollis Hills
19-May,36081138501,4138501,12496,115158,127654,Queens,11182800.29,Bayside
21-May,36081138501,4138501,5423,75178,80601,Queens,11182800.29,Bayside
19-Jun,36081138501,4138501,9753,121534,131287,Queens,11182800.29,Bayside
21-Jun,36081138501,4138501,9467,45287,54754,Queens,11182800.29,Bayside
19-Jul,36081138501,4138501,6703,138072,144775,Queens,11182800.29,Bayside
21-Jul,36081138501,4138501,2353,84814,87167,Queens,11182800.29,Bayside
19-Aug,36081138501,4138501,1643,30743,32386,Queens,11182800.29,Bayside
21-Aug,36081138501,4138501,11264,79647,90911,Queens,11182800.29,Bayside
19-May,36081140300,4140300,21896,98550,120446,Queens,4029511.51,Bayside
21-May,36081140300,4140300,5974,121166,127140,Queens,4029511.51,Bayside
19-Jun,36081140300,4140300,19432,104307,123739,Queens,4029511.51,Bayside
21-Jun,36081140300,4140300,17067,73913,90980,Queens,4029511.51,Bayside
19-Jul,36081140300,4140300,539,97205,97744,Queens,4029511.51,Bayside
21-Jul,36081140300,4140300,571,114692,115263,Queens,4029511.51,Bayside
19-Aug,36081140300,4140300,7576,19853,27429,Queens,4029511.51,Bayside
21-Aug,36081140300,4140300,7258,66970,74228,Queens,4029511.51,Bayside
19-May,36081140901,4140901,3229,85863,89092,Queens,2632594.801,Auburndale
21-May,36081140901,4140901,12638,3429,16067,Queens,2632594.801,Auburndale
19-Jun,36081140901,4140901,17520,90472,107992,Queens,2632594.801,Auburndale
21-Jun,36081140901,4140901,18054,116298,134352,Queens,2632594.801,Auburndale
19-Jul,36081140901,4140901,5013,134359,139372,Queens,2632594.801,Auburndale
21-Jul,36081140901,4140901,8056,113884,121940,Queens,2632594.801,Auburndale
19-Aug,36081140901,4140901,210,71,281,Queens,2632594.801,Auburndale
21-Aug,36081140901,4140901,8382,67000,75382,Queens,2632594.801,Auburndale
19-May,36081140902,4140902,3379,52204,55583,Queens,5785858.899,Auburndale
21-May,36081140902,4140902,10063,92832,102895,Queens,5785858.899,Auburndale
19-Jun,36081140902,4140902,10892,65515,76407,Queens,5785858.899,Auburndale
21-Jun,36081140902,4140902,7036,66465,73501,Queens,5785858.899,Auburndale
19-Jul,36081140902,4140902,3995,18497,22492,Queens,5785858.899,Auburndale
21-Jul,36081140902,4140902,5197,87243,92440,Queens,5785858.899,Auburndale
19-Aug,36081140902,4140902,6225,63656,69881,Queens,5785858.899,Auburndale
21-Aug,36081140902,4140902,7602,96597,104199,Queens,5785858.899,Auburndale
19-May,36081142900,4142900,13688,79582,93270,Queens,5720440.483,Auburndale
21-May,36081142900,4142900,9306,134067,143373,Queens,5720440.483,Auburndale
19-Jun,36081142900,4142900,9115,107393,116508,Queens,5720440.483,Auburndale
21-Jun,36081142900,4142900,10518,113949,124467,Queens,5720440.483,Auburndale
19-Jul,36081142900,4142900,4664,103310,107974,Queens,5720440.483,Auburndale
21-Jul,36081142900,4142900,2247,72268,74515,Queens,5720440.483,Auburndale
19-Aug,36081142900,4142900,2878,107324,110202,Queens,5720440.483,Auburndale
21-Aug,36081142900,4142900,3806,112441,116247,Queens,5720440.483,Auburndale
19-May,36081144100,4144100,2036,149978,152014,Queens,3630986.777,Bayside
21-May,36081144100,4144100,8763,89500,98263,Queens,3630986.777,Bayside
19-Jun,36081144100,4144100,14040,141600,155640,Queens,3630986.777,Bayside
21-Jun,36081144100,4144100,15576,78645,94221,Queens,3630986.777,Bayside
19-Jul,36081144100,4144100,17314,62786,80100,Queens,3630986.777,Bayside
21-Jul,36081144100,4144100,0,89491,89491,Queens,3630986.777,Bayside
19-Aug,36081144100,4144100,7168,111112,118280,Queens,3630986.777,Bayside
21-Aug,36081144100,4144100,218,7132,7350,Queens,3630986.777,Bayside
19-May,36081144700,4144700,10957,70495,81452,Queens,4456988.921,Bayside
21-May,36081144700,4144700,13804,12338,26142,Queens,4456988.921,Bayside
19-Jun,36081144700,4144700,13941,55263,69204,Queens,4456988.921,Bayside
21-Jun,36081144700,4144700,12890,48639,61529,Queens,4456988.921,Bayside
19-Jul,36081144700,4144700,13624,92434,106058,Queens,4456988.921,Bayside
21-Jul,36081144700,4144700,1877,34167,36044,Queens,4456988.921,Bayside
19-Aug,36081144700,4144700,7832,130271,138103,Queens,4456988.921,Bayside
21-Aug,36081144700,4144700,8828,67870,76698,Queens,4456988.921,Bayside
19-May,36081145101,4145101,4508,104264,108772,Queens,2704350.178,Auburndale
21-May,36081145101,4145101,5830,117809,123639,Queens,2704350.178,Auburndale
19-Jun,36081145101,4145101,7744,97155,104899,Queens,2704350.178,Auburndale
21-Jun,36081145101,4145101,12818,160535,173353,Queens,2704350.178,Auburndale
19-Jul,36081145101,4145101,12746,27855,40601,Queens,2704350.178,Auburndale
21-Jul,36081145101,4145101,345,37856,38201,Queens,2704350.178,Auburndale
19-Aug,36081145101,4145101,5465,77848,83313,Queens,2704350.178,Auburndale
21-Aug,36081145101,4145101,0,145345,145345,Queens,2704350.178,Auburndale
19-May,36081145102,4145102,10732,28243,38975,Queens,3684551.328,Auburndale
21-May,36081145102,4145102,8404,77997,86401,Queens,3684551.328,Auburndale
19-Jun,36081145102,4145102,3953,88784,92737,Queens,3684551.328,Auburndale
21-Jun,36081145102,4145102,0,69101,69101,Queens,3684551.328,Auburndale
19-Jul,36081145102,4145102,10641,59737,70378,Queens,3684551.328,Auburndale
21-Jul,36081145102,4145102,18687,106254,124941,Queens,3684551.328,Auburndale
19-Aug,36081145102,4145102,489,75146,75635,Queens,3684551.328,Auburndale
21-Aug,36081145102,4145102,10229,50204,60433,Queens,3684551.328,Auburndale
19-May,36081145900,4145900,4676,110643,115319,Queens,4007243.383,Auburndale
21-May,36081145900,4145900,7832,58281,66113,Queens,4007243.383,Auburndale
19-Jun,36081145900,4145900,9652,65018,74670,Queens,4007243.383,Auburndale
21-Jun,36081145900,4145900,4315,43919,48234,Queens,4007243.383,Auburndale
19-Jul,36081145900,4145900,7648,86957,94605,Queens,4007243.383,Auburndale
21-Jul,36081145900,4145900,2140,21664,23804,Queens,4007243.383,Auburndale
19-Aug,36081145900,4145900,7953,46867,54820,Queens,4007243.383,Auburndale
21-Aug,36081145900,4145900,10143,41699,51842,Queens,4007243.383,Auburndale
19-May,36081146300,4146300,8324,96649,104973,Queens,3476672.395,Auburndale
21-May,36081146300,4146300,4022,51041,55063,Queens,3476672.395,Auburndale
19-Jun,36081146300,4146300,3605,80804,84409,Queens,3476672.395,Auburndale
21-Jun,36081146300,4146300,13647,73118,86765,Queens,3476672.395,Auburndale
19-Jul,36081146300,4146300,7108,86194,93302,Queens,3476672.395,Auburndale
21-Jul,36081146300,4146300,5425,17655,23080,Queens,3476672.395,Auburndale
19-Aug,36081146300,4146300,7495,63332,70827,Queens,3476672.395,Auburndale
21-Aug,36081146300,4146300,8117,71434,79551,Queens,3476672.395,Auburndale
19-May,36081146700,4146700,10806,99793,110599,Queens,3807224.71,Bayside
21-May,36081146700,4146700,8064,43074,51138,Queens,3807224.71,Bayside
19-Jun,36081146700,4146700,7711,71,7782,Queens,3807224.71,Bayside
21-Jun,36081146700,4146700,15642,44996,60638,Queens,3807224.71,Bayside
19-Jul,36081146700,4146700,10720,68027,78747,Queens,3807224.71,Bayside
21-Jul,36081146700,4146700,11654,43822,55476,Queens,3807224.71,Bayside
19-Aug,36081146700,4146700,2349,49390,51739,Queens,3807224.71,Bayside
21-Aug,36081146700,4146700,14472,31324,45796,Queens,3807224.71,Bayside
19-May,36081147100,4147100,5750,67516,73266,Queens,4541348.018,Bayside
21-May,36081147100,4147100,9756,79872,89628,Queens,4541348.018,Bayside
19-Jun,36081147100,4147100,18513,37872,56385,Queens,4541348.018,Bayside
21-Jun,36081147100,4147100,1834,37968,39802,Queens,4541348.018,Bayside
19-Jul,36081147100,4147100,5707,52525,58232,Queens,4541348.018,Bayside
21-Jul,36081147100,4147100,6537,98123,104660,Queens,4541348.018,Bayside
19-Aug,36081147100,4147100,14100,95006,109106,Queens,4541348.018,Bayside
21-Aug,36081147100,4147100,6687,57211,63898,Queens,4541348.018,Bayside
19-May,36081147900,4147900,0,61616,61616,Queens,9172314.823,Douglaston-Little Neck
21-May,36081147900,4147900,10976,71,11047,Queens,9172314.823,Douglaston-Little Neck
19-Jun,36081147900,4147900,9159,41804,50963,Queens,9172314.823,Douglaston-Little Neck
21-Jun,36081147900,4147900,6364,75075,81439,Queens,9172314.823,Douglaston-Little Neck
19-Jul,36081147900,4147900,5811,80466,86277,Queens,9172314.823,Douglaston-Little Neck
21-Jul,36081147900,4147900,8387,71,8458,Queens,9172314.823,Douglaston-Little Neck
19-Aug,36081147900,4147900,11370,99743,111113,Queens,9172314.823,Douglaston-Little Neck
21-Aug,36081147900,4147900,16360,32367,48727,Queens,9172314.823,Douglaston-Little Neck
19-May,36081150701,4150701,9826,34887,44713,Queens,9443703.421,Douglaston-Little Neck
21-May,36081150701,4150701,9620,52128,61748,Queens,9443703.421,Douglaston-Little Neck
19-Jun,36081150701,4150701,12998,55654,68652,Queens,9443703.421,Douglaston-Little Neck
21-Jun,36081150701,4150701,11289,137926,149215,Queens,9443703.421,Douglaston-Little Neck
19-Jul,36081150701,4150701,13801,104789,118590,Queens,9443703.421,Douglaston-Little Neck
21-Jul,36081150701,4150701,16637,34514,51151,Queens,9443703.421,Douglaston-Little Neck
19-Aug,36081150701,4150701,4821,42999,47820,Queens,9443703.421,Douglaston-Little Neck
21-Aug,36081150701,4150701,10619,10498,21117,Queens,9443703.421,Douglaston-Little Neck
19-May,36081150702,4150702,8305,94445,102750,Queens,9051537.73,Douglaston-Little Neck
21-May,36081150702,4150702,7993,79784,87777,Queens,9051537.73,Douglaston-Little Neck
19-Jun,36081150702,4150702,12495,84385,96880,Queens,9051537.73,Douglaston-Little Neck
21-Jun,36081150702,4150702,666,76310,76976,Queens,9051537.73,Douglaston-Little Neck
19-Jul,36081150702,4150702,1522,111624,113146,Queens,9051537.73,Douglaston-Little Neck
21-Jul,36081150702,4150702,3948,21687,25635,Queens,9051537.73,Douglaston-Little Neck
19-Aug,36081150702,4150702,2866,79896,82762,Queens,9051537.73,Douglaston-Little Neck
21-Aug,36081150702,4150702,2946,79294,82240,Queens,9051537.73,Douglaston-Little Neck
19-May,36081152902,4152902,3309,80191,83500,Queens,11179533.3,Douglaston-Little Neck
21-May,36081152902,4152902,0,34666,34666,Queens,11179533.3,Douglaston-Little Neck
19-Jun,36081152902,4152902,6114,68942,75056,Queens,11179533.3,Douglaston-Little Neck
21-Jun,36081152902,4152902,4035,83300,87335,Queens,11179533.3,Douglaston-Little Neck
19-Jul,36081152902,4152902,9090,47317,56407,Queens,11179533.3,Douglaston-Little Neck
21-Jul,36081152902,4152902,0,111980,111980,Queens,11179533.3,Douglaston-Little Neck
19-Aug,36081152902,4152902,14518,84144,98662,Queens,11179533.3,Douglaston-Little Neck
21-Aug,36081152902,4152902,5398,73001,78399,Queens,11179533.3,Douglaston-Little Neck
19-May,36081155101,4155101,21956,111366,133322,Queens,5120603.959,Glen Oaks-Floral Park-New Hyde Park
21-May,36081155101,4155101,14209,67712,81921,Queens,5120603.959,Glen Oaks-Floral Park-New Hyde Park
19-Jun,36081155101,4155101,17098,114191,131289,Queens,5120603.959,Glen Oaks-Floral Park-New Hyde Park
21-Jun,36081155101,4155101,3811,49441,53252,Queens,5120603.959,Glen Oaks-Floral Park-New Hyde Park
19-Jul,36081155101,4155101,11545,115460,127005,Queens,5120603.959,Glen Oaks-Floral Park-New Hyde Park
21-Jul,36081155101,4155101,15664,41265,56929,Queens,5120603.959,Glen Oaks-Floral Park-New Hyde Park
19-Aug,36081155101,4155101,6632,95094,101726,Queens,5120603.959,Glen Oaks-Floral Park-New Hyde Park
21-Aug,36081155101,4155101,7259,132454,139713,Queens,5120603.959,Glen Oaks-Floral Park-New Hyde Park
19-May,36081155103,4155103,8412,45977,54389,Queens,7740917.404,Glen Oaks-Floral Park-New Hyde Park
21-May,36081155103,4155103,13760,12395,26155,Queens,7740917.404,Glen Oaks-Floral Park-New Hyde Park
19-Jun,36081155103,4155103,11914,40887,52801,Queens,7740917.404,Glen Oaks-Floral Park-New Hyde Park
21-Jun,36081155103,4155103,10318,47679,57997,Queens,7740917.404,Glen Oaks-Floral Park-New Hyde Park
19-Jul,36081155103,4155103,2821,144193,147014,Queens,7740917.404,Glen Oaks-Floral Park-New Hyde Park
21-Jul,36081155103,4155103,7747,86022,93769,Queens,7740917.404,Glen Oaks-Floral Park-New Hyde Park
19-Aug,36081155103,4155103,13849,90048,103897,Queens,7740917.404,Glen Oaks-Floral Park-New Hyde Park
21-Aug,36081155103,4155103,10221,77452,87673,Queens,7740917.404,Glen Oaks-Floral Park-New Hyde Park
19-May,36081155104,4155104,5639,40547,46186,Queens,7617998.217,Glen Oaks-Floral Park-New Hyde Park
21-May,36081155104,4155104,10331,38000,48331,Queens,7617998.217,Glen Oaks-Floral Park-New Hyde Park
19-Jun,36081155104,4155104,14438,55736,70174,Queens,7617998.217,Glen Oaks-Floral Park-New Hyde Park
21-Jun,36081155104,4155104,11594,16880,28474,Queens,7617998.217,Glen Oaks-Floral Park-New Hyde Park
19-Jul,36081155104,4155104,5094,69800,74894,Queens,7617998.217,Glen Oaks-Floral Park-New Hyde Park
21-Jul,36081155104,4155104,4596,63812,68408,Queens,7617998.217,Glen Oaks-Floral Park-New Hyde Park
19-Aug,36081155104,4155104,9801,53353,63154,Queens,7617998.217,Glen Oaks-Floral Park-New Hyde Park
21-Aug,36081155104,4155104,9936,82465,92401,Queens,7617998.217,Glen Oaks-Floral Park-New Hyde Park
19-May,36081157902,4157902,8511,116438,124949,Queens,7773114.369,Glen Oaks-Floral Park-New Hyde Park
21-May,36081157902,4157902,5260,84647,89907,Queens,7773114.369,Glen Oaks-Floral Park-New Hyde Park
19-Jun,36081157902,4157902,9134,29105,38239,Queens,7773114.369,Glen Oaks-Floral Park-New Hyde Park
21-Jun,36081157902,4157902,7876,10966,18842,Queens,7773114.369,Glen Oaks-Floral Park-New Hyde Park
19-Jul,36081157902,4157902,9681,83328,93009,Queens,7773114.369,Glen Oaks-Floral Park-New Hyde Park
21-Jul,36081157902,4157902,9255,67852,77107,Queens,7773114.369,Glen Oaks-Floral Park-New Hyde Park
19-Aug,36081157902,4157902,670,98453,99123,Queens,7773114.369,Glen Oaks-Floral Park-New Hyde Park
21-Aug,36081157902,4157902,1796,76199,77995,Queens,7773114.369,Glen Oaks-Floral Park-New Hyde Park
19-May,36005036100,2036100,2984,65171,68155,Bronx,1767528.555,West Farms
21-May,36005036100,2036100,0,83733,83733,Bronx,1767528.555,West Farms
19-Jun,36005036100,2036100,11948,32269,44217,Bronx,1767528.555,West Farms
21-Jun,36005036100,2036100,7436,155933,163369,Bronx,1767528.555,West Farms
19-Jul,36005036100,2036100,18316,56311,74627,Bronx,1767528.555,West Farms
21-Jul,36005036100,2036100,16239,110759,126998,Bronx,1767528.555,West Farms
19-Aug,36005036100,2036100,8925,155689,164614,Bronx,1767528.555,West Farms
21-Aug,36005036100,2036100,20179,52106,72285,Bronx,1767528.555,West Farms
19-May,36005012701,2012701,10830,110136,120966,Bronx,1172792.871,Longwood
21-May,36005012701,2012701,3864,73356,77220,Bronx,1172792.871,Longwood
19-Jun,36005012701,2012701,13387,157878,171265,Bronx,1172792.871,Longwood
21-Jun,36005012701,2012701,14973,5098,20071,Bronx,1172792.871,Longwood
19-Jul,36005012701,2012701,16871,132627,149498,Bronx,1172792.871,Longwood
21-Jul,36005012701,2012701,301,55185,55486,Bronx,1172792.871,Longwood
19-Aug,36005012701,2012701,14041,102167,116208,Bronx,1172792.871,Longwood
21-Aug,36005012701,2012701,0,32209,32209,Bronx,1172792.871,Longwood
19-May,36005015900,2015900,5168,143168,148336,Bronx,1112938.859,Longwood
21-May,36005015900,2015900,5773,118355,124128,Bronx,1112938.859,Longwood
19-Jun,36005015900,2015900,2423,94850,97273,Bronx,1112938.859,Longwood
21-Jun,36005015900,2015900,8494,73196,81690,Bronx,1112938.859,Longwood
19-Jul,36005015900,2015900,6609,56059,62668,Bronx,1112938.859,Longwood
21-Jul,36005015900,2015900,2585,10480,13065,Bronx,1112938.859,Longwood
19-Aug,36005015900,2015900,2612,5706,8318,Bronx,1112938.859,Longwood
21-Aug,36005015900,2015900,305,93991,94296,Bronx,1112938.859,Longwood
19-May,36005042600,2042600,2615,129896,132511,Bronx,5473783.467,Eastchester-Edenwald-Baychester
21-May,36005042600,2042600,4870,66254,71124,Bronx,5473783.467,Eastchester-Edenwald-Baychester
19-Jun,36005042600,2042600,9117,82181,91298,Bronx,5473783.467,Eastchester-Edenwald-Baychester
21-Jun,36005042600,2042600,7460,80950,88410,Bronx,5473783.467,Eastchester-Edenwald-Baychester
19-Jul,36005042600,2042600,5695,51345,57040,Bronx,5473783.467,Eastchester-Edenwald-Baychester
21-Jul,36005042600,2042600,11870,33318,45188,Bronx,5473783.467,Eastchester-Edenwald-Baychester
19-Aug,36005042600,2042600,12583,140480,153063,Bronx,5473783.467,Eastchester-Edenwald-Baychester
21-Aug,36005042600,2042600,12189,75067,87256,Bronx,5473783.467,Eastchester-Edenwald-Baychester
19-May,36061003800,1003800,7595,4863,12458,Manhattan,2180047.438,East Village
21-May,36061003800,1003800,4792,54264,59056,Manhattan,2180047.438,East Village
19-Jun,36061003800,1003800,10658,47546,58204,Manhattan,2180047.438,East Village
21-Jun,36061003800,1003800,5365,112659,118024,Manhattan,2180047.438,East Village
19-Jul,36061003800,1003800,19782,86001,105783,Manhattan,2180047.438,East Village
21-Jul,36061003800,1003800,19432,78913,98345,Manhattan,2180047.438,East Village
19-Aug,36061003800,1003800,11947,103558,115505,Manhattan,2180047.438,East Village
21-Aug,36061003800,1003800,2192,13904,16096,Manhattan,2180047.438,East Village
19-May,36061001001,1001001,11275,57728,69003,Manhattan,880264.0442,Lower East Side
21-May,36061001001,1001001,11946,31979,43925,Manhattan,880264.0442,Lower East Side
19-Jun,36061001001,1001001,5238,71,5309,Manhattan,880264.0442,Lower East Side
21-Jun,36061001001,1001001,8110,54959,63069,Manhattan,880264.0442,Lower East Side
19-Jul,36061001001,1001001,8421,54673,63094,Manhattan,880264.0442,Lower East Side
21-Jul,36061001001,1001001,12879,55302,68181,Manhattan,880264.0442,Lower East Side
19-Aug,36061001001,1001001,7316,123259,130575,Manhattan,880264.0442,Lower East Side
21-Aug,36061001001,1001001,7017,57686,64703,Manhattan,880264.0442,Lower East Side
19-May,36061001502,1001502,7546,5489,13035,Manhattan,2245047.488,Financial District-Battery Park City
21-May,36061001502,1001502,14411,114384,128795,Manhattan,2245047.488,Financial District-Battery Park City
19-Jun,36061001502,1001502,10165,76633,86798,Manhattan,2245047.488,Financial District-Battery Park City
21-Jun,36061001502,1001502,6371,50836,57207,Manhattan,2245047.488,Financial District-Battery Park City
19-Jul,36061001502,1001502,12030,86835,98865,Manhattan,2245047.488,Financial District-Battery Park City
21-Jul,36061001502,1001502,8714,140139,148853,Manhattan,2245047.488,Financial District-Battery Park City
19-Aug,36061001502,1001502,12754,27337,40091,Manhattan,2245047.488,Financial District-Battery Park City
21-Aug,36061001502,1001502,9923,102034,111957,Manhattan,2245047.488,Financial District-Battery Park City
19-May,36061004800,1004800,11407,1374,12781,Manhattan,1920852.091,Gramercy
21-May,36061004800,1004800,9787,91257,101044,Manhattan,1920852.091,Gramercy
19-Jun,36061004800,1004800,1864,69998,71862,Manhattan,1920852.091,Gramercy
21-Jun,36061004800,1004800,12787,109502,122289,Manhattan,1920852.091,Gramercy
19-Jul,36061004800,1004800,1474,74736,76210,Manhattan,1920852.091,Gramercy
21-Jul,36061004800,1004800,8598,41562,50160,Manhattan,1920852.091,Gramercy
19-Aug,36061004800,1004800,14844,73896,88740,Manhattan,1920852.091,Gramercy
21-Aug,36061004800,1004800,10073,95813,105886,Manhattan,1920852.091,Gramercy
19-May,36061004400,1004400,8075,84139,92214,Manhattan,4277834.699,Stuyvesant Town-Peter Cooper Village
21-May,36061004400,1004400,11490,82390,93880,Manhattan,4277834.699,Stuyvesant Town-Peter Cooper Village
19-Jun,36061004400,1004400,6337,124626,130963,Manhattan,4277834.699,Stuyvesant Town-Peter Cooper Village
21-Jun,36061004400,1004400,13755,69326,83081,Manhattan,4277834.699,Stuyvesant Town-Peter Cooper Village
19-Jul,36061004400,1004400,6217,34371,40588,Manhattan,4277834.699,Stuyvesant Town-Peter Cooper Village
21-Jul,36061004400,1004400,3186,25425,28611,Manhattan,4277834.699,Stuyvesant Town-Peter Cooper Village
19-Aug,36061004400,1004400,14598,66208,80806,Manhattan,4277834.699,Stuyvesant Town-Peter Cooper Village
21-Aug,36061004400,1004400,7481,76204,83685,Manhattan,4277834.699,Stuyvesant Town-Peter Cooper Village
19-May,36061006400,1006400,5017,84364,89381,Manhattan,1934407.856,Gramercy
21-May,36061006400,1006400,12754,15003,27757,Manhattan,1934407.856,Gramercy
19-Jun,36061006400,1006400,13974,72932,86906,Manhattan,1934407.856,Gramercy
21-Jun,36061006400,1006400,12978,50857,63835,Manhattan,1934407.856,Gramercy
19-Jul,36061006400,1006400,9193,71,9264,Manhattan,1934407.856,Gramercy
21-Jul,36061006400,1006400,17029,65252,82281,Manhattan,1934407.856,Gramercy
19-Aug,36061006400,1006400,12158,74254,86412,Manhattan,1934407.856,Gramercy
21-Aug,36061006400,1006400,18569,95052,113621,Manhattan,1934407.856,Gramercy
19-May,36061017800,1017800,10225,28139,38364,Manhattan,2663052.149,East Harlem (North)
21-May,36061017800,1017800,7725,77968,85693,Manhattan,2663052.149,East Harlem (North)
19-Jun,36061017800,1017800,3352,86802,90154,Manhattan,2663052.149,East Harlem (North)
21-Jun,36061017800,1017800,3768,40674,44442,Manhattan,2663052.149,East Harlem (North)
19-Jul,36061017800,1017800,7323,31514,38837,Manhattan,2663052.149,East Harlem (North)
21-Jul,36061017800,1017800,7989,54673,62662,Manhattan,2663052.149,East Harlem (North)
19-Aug,36061017800,1017800,10173,123124,133297,Manhattan,2663052.149,East Harlem (North)
21-Aug,36061017800,1017800,11539,42013,53552,Manhattan,2663052.149,East Harlem (North)
19-May,36061000500,1000500,3937,116169,120106,Manhattan,9069851.606,The Battery-Governors Island-Ellis Island-Liberty Island
21-May,36061000500,1000500,2000,93749,95749,Manhattan,9069851.606,The Battery-Governors Island-Ellis Island-Liberty Island
19-Jun,36061000500,1000500,11973,89705,101678,Manhattan,9069851.606,The Battery-Governors Island-Ellis Island-Liberty Island
21-Jun,36061000500,1000500,12927,101925,114852,Manhattan,9069851.606,The Battery-Governors Island-Ellis Island-Liberty Island
19-Jul,36061000500,1000500,5671,17157,22828,Manhattan,9069851.606,The Battery-Governors Island-Ellis Island-Liberty Island
21-Jul,36061000500,1000500,760,126026,126786,Manhattan,9069851.606,The Battery-Governors Island-Ellis Island-Liberty Island
19-Aug,36061000500,1000500,11332,37963,49295,Manhattan,9069851.606,The Battery-Governors Island-Ellis Island-Liberty Island
21-Aug,36061000500,1000500,0,81553,81553,Manhattan,9069851.606,The Battery-Governors Island-Ellis Island-Liberty Island
19-May,36081094201,4094201,13906,122551,136457,Queens,3634448.26,Rockaway Beach-Arverne-Edgemere
21-May,36081094201,4094201,12880,38671,51551,Queens,3634448.26,Rockaway Beach-Arverne-Edgemere
19-Jun,36081094201,4094201,10875,61650,72525,Queens,3634448.26,Rockaway Beach-Arverne-Edgemere
21-Jun,36081094201,4094201,8121,84922,93043,Queens,3634448.26,Rockaway Beach-Arverne-Edgemere
19-Jul,36081094201,4094201,10872,77019,87891,Queens,3634448.26,Rockaway Beach-Arverne-Edgemere
21-Jul,36081094201,4094201,12730,101015,113745,Queens,3634448.26,Rockaway Beach-Arverne-Edgemere
19-Aug,36081094201,4094201,14796,87734,102530,Queens,3634448.26,Rockaway Beach-Arverne-Edgemere
21-Aug,36081094201,4094201,6429,49984,56413,Queens,3634448.26,Rockaway Beach-Arverne-Edgemere
19-May,36081111300,4111300,3361,61710,65071,Queens,7852794.032,Bayside
21-May,36081111300,4111300,18099,83789,101888,Queens,7852794.032,Bayside
19-Jun,36081111300,4111300,12245,134417,146662,Queens,7852794.032,Bayside
21-Jun,36081111300,4111300,5377,31002,36379,Queens,7852794.032,Bayside
19-Jul,36081111300,4111300,3716,32791,36507,Queens,7852794.032,Bayside
21-Jul,36081111300,4111300,4137,31666,35803,Queens,7852794.032,Bayside
19-Aug,36081111300,4111300,9814,55617,65431,Queens,7852794.032,Bayside
21-Aug,36081111300,4111300,5628,45477,51105,Queens,7852794.032,Bayside
19-May,36081148300,4148300,9158,47605,56763,Queens,14237229.32,Douglaston-Little Neck
21-May,36081148300,4148300,11605,148002,159607,Queens,14237229.32,Douglaston-Little Neck
19-Jun,36081148300,4148300,8107,71829,79936,Queens,14237229.32,Douglaston-Little Neck
21-Jun,36081148300,4148300,6080,84794,90874,Queens,14237229.32,Douglaston-Little Neck
19-Jul,36081148300,4148300,10463,111451,121914,Queens,14237229.32,Douglaston-Little Neck
21-Jul,36081148300,4148300,13213,71,13284,Queens,14237229.32,Douglaston-Little Neck
19-Aug,36081148300,4148300,1952,106312,108264,Queens,14237229.32,Douglaston-Little Neck
21-Aug,36081148300,4148300,7232,66597,73829,Queens,14237229.32,Douglaston-Little Neck
19-May,36081080900,4080900,1264,127080,128344,Queens,10761019.26,Kew Gardens Hills
21-May,36081080900,4080900,11960,86385,98345,Queens,10761019.26,Kew Gardens Hills
19-Jun,36081080900,4080900,8997,126864,135861,Queens,10761019.26,Kew Gardens Hills
21-Jun,36081080900,4080900,19689,83845,103534,Queens,10761019.26,Kew Gardens Hills
19-Jul,36081080900,4080900,4268,44016,48284,Queens,10761019.26,Kew Gardens Hills
21-Jul,36081080900,4080900,11440,62039,73479,Queens,10761019.26,Kew Gardens Hills
19-Aug,36081080900,4080900,11265,76375,87640,Queens,10761019.26,Kew Gardens Hills
21-Aug,36081080900,4080900,13221,64288,77509,Queens,10761019.26,Kew Gardens Hills
19-May,36081122702,4122702,9850,99159,109009,Queens,4832974.042,Pomonok-Electchester-Hillcrest
21-May,36081122702,4122702,2692,78990,81682,Queens,4832974.042,Pomonok-Electchester-Hillcrest
19-Jun,36081122702,4122702,3090,856,3946,Queens,4832974.042,Pomonok-Electchester-Hillcrest
21-Jun,36081122702,4122702,7458,13308,20766,Queens,4832974.042,Pomonok-Electchester-Hillcrest
19-Jul,36081122702,4122702,9817,84597,94414,Queens,4832974.042,Pomonok-Electchester-Hillcrest
21-Jul,36081122702,4122702,13740,38214,51954,Queens,4832974.042,Pomonok-Electchester-Hillcrest
19-Aug,36081122702,4122702,8491,65479,73970,Queens,4832974.042,Pomonok-Electchester-Hillcrest
21-Aug,36081122702,4122702,9083,127347,136430,Queens,4832974.042,Pomonok-Electchester-Hillcrest
19-May,36081125700,4125700,10022,75210,85232,Queens,3566900.587,Pomonok-Electchester-Hillcrest
21-May,36081125700,4125700,1681,124039,125720,Queens,3566900.587,Pomonok-Electchester-Hillcrest
19-Jun,36081125700,4125700,12088,135658,147746,Queens,3566900.587,Pomonok-Electchester-Hillcrest
21-Jun,36081125700,4125700,11688,103030,114718,Queens,3566900.587,Pomonok-Electchester-Hillcrest
19-Jul,36081125700,4125700,5565,87419,92984,Queens,3566900.587,Pomonok-Electchester-Hillcrest
21-Jul,36081125700,4125700,7142,90563,97705,Queens,3566900.587,Pomonok-Electchester-Hillcrest
19-Aug,36081125700,4125700,9224,54182,63406,Queens,3566900.587,Pomonok-Electchester-Hillcrest
21-Aug,36081125700,4125700,9385,92932,102317,Queens,3566900.587,Pomonok-Electchester-Hillcrest
19-May,36081126700,4126700,1661,109982,111643,Queens,8286325.801,Pomonok-Electchester-Hillcrest
21-May,36081126700,4126700,11839,64235,76074,Queens,8286325.801,Pomonok-Electchester-Hillcrest
19-Jun,36081126700,4126700,4720,68061,72781,Queens,8286325.801,Pomonok-Electchester-Hillcrest
21-Jun,36081126700,4126700,14162,123356,137518,Queens,8286325.801,Pomonok-Electchester-Hillcrest
19-Jul,36081126700,4126700,19513,78638,98151,Queens,8286325.801,Pomonok-Electchester-Hillcrest
21-Jul,36081126700,4126700,2900,71,2971,Queens,8286325.801,Pomonok-Electchester-Hillcrest
19-Aug,36081126700,4126700,9046,62462,71508,Queens,8286325.801,Pomonok-Electchester-Hillcrest
21-Aug,36081126700,4126700,12085,88944,101029,Queens,8286325.801,Pomonok-Electchester-Hillcrest
19-May,36081139900,4139900,13274,71,13345,Queens,3925389.079,Bayside
21-May,36081139900,4139900,11681,3788,15469,Queens,3925389.079,Bayside
19-Jun,36081139900,4139900,15705,71,15776,Queens,3925389.079,Bayside
21-Jun,36081139900,4139900,7452,42907,50359,Queens,3925389.079,Bayside
19-Jul,36081139900,4139900,10518,35140,45658,Queens,3925389.079,Bayside
21-Jul,36081139900,4139900,8395,140460,148855,Queens,3925389.079,Bayside
19-Aug,36081139900,4139900,8871,10565,19436,Queens,3925389.079,Bayside
21-Aug,36081139900,4139900,10332,100227,110559,Queens,3925389.079,Bayside
19-May,36081143500,4143500,5811,108907,114718,Queens,3843565.44,Bayside
21-May,36081143500,4143500,11409,89566,100975,Queens,3843565.44,Bayside
19-Jun,36081143500,4143500,6083,71557,77640,Queens,3843565.44,Bayside
21-Jun,36081143500,4143500,10331,72797,83128,Queens,3843565.44,Bayside
19-Jul,36081143500,4143500,11139,65116,76255,Queens,3843565.44,Bayside
21-Jul,36081143500,4143500,2394,94302,96696,Queens,3843565.44,Bayside
19-Aug,36081143500,4143500,10274,51621,61895,Queens,3843565.44,Bayside
21-Aug,36081143500,4143500,11049,125361,136410,Queens,3843565.44,Bayside
19-May,36081157901,4157901,7609,101244,108853,Queens,9833175.459,Glen Oaks-Floral Park-New Hyde Park
21-May,36081157901,4157901,9248,103136,112384,Queens,9833175.459,Glen Oaks-Floral Park-New Hyde Park
19-Jun,36081157901,4157901,14458,85655,100113,Queens,9833175.459,Glen Oaks-Floral Park-New Hyde Park
21-Jun,36081157901,4157901,18372,13482,31854,Queens,9833175.459,Glen Oaks-Floral Park-New Hyde Park
19-Jul,36081157901,4157901,15856,77494,93350,Queens,9833175.459,Glen Oaks-Floral Park-New Hyde Park
21-Jul,36081157901,4157901,0,70137,70137,Queens,9833175.459,Glen Oaks-Floral Park-New Hyde Park
19-Aug,36081157901,4157901,5015,136146,141161,Queens,9833175.459,Glen Oaks-Floral Park-New Hyde Park
21-Aug,36081157901,4157901,11464,154530,165994,Queens,9833175.459,Glen Oaks-Floral Park-New Hyde Park
19-May,36081157903,4157903,0,107296,107296,Queens,7335307.64,Glen Oaks-Floral Park-New Hyde Park
21-May,36081157903,4157903,2092,71123,73215,Queens,7335307.64,Glen Oaks-Floral Park-New Hyde Park
19-Jun,36081157903,4157903,6788,91579,98367,Queens,7335307.64,Glen Oaks-Floral Park-New Hyde Park
21-Jun,36081157903,4157903,8159,26549,34708,Queens,7335307.64,Glen Oaks-Floral Park-New Hyde Park
19-Jul,36081157903,4157903,0,68990,68990,Queens,7335307.64,Glen Oaks-Floral Park-New Hyde Park
21-Jul,36081157903,4157903,10224,143286,153510,Queens,7335307.64,Glen Oaks-Floral Park-New Hyde Park
19-Aug,36081157903,4157903,15175,59482,74657,Queens,7335307.64,Glen Oaks-Floral Park-New Hyde Park
21-Aug,36081157903,4157903,0,52233,52233,Queens,7335307.64,Glen Oaks-Floral Park-New Hyde Park
19-May,36081042400,4042400,6486,110940,117426,Queens,5544421.063,St. Albans
21-May,36081042400,4042400,14897,60948,75845,Queens,5544421.063,St. Albans
19-Jun,36081042400,4042400,12816,39853,52669,Queens,5544421.063,St. Albans
21-Jun,36081042400,4042400,4139,93622,97761,Queens,5544421.063,St. Albans
19-Jul,36081042400,4042400,3199,133391,136590,Queens,5544421.063,St. Albans
21-Jul,36081042400,4042400,14918,84155,99073,Queens,5544421.063,St. Albans
19-Aug,36081042400,4042400,7105,144716,151821,Queens,5544421.063,St. Albans
21-Aug,36081042400,4042400,12936,53800,66736,Queens,5544421.063,St. Albans
19-May,36081043400,4043400,5359,57058,62417,Queens,2213959.962,St. Albans
21-May,36081043400,4043400,5813,106234,112047,Queens,2213959.962,St. Albans
19-Jun,36081043400,4043400,8463,112318,120781,Queens,2213959.962,St. Albans
21-Jun,36081043400,4043400,11630,18575,30205,Queens,2213959.962,St. Albans
19-Jul,36081043400,4043400,5600,14751,20351,Queens,2213959.962,St. Albans
21-Jul,36081043400,4043400,12078,82055,94133,Queens,2213959.962,St. Albans
19-Aug,36081043400,4043400,9263,34477,43740,Queens,2213959.962,St. Albans
21-Aug,36081043400,4043400,14605,44494,59099,Queens,2213959.962,St. Albans
19-May,36081042600,4042600,14651,98462,113113,Queens,5575019.578,St. Albans
21-May,36081042600,4042600,2424,71,2495,Queens,5575019.578,St. Albans
19-Jun,36081042600,4042600,9923,71,9994,Queens,5575019.578,St. Albans
21-Jun,36081042600,4042600,8776,94148,102924,Queens,5575019.578,St. Albans
19-Jul,36081042600,4042600,0,47879,47879,Queens,5575019.578,St. Albans
21-Jul,36081042600,4042600,0,77165,77165,Queens,5575019.578,St. Albans
19-Aug,36081042600,4042600,8140,57806,65946,Queens,5575019.578,St. Albans
21-Aug,36081042600,4042600,14996,116671,131667,Queens,5575019.578,St. Albans
19-May,36081043200,4043200,220,36376,36596,Queens,2600532.481,St. Albans
21-May,36081043200,4043200,2404,71,2475,Queens,2600532.481,St. Albans
19-Jun,36081043200,4043200,8219,83143,91362,Queens,2600532.481,St. Albans
21-Jun,36081043200,4043200,16830,102520,119350,Queens,2600532.481,St. Albans
19-Jul,36081043200,4043200,11359,46214,57573,Queens,2600532.481,St. Albans
21-Jul,36081043200,4043200,11999,38403,50402,Queens,2600532.481,St. Albans
19-Aug,36081043200,4043200,8464,35435,43899,Queens,2600532.481,St. Albans
21-Aug,36081043200,4043200,7755,48300,56055,Queens,2600532.481,St. Albans
19-May,36081045200,4045200,9799,88715,98514,Queens,2316001.911,Jamaica Hills-Briarwood
21-May,36081045200,4045200,11979,33163,45142,Queens,2316001.911,Jamaica Hills-Briarwood
19-Jun,36081045200,4045200,9302,25980,35282,Queens,2316001.911,Jamaica Hills-Briarwood
21-Jun,36081045200,4045200,7492,71,7563,Queens,2316001.911,Jamaica Hills-Briarwood
19-Jul,36081045200,4045200,9502,99624,109126,Queens,2316001.911,Jamaica Hills-Briarwood
21-Jul,36081045200,4045200,4524,86661,91185,Queens,2316001.911,Jamaica Hills-Briarwood
19-Aug,36081045200,4045200,4986,41132,46118,Queens,2316001.911,Jamaica Hills-Briarwood
21-Aug,36081045200,4045200,8731,31300,40031,Queens,2316001.911,Jamaica Hills-Briarwood
19-May,36081045400,4045400,3351,24919,28270,Queens,2513751.301,Jamaica Hills-Briarwood
21-May,36081045400,4045400,11287,38013,49300,Queens,2513751.301,Jamaica Hills-Briarwood
19-Jun,36081045400,4045400,4527,57802,62329,Queens,2513751.301,Jamaica Hills-Briarwood
21-Jun,36081045400,4045400,16804,28142,44946,Queens,2513751.301,Jamaica Hills-Briarwood
19-Jul,36081045400,4045400,6944,65813,72757,Queens,2513751.301,Jamaica Hills-Briarwood
21-Jul,36081045400,4045400,3048,112316,115364,Queens,2513751.301,Jamaica Hills-Briarwood
19-Aug,36081045400,4045400,24002,71916,95918,Queens,2513751.301,Jamaica Hills-Briarwood
21-Aug,36081045400,4045400,6876,79114,85990,Queens,2513751.301,Jamaica Hills-Briarwood
19-May,36081005900,4005900,8627,16814,25441,Queens,2047586.872,Astoria (Central)
21-May,36081005900,4005900,14812,97030,111842,Queens,2047586.872,Astoria (Central)
19-Jun,36081005900,4005900,10039,61756,71795,Queens,2047586.872,Astoria (Central)
21-Jun,36081005900,4005900,13758,53462,67220,Queens,2047586.872,Astoria (Central)
19-Jul,36081005900,4005900,6571,78458,85029,Queens,2047586.872,Astoria (Central)
21-Jul,36081005900,4005900,5296,93366,98662,Queens,2047586.872,Astoria (Central)
19-Aug,36081005900,4005900,0,61665,61665,Queens,2047586.872,Astoria (Central)
21-Aug,36081005900,4005900,8033,24192,32225,Queens,2047586.872,Astoria (Central)
19-May,36081006100,4006100,7413,114909,122322,Queens,2099196.685,Astoria (Central)
21-May,36081006100,4006100,9177,43452,52629,Queens,2099196.685,Astoria (Central)
19-Jun,36081006100,4006100,14145,96037,110182,Queens,2099196.685,Astoria (Central)
21-Jun,36081006100,4006100,0,60242,60242,Queens,2099196.685,Astoria (Central)
19-Jul,36081006100,4006100,17539,80564,98103,Queens,2099196.685,Astoria (Central)
21-Jul,36081006100,4006100,16062,38209,54271,Queens,2099196.685,Astoria (Central)
19-Aug,36081006100,4006100,13571,57573,71144,Queens,2099196.685,Astoria (Central)
21-Aug,36081006100,4006100,0,47592,47592,Queens,2099196.685,Astoria (Central)
19-May,36081058100,4058100,0,6170,6170,Queens,1549676.318,Ridgewood
21-May,36081058100,4058100,8964,12913,21877,Queens,1549676.318,Ridgewood
19-Jun,36081058100,4058100,19597,66780,86377,Queens,1549676.318,Ridgewood
21-Jun,36081058100,4058100,11882,44292,56174,Queens,1549676.318,Ridgewood
19-Jul,36081058100,4058100,15217,106235,121452,Queens,1549676.318,Ridgewood
21-Jul,36081058100,4058100,0,64006,64006,Queens,1549676.318,Ridgewood
19-Aug,36081058100,4058100,5495,82714,88209,Queens,1549676.318,Ridgewood
21-Aug,36081058100,4058100,5260,43958,49218,Queens,1549676.318,Ridgewood
19-May,36081058300,4058300,7905,83628,91533,Queens,1528024.013,Ridgewood
21-May,36081058300,4058300,10207,47970,58177,Queens,1528024.013,Ridgewood
19-Jun,36081058300,4058300,2910,75009,77919,Queens,1528024.013,Ridgewood
21-Jun,36081058300,4058300,9483,53200,62683,Queens,1528024.013,Ridgewood
19-Jul,36081058300,4058300,11404,52101,63505,Queens,1528024.013,Ridgewood
21-Jul,36081058300,4058300,10814,44060,54874,Queens,1528024.013,Ridgewood
19-Aug,36081058300,4058300,10317,56250,66567,Queens,1528024.013,Ridgewood
21-Aug,36081058300,4058300,17097,110505,127602,Queens,1528024.013,Ridgewood
19-May,36061023501,1023501,10310,71,10381,Manhattan,1928941.322,Hamilton Heights-Sugar Hill
21-May,36061023501,1023501,7835,68884,76719,Manhattan,1928941.322,Hamilton Heights-Sugar Hill
19-Jun,36061023501,1023501,2836,71,2907,Manhattan,1928941.322,Hamilton Heights-Sugar Hill
21-Jun,36061023501,1023501,12850,77709,90559,Manhattan,1928941.322,Hamilton Heights-Sugar Hill
19-Jul,36061023501,1023501,15179,57915,73094,Manhattan,1928941.322,Hamilton Heights-Sugar Hill
21-Jul,36061023501,1023501,1414,151712,153126,Manhattan,1928941.322,Hamilton Heights-Sugar Hill
19-Aug,36061023501,1023501,9550,102796,112346,Manhattan,1928941.322,Hamilton Heights-Sugar Hill
21-Aug,36061023501,1023501,2956,70560,73516,Manhattan,1928941.322,Hamilton Heights-Sugar Hill
19-May,36081047900,4047900,5836,115399,121235,Queens,4238221.047,Elmhurst
21-May,36081047900,4047900,8271,29148,37419,Queens,4238221.047,Elmhurst
19-Jun,36081047900,4047900,4888,36553,41441,Queens,4238221.047,Elmhurst
21-Jun,36081047900,4047900,9526,107893,117419,Queens,4238221.047,Elmhurst
19-Jul,36081047900,4047900,0,58429,58429,Queens,4238221.047,Elmhurst
21-Jul,36081047900,4047900,9626,75334,84960,Queens,4238221.047,Elmhurst
19-Aug,36081047900,4047900,0,67109,67109,Queens,4238221.047,Elmhurst
21-Aug,36081047900,4047900,3928,68590,72518,Queens,4238221.047,Elmhurst
19-May,36081062400,4062400,4294,61476,65770,Queens,5322023.21,Montefiore Cemetery
21-May,36081062400,4062400,13161,111812,124973,Queens,5322023.21,Montefiore Cemetery
19-Jun,36081062400,4062400,12776,160318,173094,Queens,5322023.21,Montefiore Cemetery
21-Jun,36081062400,4062400,4958,76791,81749,Queens,5322023.21,Montefiore Cemetery
19-Jul,36081062400,4062400,4486,78996,83482,Queens,5322023.21,Montefiore Cemetery
21-Jul,36081062400,4062400,11642,14736,26378,Queens,5322023.21,Montefiore Cemetery
19-Aug,36081062400,4062400,941,55335,56276,Queens,5322023.21,Montefiore Cemetery
21-Aug,36081062400,4062400,5880,107090,112970,Queens,5322023.21,Montefiore Cemetery
19-May,36081062000,4062000,5889,104265,110154,Queens,2374809.931,Laurelton
21-May,36081062000,4062000,11195,54818,66013,Queens,2374809.931,Laurelton
19-Jun,36081062000,4062000,1830,54921,56751,Queens,2374809.931,Laurelton
21-Jun,36081062000,4062000,8146,71,8217,Queens,2374809.931,Laurelton
19-Jul,36081062000,4062000,5738,84830,90568,Queens,2374809.931,Laurelton
21-Jul,36081062000,4062000,10198,57228,67426,Queens,2374809.931,Laurelton
19-Aug,36081062000,4062000,3632,101887,105519,Queens,2374809.931,Laurelton
21-Aug,36081062000,4062000,6153,51133,57286,Queens,2374809.931,Laurelton
19-May,36081063000,4063000,3776,63953,67729,Queens,2084282.119,Laurelton
21-May,36081063000,4063000,11310,20928,32238,Queens,2084282.119,Laurelton
19-Jun,36081063000,4063000,3583,94257,97840,Queens,2084282.119,Laurelton
21-Jun,36081063000,4063000,7068,99483,106551,Queens,2084282.119,Laurelton
19-Jul,36081063000,4063000,870,105309,106179,Queens,2084282.119,Laurelton
21-Jul,36081063000,4063000,11858,118169,130027,Queens,2084282.119,Laurelton
19-Aug,36081063000,4063000,4379,104335,108714,Queens,2084282.119,Laurelton
21-Aug,36081063000,4063000,4748,14034,18782,Queens,2084282.119,Laurelton
19-May,36061022302,1022302,0,98613,98613,Manhattan,643336.6459,Manhattanville-West Harlem
21-May,36061022302,1022302,21244,83802,105046,Manhattan,643336.6459,Manhattanville-West Harlem
19-Jun,36061022302,1022302,10251,76200,86451,Manhattan,643336.6459,Manhattanville-West Harlem
21-Jun,36061022302,1022302,1533,139218,140751,Manhattan,643336.6459,Manhattanville-West Harlem
19-Jul,36061022302,1022302,4353,198165,202518,Manhattan,643336.6459,Manhattanville-West Harlem
21-Jul,36061022302,1022302,15083,22211,37294,Manhattan,643336.6459,Manhattanville-West Harlem
19-Aug,36061022302,1022302,553,71,624,Manhattan,643336.6459,Manhattanville-West Harlem
21-Aug,36061022302,1022302,10404,48328,58732,Manhattan,643336.6459,Manhattanville-West Harlem
19-May,36081133300,4133300,9605,78524,88129,Queens,7439227.093,Fresh Meadows-Utopia
21-May,36081133300,4133300,12765,19572,32337,Queens,7439227.093,Fresh Meadows-Utopia
19-Jun,36081133300,4133300,3752,90424,94176,Queens,7439227.093,Fresh Meadows-Utopia
21-Jun,36081133300,4133300,6085,27201,33286,Queens,7439227.093,Fresh Meadows-Utopia
19-Jul,36081133300,4133300,3503,77842,81345,Queens,7439227.093,Fresh Meadows-Utopia
21-Jul,36081133300,4133300,11368,39965,51333,Queens,7439227.093,Fresh Meadows-Utopia
19-Aug,36081133300,4133300,9684,46709,56393,Queens,7439227.093,Fresh Meadows-Utopia
21-Aug,36081133300,4133300,4880,34613,39493,Queens,7439227.093,Fresh Meadows-Utopia
19-May,36061012400,1012400,789,111447,112236,Manhattan,1847564.377,Upper East Side-Lenox Hill-Roosevelt Island
21-May,36061012400,1012400,15774,110422,126196,Manhattan,1847564.377,Upper East Side-Lenox Hill-Roosevelt Island
19-Jun,36061012400,1012400,11880,86006,97886,Manhattan,1847564.377,Upper East Side-Lenox Hill-Roosevelt Island
21-Jun,36061012400,1012400,4177,78944,83121,Manhattan,1847564.377,Upper East Side-Lenox Hill-Roosevelt Island
19-Jul,36061012400,1012400,9987,54102,64089,Manhattan,1847564.377,Upper East Side-Lenox Hill-Roosevelt Island
21-Jul,36061012400,1012400,0,68711,68711,Manhattan,1847564.377,Upper East Side-Lenox Hill-Roosevelt Island
19-Aug,36061012400,1012400,8137,104402,112539,Manhattan,1847564.377,Upper East Side-Lenox Hill-Roosevelt Island
21-Aug,36061012400,1012400,13987,109743,123730,Manhattan,1847564.377,Upper East Side-Lenox Hill-Roosevelt Island
19-May,36005021200,2021200,13360,95290,108650,Bronx,1087470.391,Parkchester
21-May,36005021200,2021200,5600,73859,79459,Bronx,1087470.391,Parkchester
19-Jun,36005021200,2021200,2481,45593,48074,Bronx,1087470.391,Parkchester
21-Jun,36005021200,2021200,7976,131342,139318,Bronx,1087470.391,Parkchester
19-Jul,36005021200,2021200,5139,74412,79551,Bronx,1087470.391,Parkchester
21-Jul,36005021200,2021200,4943,106275,111218,Bronx,1087470.391,Parkchester
19-Aug,36005021200,2021200,3963,47421,51384,Bronx,1087470.391,Parkchester
21-Aug,36005021200,2021200,5627,11161,16788,Bronx,1087470.391,Parkchester
19-May,36005022200,2022200,15830,67795,83625,Bronx,2364209.585,Parkchester
21-May,36005022200,2022200,12002,51149,63151,Bronx,2364209.585,Parkchester
19-Jun,36005022200,2022200,1791,146442,148233,Bronx,2364209.585,Parkchester
21-Jun,36005022200,2022200,11147,71,11218,Bronx,2364209.585,Parkchester
19-Jul,36005022200,2022200,18924,19617,38541,Bronx,2364209.585,Parkchester
21-Jul,36005022200,2022200,5238,47640,52878,Bronx,2364209.585,Parkchester
19-Aug,36005022200,2022200,17107,12265,29372,Bronx,2364209.585,Parkchester
21-Aug,36005022200,2022200,0,79774,79774,Bronx,2364209.585,Parkchester
19-May,36081065501,4065501,8950,83475,92425,Queens,8754117.359,St. John Cemetery
21-May,36081065501,4065501,18045,108339,126384,Queens,8754117.359,St. John Cemetery
19-Jun,36081065501,4065501,11723,43416,55139,Queens,8754117.359,St. John Cemetery
21-Jun,36081065501,4065501,4596,138443,143039,Queens,8754117.359,St. John Cemetery
19-Jul,36081065501,4065501,8492,78745,87237,Queens,8754117.359,St. John Cemetery
21-Jul,36081065501,4065501,19565,63890,83455,Queens,8754117.359,St. John Cemetery
19-Aug,36081065501,4065501,12434,60768,73202,Queens,8754117.359,St. John Cemetery
21-Aug,36081065501,4065501,3173,91911,95084,Queens,8754117.359,St. John Cemetery
19-May,36061014401,1014401,7282,60521,67803,Manhattan,807979.6996,Upper East Side-Yorkville
21-May,36061014401,1014401,8043,70843,78886,Manhattan,807979.6996,Upper East Side-Yorkville
19-Jun,36061014401,1014401,3823,39482,43305,Manhattan,807979.6996,Upper East Side-Yorkville
21-Jun,36061014401,1014401,9794,61621,71415,Manhattan,807979.6996,Upper East Side-Yorkville
19-Jul,36061014401,1014401,1157,10445,11602,Manhattan,807979.6996,Upper East Side-Yorkville
21-Jul,36061014401,1014401,198,112494,112692,Manhattan,807979.6996,Upper East Side-Yorkville
19-Aug,36061014401,1014401,15090,48003,63093,Manhattan,807979.6996,Upper East Side-Yorkville
21-Aug,36061014401,1014401,2821,77259,80080,Manhattan,807979.6996,Upper East Side-Yorkville
19-May,36061001600,1001600,11894,73442,85336,Manhattan,2232591.526,Chinatown-Two Bridges
21-May,36061001600,1001600,20948,8331,29279,Manhattan,2232591.526,Chinatown-Two Bridges
19-Jun,36061001600,1001600,9094,121518,130612,Manhattan,2232591.526,Chinatown-Two Bridges
21-Jun,36061001600,1001600,3108,78848,81956,Manhattan,2232591.526,Chinatown-Two Bridges
19-Jul,36061001600,1001600,2440,51013,53453,Manhattan,2232591.526,Chinatown-Two Bridges
21-Jul,36061001600,1001600,3281,41076,44357,Manhattan,2232591.526,Chinatown-Two Bridges
19-Aug,36061001600,1001600,8006,115607,123613,Manhattan,2232591.526,Chinatown-Two Bridges
21-Aug,36061001600,1001600,4988,102521,107509,Manhattan,2232591.526,Chinatown-Two Bridges
19-May,36061001200,1001200,5959,46225,52184,Manhattan,1298211.217,Lower East Side
21-May,36061001200,1001200,3269,41645,44914,Manhattan,1298211.217,Lower East Side
19-Jun,36061001200,1001200,6446,96599,103045,Manhattan,1298211.217,Lower East Side
21-Jun,36061001200,1001200,10409,107886,118295,Manhattan,1298211.217,Lower East Side
19-Jul,36061001200,1001200,3901,138397,142298,Manhattan,1298211.217,Lower East Side
21-Jul,36061001200,1001200,4870,55898,60768,Manhattan,1298211.217,Lower East Side
19-Aug,36061001200,1001200,13593,104497,118090,Manhattan,1298211.217,Lower East Side
21-Aug,36061001200,1001200,10844,74989,85833,Manhattan,1298211.217,Lower East Side
19-May,36081112300,4112300,8178,71,8249,Queens,3005919.534,Bayside
21-May,36081112300,4112300,6997,110474,117471,Queens,3005919.534,Bayside
19-Jun,36081112300,4112300,3571,30171,33742,Queens,3005919.534,Bayside
21-Jun,36081112300,4112300,13317,28469,41786,Queens,3005919.534,Bayside
19-Jul,36081112300,4112300,0,81898,81898,Queens,3005919.534,Bayside
21-Jul,36081112300,4112300,4421,39318,43739,Queens,3005919.534,Bayside
19-Aug,36081112300,4112300,14384,55724,70108,Queens,3005919.534,Bayside
21-Aug,36081112300,4112300,9237,78579,87816,Queens,3005919.534,Bayside
19-May,36081112900,4112900,8876,88613,97489,Queens,3819983.3,Bayside
21-May,36081112900,4112900,5545,46065,51610,Queens,3819983.3,Bayside
19-Jun,36081112900,4112900,15953,88817,104770,Queens,3819983.3,Bayside
21-Jun,36081112900,4112900,2825,115335,118160,Queens,3819983.3,Bayside
19-Jul,36081112900,4112900,9773,68905,78678,Queens,3819983.3,Bayside
21-Jul,36081112900,4112900,7736,157695,165431,Queens,3819983.3,Bayside
19-Aug,36081112900,4112900,5825,4787,10612,Queens,3819983.3,Bayside
21-Aug,36081112900,4112900,8884,156305,165189,Queens,3819983.3,Bayside
19-May,36005042901,2042901,4810,124065,128875,Bronx,1105150.954,Norwood
21-May,36005042901,2042901,7538,15528,23066,Bronx,1105150.954,Norwood
19-Jun,36005042901,2042901,2898,73740,76638,Bronx,1105150.954,Norwood
21-Jun,36005042901,2042901,12436,127766,140202,Bronx,1105150.954,Norwood
19-Jul,36005042901,2042901,6962,55273,62235,Bronx,1105150.954,Norwood
21-Jul,36005042901,2042901,1064,128942,130006,Bronx,1105150.954,Norwood
19-Aug,36005042901,2042901,9266,54504,63770,Bronx,1105150.954,Norwood
21-Aug,36005042901,2042901,14867,85275,100142,Bronx,1105150.954,Norwood
19-May,36005043102,2043102,10112,107629,117741,Bronx,1228613.538,Norwood
21-May,36005043102,2043102,8182,69768,77950,Bronx,1228613.538,Norwood
19-Jun,36005043102,2043102,3355,62475,65830,Bronx,1228613.538,Norwood
21-Jun,36005043102,2043102,9759,77154,86913,Bronx,1228613.538,Norwood
19-Jul,36005043102,2043102,8694,14148,22842,Bronx,1228613.538,Norwood
21-Jul,36005043102,2043102,10756,52925,63681,Bronx,1228613.538,Norwood
19-Aug,36005043102,2043102,8816,37117,45933,Bronx,1228613.538,Norwood
21-Aug,36005043102,2043102,15460,44702,60162,Bronx,1228613.538,Norwood
19-May,36081026300,4026300,11316,122166,133482,Queens,2242333.59,Woodside
21-May,36081026300,4026300,8908,68302,77210,Queens,2242333.59,Woodside
19-Jun,36081026300,4026300,12513,55605,68118,Queens,2242333.59,Woodside
21-Jun,36081026300,4026300,12335,74091,86426,Queens,2242333.59,Woodside
19-Jul,36081026300,4026300,521,95378,95899,Queens,2242333.59,Woodside
21-Jul,36081026300,4026300,1116,48058,49174,Queens,2242333.59,Woodside
19-Aug,36081026300,4026300,0,71,71,Queens,2242333.59,Woodside
21-Aug,36081026300,4026300,2758,65315,68073,Queens,2242333.59,Woodside
19-May,36081005400,4005400,14673,38137,52810,Queens,4486727.314,Ozone Park
21-May,36081005400,4005400,982,82108,83090,Queens,4486727.314,Ozone Park
19-Jun,36081005400,4005400,7758,73901,81659,Queens,4486727.314,Ozone Park
21-Jun,36081005400,4005400,18988,85256,104244,Queens,4486727.314,Ozone Park
19-Jul,36081005400,4005400,3131,43902,47033,Queens,4486727.314,Ozone Park
21-Jul,36081005400,4005400,3958,60607,64565,Queens,4486727.314,Ozone Park
19-Aug,36081005400,4005400,4295,57457,61752,Queens,4486727.314,Ozone Park
21-Aug,36081005400,4005400,13460,102967,116427,Queens,4486727.314,Ozone Park
19-May,36081008600,4008600,15103,42646,57749,Queens,3562475.848,Ozone Park
21-May,36081008600,4008600,16839,119178,136017,Queens,3562475.848,Ozone Park
19-Jun,36081008600,4008600,5689,18681,24370,Queens,3562475.848,Ozone Park
21-Jun,36081008600,4008600,14704,171330,186034,Queens,3562475.848,Ozone Park
19-Jul,36081008600,4008600,10369,48580,58949,Queens,3562475.848,Ozone Park
21-Jul,36081008600,4008600,9989,63724,73713,Queens,3562475.848,Ozone Park
19-Aug,36081008600,4008600,0,71,71,Queens,3562475.848,Ozone Park
21-Aug,36081008600,4008600,9933,101438,111371,Queens,3562475.848,Ozone Park
19-May,36081066401,4066401,5988,61840,67828,Queens,11982313.98,Rosedale
21-May,36081066401,4066401,8139,87569,95708,Queens,11982313.98,Rosedale
19-Jun,36081066401,4066401,14880,71,14951,Queens,11982313.98,Rosedale
21-Jun,36081066401,4066401,9031,64121,73152,Queens,11982313.98,Rosedale
19-Jul,36081066401,4066401,5983,94075,100058,Queens,11982313.98,Rosedale
21-Jul,36081066401,4066401,13902,110140,124042,Queens,11982313.98,Rosedale
19-Aug,36081066401,4066401,0,23199,23199,Queens,11982313.98,Rosedale
21-Aug,36081066401,4066401,11084,57065,68149,Queens,11982313.98,Rosedale
19-May,36081066900,4066900,19313,24113,43426,Queens,1723437.329,Maspeth
21-May,36081066900,4066900,4828,43141,47969,Queens,1723437.329,Maspeth
19-Jun,36081066900,4066900,5336,45841,51177,Queens,1723437.329,Maspeth
21-Jun,36081066900,4066900,8122,105712,113834,Queens,1723437.329,Maspeth
19-Jul,36081066900,4066900,6583,181763,188346,Queens,1723437.329,Maspeth
21-Jul,36081066900,4066900,9601,46515,56116,Queens,1723437.329,Maspeth
19-Aug,36081066900,4066900,10388,112458,122846,Queens,1723437.329,Maspeth
21-Aug,36081066900,4066900,14138,121865,136003,Queens,1723437.329,Maspeth
19-May,36081048500,4048500,10016,3311,13327,Queens,3415647.865,Elmhurst
21-May,36081048500,4048500,7855,59629,67484,Queens,3415647.865,Elmhurst
19-Jun,36081048500,4048500,0,51586,51586,Queens,3415647.865,Elmhurst
21-Jun,36081048500,4048500,8222,91213,99435,Queens,3415647.865,Elmhurst
19-Jul,36081048500,4048500,1661,132166,133827,Queens,3415647.865,Elmhurst
21-Jul,36081048500,4048500,0,105600,105600,Queens,3415647.865,Elmhurst
19-Aug,36081048500,4048500,10163,64850,75013,Queens,3415647.865,Elmhurst
21-Aug,36081048500,4048500,7139,18302,25441,Queens,3415647.865,Elmhurst
19-May,36081012500,4012500,7973,137553,145526,Queens,1752242.246,Astoria (North)-Ditmars-Steinway
21-May,36081012500,4012500,10594,58431,69025,Queens,1752242.246,Astoria (North)-Ditmars-Steinway
19-Jun,36081012500,4012500,15393,109582,124975,Queens,1752242.246,Astoria (North)-Ditmars-Steinway
21-Jun,36081012500,4012500,8075,51132,59207,Queens,1752242.246,Astoria (North)-Ditmars-Steinway
19-Jul,36081012500,4012500,18535,78365,96900,Queens,1752242.246,Astoria (North)-Ditmars-Steinway
21-Jul,36081012500,4012500,4612,19717,24329,Queens,1752242.246,Astoria (North)-Ditmars-Steinway
19-Aug,36081012500,4012500,14176,140608,154784,Queens,1752242.246,Astoria (North)-Ditmars-Steinway
21-Aug,36081012500,4012500,9197,53997,63194,Queens,1752242.246,Astoria (North)-Ditmars-Steinway
19-May,36005038900,2038900,15674,30506,46180,Bronx,1846409.317,Belmont
21-May,36005038900,2038900,8377,86196,94573,Bronx,1846409.317,Belmont
19-Jun,36005038900,2038900,13650,78060,91710,Bronx,1846409.317,Belmont
21-Jun,36005038900,2038900,15501,66805,82306,Bronx,1846409.317,Belmont
19-Jul,36005038900,2038900,19605,35163,54768,Bronx,1846409.317,Belmont
21-Jul,36005038900,2038900,5527,62099,67626,Bronx,1846409.317,Belmont
19-Aug,36005038900,2038900,11186,71,11257,Bronx,1846409.317,Belmont
21-Aug,36005038900,2038900,14575,71712,86287,Bronx,1846409.317,Belmont
19-May,36005029301,2029301,9602,106856,116458,Bronx,2678153.336,Riverdale-Spuyten Duyvil
21-May,36005029301,2029301,113,71,184,Bronx,2678153.336,Riverdale-Spuyten Duyvil
19-Jun,36005029301,2029301,15935,21185,37120,Bronx,2678153.336,Riverdale-Spuyten Duyvil
21-Jun,36005029301,2029301,10940,62801,73741,Bronx,2678153.336,Riverdale-Spuyten Duyvil
19-Jul,36005029301,2029301,12595,63384,75979,Bronx,2678153.336,Riverdale-Spuyten Duyvil
21-Jul,36005029301,2029301,11556,77289,88845,Bronx,2678153.336,Riverdale-Spuyten Duyvil
19-Aug,36005029301,2029301,847,78005,78852,Bronx,2678153.336,Riverdale-Spuyten Duyvil
21-Aug,36005029301,2029301,9691,98288,107979,Bronx,2678153.336,Riverdale-Spuyten Duyvil
19-May,36081013000,4013000,10064,21072,31136,Queens,2016151.066,Richmond Hill
21-May,36081013000,4013000,0,56205,56205,Queens,2016151.066,Richmond Hill
19-Jun,36081013000,4013000,13982,111097,125079,Queens,2016151.066,Richmond Hill
21-Jun,36081013000,4013000,1702,80742,82444,Queens,2016151.066,Richmond Hill
19-Jul,36081013000,4013000,7013,75304,82317,Queens,2016151.066,Richmond Hill
21-Jul,36081013000,4013000,18663,57341,76004,Queens,2016151.066,Richmond Hill
19-Aug,36081013000,4013000,8800,108351,117151,Queens,2016151.066,Richmond Hill
21-Aug,36081013000,4013000,9804,147928,157732,Queens,2016151.066,Richmond Hill
19-May,36081073100,4073100,0,70538,70538,Queens,2029218.079,Forest Hills
21-May,36081073100,4073100,13311,113575,126886,Queens,2029218.079,Forest Hills
19-Jun,36081073100,4073100,6069,43082,49151,Queens,2029218.079,Forest Hills
21-Jun,36081073100,4073100,10592,33631,44223,Queens,2029218.079,Forest Hills
19-Jul,36081073100,4073100,18196,59171,77367,Queens,2029218.079,Forest Hills
21-Jul,36081073100,4073100,3551,52611,56162,Queens,2029218.079,Forest Hills
19-Aug,36081073100,4073100,13775,17759,31534,Queens,2029218.079,Forest Hills
21-Aug,36081073100,4073100,2366,50426,52792,Queens,2029218.079,Forest Hills
19-May,36081074900,4074900,3015,72911,75926,Queens,3859945.226,Forest Hills
21-May,36081074900,4074900,15875,77826,93701,Queens,3859945.226,Forest Hills
19-Jun,36081074900,4074900,16585,48277,64862,Queens,3859945.226,Forest Hills
21-Jun,36081074900,4074900,6104,149914,156018,Queens,3859945.226,Forest Hills
19-Jul,36081074900,4074900,17126,52976,70102,Queens,3859945.226,Forest Hills
21-Jul,36081074900,4074900,6425,71,6496,Queens,3859945.226,Forest Hills
19-Aug,36081074900,4074900,266,48706,48972,Queens,3859945.226,Forest Hills
21-Aug,36081074900,4074900,7979,67453,75432,Queens,3859945.226,Forest Hills
19-May,36005042500,2042500,6003,49193,55196,Bronx,3154915.507,Norwood
21-May,36005042500,2042500,11579,78319,89898,Bronx,3154915.507,Norwood
19-Jun,36005042500,2042500,19917,2018,21935,Bronx,3154915.507,Norwood
21-Jun,36005042500,2042500,12911,75354,88265,Bronx,3154915.507,Norwood
19-Jul,36005042500,2042500,7993,60047,68040,Bronx,3154915.507,Norwood
21-Jul,36005042500,2042500,11122,80853,91975,Bronx,3154915.507,Norwood
19-Aug,36005042500,2042500,5190,40989,46179,Bronx,3154915.507,Norwood
21-Aug,36005042500,2042500,10634,111218,121852,Bronx,3154915.507,Norwood
19-May,36081026502,4026502,0,36107,36107,Queens,752238.1865,Woodside
21-May,36081026502,4026502,7769,114721,122490,Queens,752238.1865,Woodside
19-Jun,36081026502,4026502,8709,106439,115148,Queens,752238.1865,Woodside
21-Jun,36081026502,4026502,5776,58069,63845,Queens,752238.1865,Woodside
19-Jul,36081026502,4026502,12756,32982,45738,Queens,752238.1865,Woodside
21-Jul,36081026502,4026502,0,65276,65276,Queens,752238.1865,Woodside
19-Aug,36081026502,4026502,5664,41430,47094,Queens,752238.1865,Woodside
21-Aug,36081026502,4026502,9229,65277,74506,Queens,752238.1865,Woodside
19-May,36081026501,4026501,5865,105562,111427,Queens,1155418.732,Elmhurst
21-May,36081026501,4026501,4347,98743,103090,Queens,1155418.732,Elmhurst
19-Jun,36081026501,4026501,11501,1466,12967,Queens,1155418.732,Elmhurst
21-Jun,36081026501,4026501,0,11737,11737,Queens,1155418.732,Elmhurst
19-Jul,36081026501,4026501,12576,84723,97299,Queens,1155418.732,Elmhurst
21-Jul,36081026501,4026501,5092,87788,92880,Queens,1155418.732,Elmhurst
19-Aug,36081026501,4026501,10580,71,10651,Queens,1155418.732,Elmhurst
21-Aug,36081026501,4026501,14323,137656,151979,Queens,1155418.732,Elmhurst
19-May,36081048301,4048301,4119,100644,104763,Queens,931227.0306,Elmhurst
21-May,36081048301,4048301,12506,42374,54880,Queens,931227.0306,Elmhurst
19-Jun,36081048301,4048301,8831,82388,91219,Queens,931227.0306,Elmhurst
21-Jun,36081048301,4048301,11279,18772,30051,Queens,931227.0306,Elmhurst
19-Jul,36081048301,4048301,6090,127908,133998,Queens,931227.0306,Elmhurst
21-Jul,36081048301,4048301,6278,91986,98264,Queens,931227.0306,Elmhurst
19-Aug,36081048301,4048301,12758,64560,77318,Queens,931227.0306,Elmhurst
21-Aug,36081048301,4048301,7452,87067,94519,Queens,931227.0306,Elmhurst
19-May,36005002800,2002800,6076,16089,22165,Bronx,4706441.346,Soundview-Bruckner-Bronx River
21-May,36005002800,2002800,9292,64400,73692,Bronx,4706441.346,Soundview-Bruckner-Bronx River
19-Jun,36005002800,2002800,12602,125045,137647,Bronx,4706441.346,Soundview-Bruckner-Bronx River
21-Jun,36005002800,2002800,2249,69280,71529,Bronx,4706441.346,Soundview-Bruckner-Bronx River
19-Jul,36005002800,2002800,8139,73567,81706,Bronx,4706441.346,Soundview-Bruckner-Bronx River
21-Jul,36005002800,2002800,5637,41414,47051,Bronx,4706441.346,Soundview-Bruckner-Bronx River
19-Aug,36005002800,2002800,4215,165349,169564,Bronx,4706441.346,Soundview-Bruckner-Bronx River
21-Aug,36005002800,2002800,6279,29196,35475,Bronx,4706441.346,Soundview-Bruckner-Bronx River
19-May,36081066100,4066100,14085,61560,75645,Queens,1439518.728,Middle Village
21-May,36081066100,4066100,12331,44357,56688,Queens,1439518.728,Middle Village
19-Jun,36081066100,4066100,6687,82299,88986,Queens,1439518.728,Middle Village
21-Jun,36081066100,4066100,17846,74114,91960,Queens,1439518.728,Middle Village
19-Jul,36081066100,4066100,17158,57665,74823,Queens,1439518.728,Middle Village
21-Jul,36081066100,4066100,3553,109511,113064,Queens,1439518.728,Middle Village
19-Aug,36081066100,4066100,11672,89906,101578,Queens,1439518.728,Middle Village
21-Aug,36081066100,4066100,9436,1591,11027,Queens,1439518.728,Middle Village
19-May,36081065900,4065900,6077,71,6148,Queens,2083726.484,Middle Village
21-May,36081065900,4065900,12661,114683,127344,Queens,2083726.484,Middle Village
19-Jun,36081065900,4065900,10873,70291,81164,Queens,2083726.484,Middle Village
21-Jun,36081065900,4065900,3841,215920,219761,Queens,2083726.484,Middle Village
19-Jul,36081065900,4065900,15360,41713,57073,Queens,2083726.484,Middle Village
21-Jul,36081065900,4065900,8989,88665,97654,Queens,2083726.484,Middle Village
19-Aug,36081065900,4065900,11979,88310,100289,Queens,2083726.484,Middle Village
21-Aug,36081065900,4065900,11965,35040,47005,Queens,2083726.484,Middle Village
19-May,36081066501,4066501,12933,86116,99049,Queens,3506166.382,Middle Village
21-May,36081066501,4066501,3631,44790,48421,Queens,3506166.382,Middle Village
19-Jun,36081066501,4066501,2880,113196,116076,Queens,3506166.382,Middle Village
21-Jun,36081066501,4066501,3024,145353,148377,Queens,3506166.382,Middle Village
19-Jul,36081066501,4066501,13797,58790,72587,Queens,3506166.382,Middle Village
21-Jul,36081066501,4066501,0,95216,95216,Queens,3506166.382,Middle Village
19-Aug,36081066501,4066501,13181,68064,81245,Queens,3506166.382,Middle Village
21-Aug,36081066501,4066501,9216,84324,93540,Queens,3506166.382,Middle Village
19-May,36005025600,2025600,13570,14254,27824,Bronx,2037862.72,Morris Park
21-May,36005025600,2025600,11844,64699,76543,Bronx,2037862.72,Morris Park
19-Jun,36005025600,2025600,11854,91897,103751,Bronx,2037862.72,Morris Park
21-Jun,36005025600,2025600,12492,84387,96879,Bronx,2037862.72,Morris Park
19-Jul,36005025600,2025600,4357,73645,78002,Bronx,2037862.72,Morris Park
21-Jul,36005025600,2025600,0,22128,22128,Bronx,2037862.72,Morris Park
19-Aug,36005025600,2025600,12213,81349,93562,Bronx,2037862.72,Morris Park
21-Aug,36005025600,2025600,14974,31558,46532,Bronx,2037862.72,Morris Park
19-May,36081102900,4102900,14597,79997,94594,Queens,5270086.561,Whitestone-Beechhurst
21-May,36081102900,4102900,11290,91665,102955,Queens,5270086.561,Whitestone-Beechhurst
19-Jun,36081102900,4102900,14198,182983,197181,Queens,5270086.561,Whitestone-Beechhurst
21-Jun,36081102900,4102900,8671,97778,106449,Queens,5270086.561,Whitestone-Beechhurst
19-Jul,36081102900,4102900,13698,38720,52418,Queens,5270086.561,Whitestone-Beechhurst
21-Jul,36081102900,4102900,0,35926,35926,Queens,5270086.561,Whitestone-Beechhurst
19-Aug,36081102900,4102900,20249,110149,130398,Queens,5270086.561,Whitestone-Beechhurst
21-Aug,36081102900,4102900,0,114747,114747,Queens,5270086.561,Whitestone-Beechhurst
19-May,36081097300,4097300,11075,84178,95253,Queens,5638287.019,Whitestone-Beechhurst
21-May,36081097300,4097300,11009,94701,105710,Queens,5638287.019,Whitestone-Beechhurst
19-Jun,36081097300,4097300,7495,121421,128916,Queens,5638287.019,Whitestone-Beechhurst
21-Jun,36081097300,4097300,14512,32188,46700,Queens,5638287.019,Whitestone-Beechhurst
19-Jul,36081097300,4097300,14990,113497,128487,Queens,5638287.019,Whitestone-Beechhurst
21-Jul,36081097300,4097300,9007,71,9078,Queens,5638287.019,Whitestone-Beechhurst
19-Aug,36081097300,4097300,2772,66199,68971,Queens,5638287.019,Whitestone-Beechhurst
21-Aug,36081097300,4097300,5143,35090,40233,Queens,5638287.019,Whitestone-Beechhurst
19-May,36081060100,4060100,4277,87999,92276,Queens,1661594.07,Maspeth
21-May,36081060100,4060100,5523,50948,56471,Queens,1661594.07,Maspeth
19-Jun,36081060100,4060100,15176,91256,106432,Queens,1661594.07,Maspeth
21-Jun,36081060100,4060100,11578,47427,59005,Queens,1661594.07,Maspeth
19-Jul,36081060100,4060100,10229,84803,95032,Queens,1661594.07,Maspeth
21-Jul,36081060100,4060100,168,30637,30805,Queens,1661594.07,Maspeth
19-Aug,36081060100,4060100,877,145147,146024,Queens,1661594.07,Maspeth
21-Aug,36081060100,4060100,1135,71789,72924,Queens,1661594.07,Maspeth
19-May,36081063500,4063500,13246,552,13798,Queens,2039753.492,Glendale
21-May,36081063500,4063500,15644,102886,118530,Queens,2039753.492,Glendale
19-Jun,36081063500,4063500,4136,90321,94457,Queens,2039753.492,Glendale
21-Jun,36081063500,4063500,7447,77519,84966,Queens,2039753.492,Glendale
19-Jul,36081063500,4063500,4313,42437,46750,Queens,2039753.492,Glendale
21-Jul,36081063500,4063500,6903,124718,131621,Queens,2039753.492,Glendale
19-Aug,36081063500,4063500,17761,19317,37078,Queens,2039753.492,Glendale
21-Aug,36081063500,4063500,11591,112408,123999,Queens,2039753.492,Glendale
19-May,36081062100,4062100,2625,55011,57636,Queens,2794044.161,Middle Village
21-May,36081062100,4062100,445,43786,44231,Queens,2794044.161,Middle Village
19-Jun,36081062100,4062100,8190,29973,38163,Queens,2794044.161,Middle Village
21-Jun,36081062100,4062100,8321,47591,55912,Queens,2794044.161,Middle Village
19-Jul,36081062100,4062100,9981,161616,171597,Queens,2794044.161,Middle Village
21-Jul,36081062100,4062100,8104,62153,70257,Queens,2794044.161,Middle Village
19-Aug,36081062100,4062100,16783,107442,124225,Queens,2794044.161,Middle Village
21-Aug,36081062100,4062100,3979,32066,36045,Queens,2794044.161,Middle Village
19-May,36081063700,4063700,8984,72516,81500,Queens,7447820.5,Glendale
21-May,36081063700,4063700,3002,86205,89207,Queens,7447820.5,Glendale
19-Jun,36081063700,4063700,0,178303,178303,Queens,7447820.5,Glendale
21-Jun,36081063700,4063700,11836,128714,140550,Queens,7447820.5,Glendale
19-Jul,36081063700,4063700,12008,23591,35599,Queens,7447820.5,Glendale
21-Jul,36081063700,4063700,14034,112812,126846,Queens,7447820.5,Glendale
19-Aug,36081063700,4063700,2817,35286,38103,Queens,7447820.5,Glendale
21-Aug,36081063700,4063700,4108,92508,96616,Queens,7447820.5,Glendale
19-May,36081077500,4077500,4935,63517,68452,Queens,2469600.849,Kew Gardens
21-May,36081077500,4077500,14557,32474,47031,Queens,2469600.849,Kew Gardens
19-Jun,36081077500,4077500,0,57871,57871,Queens,2469600.849,Kew Gardens
21-Jun,36081077500,4077500,14752,63711,78463,Queens,2469600.849,Kew Gardens
19-Jul,36081077500,4077500,12326,71,12397,Queens,2469600.849,Kew Gardens
21-Jul,36081077500,4077500,6765,12867,19632,Queens,2469600.849,Kew Gardens
19-Aug,36081077500,4077500,13377,113390,126767,Queens,2469600.849,Kew Gardens
21-Aug,36081077500,4077500,11425,80980,92405,Queens,2469600.849,Kew Gardens
19-May,36005039700,2039700,3914,71797,75711,Bronx,5593958.083,Belmont
21-May,36005039700,2039700,0,1017,1017,Bronx,5593958.083,Belmont
19-Jun,36005039700,2039700,3394,53468,56862,Bronx,5593958.083,Belmont
21-Jun,36005039700,2039700,2608,39686,42294,Bronx,5593958.083,Belmont
19-Jul,36005039700,2039700,550,89406,89956,Bronx,5593958.083,Belmont
21-Jul,36005039700,2039700,6291,75924,82215,Bronx,5593958.083,Belmont
19-Aug,36005039700,2039700,1563,119780,121343,Bronx,5593958.083,Belmont
21-Aug,36005039700,2039700,6343,15870,22213,Bronx,5593958.083,Belmont
19-May,36005039300,2039300,2390,142483,144873,Bronx,1963927.152,Belmont
21-May,36005039300,2039300,6542,52335,58877,Bronx,1963927.152,Belmont
19-Jun,36005039300,2039300,15544,109479,125023,Bronx,1963927.152,Belmont
21-Jun,36005039300,2039300,315,53479,53794,Bronx,1963927.152,Belmont
19-Jul,36005039300,2039300,0,30927,30927,Bronx,1963927.152,Belmont
21-Jul,36005039300,2039300,10955,18893,29848,Bronx,1963927.152,Belmont
19-Aug,36005039300,2039300,2268,83802,86070,Bronx,1963927.152,Belmont
21-Aug,36005039300,2039300,14450,12153,26603,Bronx,1963927.152,Belmont
19-May,36081063900,4063900,13723,5063,18786,Queens,2604996.758,Glendale
21-May,36081063900,4063900,9001,77350,86351,Queens,2604996.758,Glendale
19-Jun,36081063900,4063900,6737,102197,108934,Queens,2604996.758,Glendale
21-Jun,36081063900,4063900,4240,9272,13512,Queens,2604996.758,Glendale
19-Jul,36081063900,4063900,9049,101626,110675,Queens,2604996.758,Glendale
21-Jul,36081063900,4063900,4127,121959,126086,Queens,2604996.758,Glendale
19-Aug,36081063900,4063900,19734,86001,105735,Queens,2604996.758,Glendale
21-Aug,36081063900,4063900,14095,78786,92881,Queens,2604996.758,Glendale
19-May,36081046300,4046300,7291,120627,127918,Queens,1710782.361,Elmhurst
21-May,36081046300,4046300,16267,70994,87261,Queens,1710782.361,Elmhurst
19-Jun,36081046300,4046300,2179,79870,82049,Queens,1710782.361,Elmhurst
21-Jun,36081046300,4046300,3902,39924,43826,Queens,1710782.361,Elmhurst
19-Jul,36081046300,4046300,9787,116402,126189,Queens,1710782.361,Elmhurst
21-Jul,36081046300,4046300,8725,9636,18361,Queens,1710782.361,Elmhurst
19-Aug,36081046300,4046300,15428,135018,150446,Queens,1710782.361,Elmhurst
21-Aug,36081046300,4046300,8456,114523,122979,Queens,1710782.361,Elmhurst
19-May,36081047100,4047100,1311,80298,81609,Queens,1692064.806,Elmhurst
21-May,36081047100,4047100,10351,80200,90551,Queens,1692064.806,Elmhurst
19-Jun,36081047100,4047100,10855,90127,100982,Queens,1692064.806,Elmhurst
21-Jun,36081047100,4047100,13375,112065,125440,Queens,1692064.806,Elmhurst
19-Jul,36081047100,4047100,8329,56406,64735,Queens,1692064.806,Elmhurst
21-Jul,36081047100,4047100,7967,50336,58303,Queens,1692064.806,Elmhurst
19-Aug,36081047100,4047100,1409,83559,84968,Queens,1692064.806,Elmhurst
21-Aug,36081047100,4047100,4827,42827,47654,Queens,1692064.806,Elmhurst
19-May,36005035000,2035000,15942,40183,56125,Bronx,2066395.843,Pelham Gardens
21-May,36005035000,2035000,9518,71,9589,Bronx,2066395.843,Pelham Gardens
19-Jun,36005035000,2035000,4430,33330,37760,Bronx,2066395.843,Pelham Gardens
21-Jun,36005035000,2035000,9103,111710,120813,Bronx,2066395.843,Pelham Gardens
19-Jul,36005035000,2035000,7073,89593,96666,Bronx,2066395.843,Pelham Gardens
21-Jul,36005035000,2035000,10374,96292,106666,Bronx,2066395.843,Pelham Gardens
19-Aug,36005035000,2035000,11520,101439,112959,Bronx,2066395.843,Pelham Gardens
21-Aug,36005035000,2035000,11140,95826,106966,Bronx,2066395.843,Pelham Gardens
19-May,36081024900,4024900,8261,62074,70335,Queens,2196907.251,Woodside
21-May,36081024900,4024900,8749,93797,102546,Queens,2196907.251,Woodside
19-Jun,36081024900,4024900,4189,61932,66121,Queens,2196907.251,Woodside
21-Jun,36081024900,4024900,10307,54698,65005,Queens,2196907.251,Woodside
19-Jul,36081024900,4024900,7243,22805,30048,Queens,2196907.251,Woodside
21-Jul,36081024900,4024900,14446,66666,81112,Queens,2196907.251,Woodside
19-Aug,36081024900,4024900,10636,149220,159856,Queens,2196907.251,Woodside
21-Aug,36081024900,4024900,17029,39525,56554,Queens,2196907.251,Woodside
19-May,36081026100,4026100,5992,77272,83264,Queens,2384003.702,Woodside
21-May,36081026100,4026100,4080,123427,127507,Queens,2384003.702,Woodside
19-Jun,36081026100,4026100,11703,76770,88473,Queens,2384003.702,Woodside
21-Jun,36081026100,4026100,7210,142759,149969,Queens,2384003.702,Woodside
19-Jul,36081026100,4026100,7702,33873,41575,Queens,2384003.702,Woodside
21-Jul,36081026100,4026100,7186,71,7257,Queens,2384003.702,Woodside
19-Aug,36081026100,4026100,7777,94154,101931,Queens,2384003.702,Woodside
21-Aug,36081026100,4026100,12709,50252,62961,Queens,2384003.702,Woodside
19-May,36061021000,1021000,625,33094,33719,Manhattan,2172878.676,East Harlem (North)
21-May,36061021000,1021000,14485,123123,137608,Manhattan,2172878.676,East Harlem (North)
19-Jun,36061021000,1021000,4195,61880,66075,Manhattan,2172878.676,East Harlem (North)
21-Jun,36061021000,1021000,8980,44062,53042,Manhattan,2172878.676,East Harlem (North)
19-Jul,36061021000,1021000,126,77697,77823,Manhattan,2172878.676,East Harlem (North)
21-Jul,36061021000,1021000,7943,24171,32114,Manhattan,2172878.676,East Harlem (North)
19-Aug,36061021000,1021000,6248,142437,148685,Manhattan,2172878.676,East Harlem (North)
21-Aug,36061021000,1021000,8614,136973,145587,Manhattan,2172878.676,East Harlem (North)
19-May,36061021200,1021200,12082,71889,83971,Manhattan,1900275.546,Harlem (North)
21-May,36061021200,1021200,5012,45578,50590,Manhattan,1900275.546,Harlem (North)
19-Jun,36061021200,1021200,8097,59153,67250,Manhattan,1900275.546,Harlem (North)
21-Jun,36061021200,1021200,22105,81148,103253,Manhattan,1900275.546,Harlem (North)
19-Jul,36061021200,1021200,18382,116162,134544,Manhattan,1900275.546,Harlem (North)
21-Jul,36061021200,1021200,20049,2975,23024,Manhattan,1900275.546,Harlem (North)
19-Aug,36061021200,1021200,0,29729,29729,Manhattan,1900275.546,Harlem (North)
21-Aug,36061021200,1021200,6979,84117,91096,Manhattan,1900275.546,Harlem (North)
19-May,36005027600,2027600,8461,81906,90367,Bronx,19952523.18,Pelham Bay Park
21-May,36005027600,2027600,5454,69703,75157,Bronx,19952523.18,Pelham Bay Park
19-Jun,36005027600,2027600,3549,52414,55963,Bronx,19952523.18,Pelham Bay Park
21-Jun,36005027600,2027600,0,27752,27752,Bronx,19952523.18,Pelham Bay Park
19-Jul,36005027600,2027600,6336,72278,78614,Bronx,19952523.18,Pelham Bay Park
21-Jul,36005027600,2027600,7780,71097,78877,Bronx,19952523.18,Pelham Bay Park
19-Aug,36005027600,2027600,18073,79105,97178,Bronx,19952523.18,Pelham Bay Park
21-Aug,36005027600,2027600,7528,88874,96402,Bronx,19952523.18,Pelham Bay Park
19-May,36061015502,1015502,10669,60640,71309,Manhattan,1107525.487,Upper West Side-Lincoln Square
21-May,36061015502,1015502,6341,106984,113325,Manhattan,1107525.487,Upper West Side-Lincoln Square
19-Jun,36061015502,1015502,9270,62991,72261,Manhattan,1107525.487,Upper West Side-Lincoln Square
21-Jun,36061015502,1015502,11698,40906,52604,Manhattan,1107525.487,Upper West Side-Lincoln Square
19-Jul,36061015502,1015502,16010,18960,34970,Manhattan,1107525.487,Upper West Side-Lincoln Square
21-Jul,36061015502,1015502,1168,74501,75669,Manhattan,1107525.487,Upper West Side-Lincoln Square
19-Aug,36061015502,1015502,8267,118180,126447,Manhattan,1107525.487,Upper West Side-Lincoln Square
21-Aug,36061015502,1015502,14323,74602,88925,Manhattan,1107525.487,Upper West Side-Lincoln Square
19-May,36081010701,4010701,15779,95339,111118,Queens,17172406.65,Astoria (North)-Ditmars-Steinway
21-May,36081010701,4010701,5752,100223,105975,Queens,17172406.65,Astoria (North)-Ditmars-Steinway
19-Jun,36081010701,4010701,2050,18377,20427,Queens,17172406.65,Astoria (North)-Ditmars-Steinway
21-Jun,36081010701,4010701,11150,167157,178307,Queens,17172406.65,Astoria (North)-Ditmars-Steinway
19-Jul,36081010701,4010701,10170,92912,103082,Queens,17172406.65,Astoria (North)-Ditmars-Steinway
21-Jul,36081010701,4010701,7578,102146,109724,Queens,17172406.65,Astoria (North)-Ditmars-Steinway
19-Aug,36081010701,4010701,8832,74573,83405,Queens,17172406.65,Astoria (North)-Ditmars-Steinway
21-Aug,36081010701,4010701,14229,86790,101019,Queens,17172406.65,Astoria (North)-Ditmars-Steinway
19-May,36081012301,4012301,6619,71,6690,Queens,6366950.852,Astoria (North)-Ditmars-Steinway
21-May,36081012301,4012301,8276,83707,91983,Queens,6366950.852,Astoria (North)-Ditmars-Steinway
19-Jun,36081012301,4012301,15719,8702,24421,Queens,6366950.852,Astoria (North)-Ditmars-Steinway
21-Jun,36081012301,4012301,3388,110118,113506,Queens,6366950.852,Astoria (North)-Ditmars-Steinway
19-Jul,36081012301,4012301,516,109287,109803,Queens,6366950.852,Astoria (North)-Ditmars-Steinway
21-Jul,36081012301,4012301,1683,90476,92159,Queens,6366950.852,Astoria (North)-Ditmars-Steinway
19-Aug,36081012301,4012301,5249,101589,106838,Queens,6366950.852,Astoria (North)-Ditmars-Steinway
21-Aug,36081012301,4012301,18995,41763,60758,Queens,6366950.852,Astoria (North)-Ditmars-Steinway
19-May,36081085300,4085300,3718,134234,137952,Queens,2102465.733,Flushing-Willets Point
21-May,36081085300,4085300,12224,126444,138668,Queens,2102465.733,Flushing-Willets Point
19-Jun,36081085300,4085300,12182,93933,106115,Queens,2102465.733,Flushing-Willets Point
21-Jun,36081085300,4085300,4083,25499,29582,Queens,2102465.733,Flushing-Willets Point
19-Jul,36081085300,4085300,7440,97656,105096,Queens,2102465.733,Flushing-Willets Point
21-Jul,36081085300,4085300,14273,68425,82698,Queens,2102465.733,Flushing-Willets Point
19-Aug,36081085300,4085300,5194,103552,108746,Queens,2102465.733,Flushing-Willets Point
21-Aug,36081085300,4085300,5008,18924,23932,Queens,2102465.733,Flushing-Willets Point
19-May,36081161700,4161700,7283,140800,148083,Queens,7560560.579,Bellerose
21-May,36081161700,4161700,7577,67211,74788,Queens,7560560.579,Bellerose
19-Jun,36081161700,4161700,16480,56147,72627,Queens,7560560.579,Bellerose
21-Jun,36081161700,4161700,6292,137455,143747,Queens,7560560.579,Bellerose
19-Jul,36081161700,4161700,5694,33677,39371,Queens,7560560.579,Bellerose
21-Jul,36081161700,4161700,13089,67650,80739,Queens,7560560.579,Bellerose
19-Aug,36081161700,4161700,16102,86554,102656,Queens,7560560.579,Bellerose
21-Aug,36081161700,4161700,2229,30681,32910,Queens,7560560.579,Bellerose
19-May,36081099701,4099701,10359,115306,125665,Queens,10495254.3,Bay Terrace-Clearview
21-May,36081099701,4099701,13681,50784,64465,Queens,10495254.3,Bay Terrace-Clearview
19-Jun,36081099701,4099701,13852,15606,29458,Queens,10495254.3,Bay Terrace-Clearview
21-Jun,36081099701,4099701,5393,21944,27337,Queens,10495254.3,Bay Terrace-Clearview
19-Jul,36081099701,4099701,6161,64328,70489,Queens,10495254.3,Bay Terrace-Clearview
21-Jul,36081099701,4099701,14269,45922,60191,Queens,10495254.3,Bay Terrace-Clearview
19-Aug,36081099701,4099701,11101,67053,78154,Queens,10495254.3,Bay Terrace-Clearview
21-Aug,36081099701,4099701,9044,35156,44200,Queens,10495254.3,Bay Terrace-Clearview
19-May,36081101700,4101700,16871,167474,184345,Queens,10640265.44,Bay Terrace-Clearview
21-May,36081101700,4101700,879,162096,162975,Queens,10640265.44,Bay Terrace-Clearview
19-Jun,36081101700,4101700,5682,2749,8431,Queens,10640265.44,Bay Terrace-Clearview
21-Jun,36081101700,4101700,9747,114493,124240,Queens,10640265.44,Bay Terrace-Clearview
19-Jul,36081101700,4101700,12001,79627,91628,Queens,10640265.44,Bay Terrace-Clearview
21-Jul,36081101700,4101700,5894,92497,98391,Queens,10640265.44,Bay Terrace-Clearview
19-Aug,36081101700,4101700,6526,134921,141447,Queens,10640265.44,Bay Terrace-Clearview
21-Aug,36081101700,4101700,0,57143,57143,Queens,10640265.44,Bay Terrace-Clearview
19-May,36005023702,2023702,4766,69061,73827,Bronx,515656.545,Fordham Heights
21-May,36005023702,2023702,8079,34295,42374,Bronx,515656.545,Fordham Heights
19-Jun,36005023702,2023702,11160,76244,87404,Bronx,515656.545,Fordham Heights
21-Jun,36005023702,2023702,4583,71,4654,Bronx,515656.545,Fordham Heights
19-Jul,36005023702,2023702,6046,104041,110087,Bronx,515656.545,Fordham Heights
21-Jul,36005023702,2023702,8143,25468,33611,Bronx,515656.545,Fordham Heights
19-Aug,36005023702,2023702,11716,64099,75815,Bronx,515656.545,Fordham Heights
21-Aug,36005023702,2023702,5933,106525,112458,Bronx,515656.545,Fordham Heights
19-May,36005039901,2039901,13965,71,14036,Bronx,1637824.879,University Heights (North)-Fordham
21-May,36005039901,2039901,7015,38272,45287,Bronx,1637824.879,University Heights (North)-Fordham
19-Jun,36005039901,2039901,2003,61353,63356,Bronx,1637824.879,University Heights (North)-Fordham
21-Jun,36005039901,2039901,8493,78376,86869,Bronx,1637824.879,University Heights (North)-Fordham
19-Jul,36005039901,2039901,9472,107869,117341,Bronx,1637824.879,University Heights (North)-Fordham
21-Jul,36005039901,2039901,5293,101689,106982,Bronx,1637824.879,University Heights (North)-Fordham
19-Aug,36005039901,2039901,10994,71006,82000,Bronx,1637824.879,University Heights (North)-Fordham
21-Aug,36005039901,2039901,14413,136122,150535,Bronx,1637824.879,University Heights (North)-Fordham
19-May,36005040100,2040100,6448,59226,65674,Bronx,1841946.023,University Heights (North)-Fordham
21-May,36005040100,2040100,2445,71112,73557,Bronx,1841946.023,University Heights (North)-Fordham
19-Jun,36005040100,2040100,6220,70758,76978,Bronx,1841946.023,University Heights (North)-Fordham
21-Jun,36005040100,2040100,8477,86567,95044,Bronx,1841946.023,University Heights (North)-Fordham
19-Jul,36005040100,2040100,11389,106345,117734,Bronx,1841946.023,University Heights (North)-Fordham
21-Jul,36005040100,2040100,8422,47647,56069,Bronx,1841946.023,University Heights (North)-Fordham
19-Aug,36005040100,2040100,955,61708,62663,Bronx,1841946.023,University Heights (North)-Fordham
21-Aug,36005040100,2040100,7962,26395,34357,Bronx,1841946.023,University Heights (North)-Fordham
19-May,36005016900,2016900,3473,56949,60422,Bronx,1000160.745,Claremont Village-Claremont (East)
21-May,36005016900,2016900,6920,63667,70587,Bronx,1000160.745,Claremont Village-Claremont (East)
19-Jun,36005016900,2016900,9503,56977,66480,Bronx,1000160.745,Claremont Village-Claremont (East)
21-Jun,36005016900,2016900,0,62911,62911,Bronx,1000160.745,Claremont Village-Claremont (East)
19-Jul,36005016900,2016900,5875,103714,109589,Bronx,1000160.745,Claremont Village-Claremont (East)
21-Jul,36005016900,2016900,3380,46370,49750,Bronx,1000160.745,Claremont Village-Claremont (East)
19-Aug,36005016900,2016900,16709,71,16780,Bronx,1000160.745,Claremont Village-Claremont (East)
21-Aug,36005016900,2016900,12215,18057,30272,Bronx,1000160.745,Claremont Village-Claremont (East)
19-May,36081085500,4085500,15877,94062,109939,Queens,1405499.922,Flushing-Willets Point
21-May,36081085500,4085500,10395,118556,128951,Queens,1405499.922,Flushing-Willets Point
19-Jun,36081085500,4085500,5821,71,5892,Queens,1405499.922,Flushing-Willets Point
21-Jun,36081085500,4085500,8488,40127,48615,Queens,1405499.922,Flushing-Willets Point
19-Jul,36081085500,4085500,12355,31043,43398,Queens,1405499.922,Flushing-Willets Point
21-Jul,36081085500,4085500,4965,56471,61436,Queens,1405499.922,Flushing-Willets Point
19-Aug,36081085500,4085500,3318,121735,125053,Queens,1405499.922,Flushing-Willets Point
21-Aug,36081085500,4085500,11716,36418,48134,Queens,1405499.922,Flushing-Willets Point
19-May,36081086300,4086300,12643,64760,77403,Queens,1551084.256,Murray Hill-Broadway Flushing
21-May,36081086300,4086300,7511,76845,84356,Queens,1551084.256,Murray Hill-Broadway Flushing
19-Jun,36081086300,4086300,14265,104353,118618,Queens,1551084.256,Murray Hill-Broadway Flushing
21-Jun,36081086300,4086300,695,107393,108088,Queens,1551084.256,Murray Hill-Broadway Flushing
19-Jul,36081086300,4086300,11465,134746,146211,Queens,1551084.256,Murray Hill-Broadway Flushing
21-Jul,36081086300,4086300,9359,79416,88775,Queens,1551084.256,Murray Hill-Broadway Flushing
19-Aug,36081086300,4086300,4481,71,4552,Queens,1551084.256,Murray Hill-Broadway Flushing
21-Aug,36081086300,4086300,9114,45770,54884,Queens,1551084.256,Murray Hill-Broadway Flushing
19-May,36005014702,2014702,5626,40164,45790,Bronx,1247172.468,Claremont Village-Claremont (East)
21-May,36005014702,2014702,0,74594,74594,Bronx,1247172.468,Claremont Village-Claremont (East)
19-Jun,36005014702,2014702,7673,112547,120220,Bronx,1247172.468,Claremont Village-Claremont (East)
21-Jun,36005014702,2014702,7780,8078,15858,Bronx,1247172.468,Claremont Village-Claremont (East)
19-Jul,36005014702,2014702,1723,91857,93580,Bronx,1247172.468,Claremont Village-Claremont (East)
21-Jul,36005014702,2014702,0,41479,41479,Bronx,1247172.468,Claremont Village-Claremont (East)
19-Aug,36005014702,2014702,7683,77337,85020,Bronx,1247172.468,Claremont Village-Claremont (East)
21-Aug,36005014702,2014702,9265,125772,135037,Bronx,1247172.468,Claremont Village-Claremont (East)
19-May,36081028803,4028803,0,27965,27965,Queens,4065542.14,Baisley Park
21-May,36081028803,4028803,3317,69171,72488,Queens,4065542.14,Baisley Park
19-Jun,36081028803,4028803,5603,46834,52437,Queens,4065542.14,Baisley Park
21-Jun,36081028803,4028803,20105,65319,85424,Queens,4065542.14,Baisley Park
19-Jul,36081028803,4028803,3609,64795,68404,Queens,4065542.14,Baisley Park
21-Jul,36081028803,4028803,668,75910,76578,Queens,4065542.14,Baisley Park
19-Aug,36081028803,4028803,16007,54792,70799,Queens,4065542.14,Baisley Park
21-Aug,36081028803,4028803,13645,2484,16129,Queens,4065542.14,Baisley Park
19-May,36081029400,4029400,13414,103522,116936,Queens,11458904.11,Springfield Gardens (North)-Rochdale Village
21-May,36081029400,4029400,12054,74465,86519,Queens,11458904.11,Springfield Gardens (North)-Rochdale Village
19-Jun,36081029400,4029400,9976,19828,29804,Queens,11458904.11,Springfield Gardens (North)-Rochdale Village
21-Jun,36081029400,4029400,6939,78954,85893,Queens,11458904.11,Springfield Gardens (North)-Rochdale Village
19-Jul,36081029400,4029400,7308,42278,49586,Queens,11458904.11,Springfield Gardens (North)-Rochdale Village
21-Jul,36081029400,4029400,11681,41906,53587,Queens,11458904.11,Springfield Gardens (North)-Rochdale Village
19-Aug,36081029400,4029400,11845,64097,75942,Queens,11458904.11,Springfield Gardens (North)-Rochdale Village
21-Aug,36081029400,4029400,5232,48447,53679,Queens,11458904.11,Springfield Gardens (North)-Rochdale Village
19-May,36005014300,2014300,5177,71,5248,Bronx,1395894.552,Concourse-Concourse Village
21-May,36005014300,2014300,5139,49617,54756,Bronx,1395894.552,Concourse-Concourse Village
19-Jun,36005014300,2014300,8245,64265,72510,Bronx,1395894.552,Concourse-Concourse Village
21-Jun,36005014300,2014300,11915,52802,64717,Bronx,1395894.552,Concourse-Concourse Village
19-Jul,36005014300,2014300,20115,25599,45714,Bronx,1395894.552,Concourse-Concourse Village
21-Jul,36005014300,2014300,6077,99215,105292,Bronx,1395894.552,Concourse-Concourse Village
19-Aug,36005014300,2014300,12372,73358,85730,Bronx,1395894.552,Concourse-Concourse Village
21-Aug,36005014300,2014300,10035,62514,72549,Bronx,1395894.552,Concourse-Concourse Village
19-May,36081004401,4004401,16845,45207,62052,Queens,2833237.774,Ozone Park
21-May,36081004401,4004401,12125,107085,119210,Queens,2833237.774,Ozone Park
19-Jun,36081004401,4004401,15594,100762,116356,Queens,2833237.774,Ozone Park
21-Jun,36081004401,4004401,3263,11055,14318,Queens,2833237.774,Ozone Park
19-Jul,36081004401,4004401,8758,121365,130123,Queens,2833237.774,Ozone Park
21-Jul,36081004401,4004401,12298,27381,39679,Queens,2833237.774,Ozone Park
19-Aug,36081004401,4004401,2658,127351,130009,Queens,2833237.774,Ozone Park
21-Aug,36081004401,4004401,5947,29776,35723,Queens,2833237.774,Ozone Park
19-May,36081005800,4005800,8903,71,8974,Queens,6343697.751,Ozone Park
21-May,36081005800,4005800,10752,101737,112489,Queens,6343697.751,Ozone Park
19-Jun,36081005800,4005800,15914,67035,82949,Queens,6343697.751,Ozone Park
21-Jun,36081005800,4005800,4465,8498,12963,Queens,6343697.751,Ozone Park
19-Jul,36081005800,4005800,17002,29507,46509,Queens,6343697.751,Ozone Park
21-Jul,36081005800,4005800,15146,57723,72869,Queens,6343697.751,Ozone Park
19-Aug,36081005800,4005800,16351,116156,132507,Queens,6343697.751,Ozone Park
21-Aug,36081005800,4005800,16437,130591,147028,Queens,6343697.751,Ozone Park
19-May,36061020101,1020101,2248,62297,64545,Manhattan,593177.2283,Morningside Heights
21-May,36061020101,1020101,15886,77130,93016,Manhattan,593177.2283,Morningside Heights
19-Jun,36061020101,1020101,7662,101090,108752,Manhattan,593177.2283,Morningside Heights
21-Jun,36061020101,1020101,9565,21038,30603,Manhattan,593177.2283,Morningside Heights
19-Jul,36061020101,1020101,8790,39973,48763,Manhattan,593177.2283,Morningside Heights
21-Jul,36061020101,1020101,12833,97065,109898,Manhattan,593177.2283,Morningside Heights
19-Aug,36061020101,1020101,7089,21784,28873,Manhattan,593177.2283,Morningside Heights
21-Aug,36061020101,1020101,12536,128073,140609,Manhattan,593177.2283,Morningside Heights
19-May,36061020300,1020300,0,16608,16608,Manhattan,1916856.726,Morningside Heights
21-May,36061020300,1020300,15609,5331,20940,Manhattan,1916856.726,Morningside Heights
19-Jun,36061020300,1020300,10932,62588,73520,Manhattan,1916856.726,Morningside Heights
21-Jun,36061020300,1020300,3650,42912,46562,Manhattan,1916856.726,Morningside Heights
19-Jul,36061020300,1020300,11122,115551,126673,Manhattan,1916856.726,Morningside Heights
21-Jul,36061020300,1020300,2351,43747,46098,Manhattan,1916856.726,Morningside Heights
19-Aug,36061020300,1020300,1413,52094,53507,Manhattan,1916856.726,Morningside Heights
21-Aug,36061020300,1020300,0,98837,98837,Manhattan,1916856.726,Morningside Heights
19-May,36081116302,4116302,6130,52513,58643,Queens,1271235.726,Murray Hill-Broadway Flushing
21-May,36081116302,4116302,9776,5761,15537,Queens,1271235.726,Murray Hill-Broadway Flushing
19-Jun,36081116302,4116302,14769,33189,47958,Queens,1271235.726,Murray Hill-Broadway Flushing
21-Jun,36081116302,4116302,8647,93750,102397,Queens,1271235.726,Murray Hill-Broadway Flushing
19-Jul,36081116302,4116302,6460,53069,59529,Queens,1271235.726,Murray Hill-Broadway Flushing
21-Jul,36081116302,4116302,7606,29209,36815,Queens,1271235.726,Murray Hill-Broadway Flushing
19-Aug,36081116302,4116302,17658,11525,29183,Queens,1271235.726,Murray Hill-Broadway Flushing
21-Aug,36081116302,4116302,10207,34477,44684,Queens,1271235.726,Murray Hill-Broadway Flushing
19-May,36081116700,4116700,13122,112494,125616,Queens,1787963.292,Murray Hill-Broadway Flushing
21-May,36081116700,4116700,11527,52081,63608,Queens,1787963.292,Murray Hill-Broadway Flushing
19-Jun,36081116700,4116700,7583,132312,139895,Queens,1787963.292,Murray Hill-Broadway Flushing
21-Jun,36081116700,4116700,12032,47238,59270,Queens,1787963.292,Murray Hill-Broadway Flushing
19-Jul,36081116700,4116700,4315,95188,99503,Queens,1787963.292,Murray Hill-Broadway Flushing
21-Jul,36081116700,4116700,3483,46816,50299,Queens,1787963.292,Murray Hill-Broadway Flushing
19-Aug,36081116700,4116700,13611,89338,102949,Queens,1787963.292,Murray Hill-Broadway Flushing
21-Aug,36081116700,4116700,10570,62427,72997,Queens,1787963.292,Murray Hill-Broadway Flushing
19-May,36081090700,4090700,2058,58969,61027,Queens,21709172.24,College Point
21-May,36081090700,4090700,0,52429,52429,Queens,21709172.24,College Point
19-Jun,36081090700,4090700,12325,49901,62226,Queens,21709172.24,College Point
21-Jun,36081090700,4090700,0,27165,27165,Queens,21709172.24,College Point
19-Jul,36081090700,4090700,12473,75855,88328,Queens,21709172.24,College Point
21-Jul,36081090700,4090700,5585,14671,20256,Queens,21709172.24,College Point
19-Aug,36081090700,4090700,12528,84997,97525,Queens,21709172.24,College Point
21-Aug,36081090700,4090700,12651,32869,45520,Queens,21709172.24,College Point
19-May,36081091900,4091900,7839,112027,119866,Queens,4908594.601,College Point
21-May,36081091900,4091900,0,106537,106537,Queens,4908594.601,College Point
19-Jun,36081091900,4091900,16634,56389,73023,Queens,4908594.601,College Point
21-Jun,36081091900,4091900,10062,79402,89464,Queens,4908594.601,College Point
19-Jul,36081091900,4091900,3425,62166,65591,Queens,4908594.601,College Point
21-Jul,36081091900,4091900,11052,55098,66150,Queens,4908594.601,College Point
19-Aug,36081091900,4091900,9683,35470,45153,Queens,4908594.601,College Point
21-Aug,36081091900,4091900,6783,68234,75017,Queens,4908594.601,College Point
19-May,36081000103,4000103,7014,143401,150415,Queens,1987162.206,Long Island City-Hunters Point
21-May,36081000103,4000103,2917,53391,56308,Queens,1987162.206,Long Island City-Hunters Point
19-Jun,36081000103,4000103,3673,64264,67937,Queens,1987162.206,Long Island City-Hunters Point
21-Jun,36081000103,4000103,12975,132284,145259,Queens,1987162.206,Long Island City-Hunters Point
19-Jul,36081000103,4000103,12015,56833,68848,Queens,1987162.206,Long Island City-Hunters Point
21-Jul,36081000103,4000103,2802,29495,32297,Queens,1987162.206,Long Island City-Hunters Point
19-Aug,36081000103,4000103,3087,78344,81431,Queens,1987162.206,Long Island City-Hunters Point
21-Aug,36081000103,4000103,15895,53341,69236,Queens,1987162.206,Long Island City-Hunters Point
19-May,36061018500,1018500,9365,19825,29190,Manhattan,1406208.061,Upper West Side-Manhattan Valley
21-May,36061018500,1018500,13563,71,13634,Manhattan,1406208.061,Upper West Side-Manhattan Valley
19-Jun,36061018500,1018500,10557,43941,54498,Manhattan,1406208.061,Upper West Side-Manhattan Valley
21-Jun,36061018500,1018500,19694,28282,47976,Manhattan,1406208.061,Upper West Side-Manhattan Valley
19-Jul,36061018500,1018500,11732,74244,85976,Manhattan,1406208.061,Upper West Side-Manhattan Valley
21-Jul,36061018500,1018500,12981,140350,153331,Manhattan,1406208.061,Upper West Side-Manhattan Valley
19-Aug,36061018500,1018500,9144,117650,126794,Manhattan,1406208.061,Upper West Side-Manhattan Valley
21-Aug,36061018500,1018500,8494,56099,64593,Manhattan,1406208.061,Upper West Side-Manhattan Valley
19-May,36081022900,4022900,5487,99771,105258,Queens,14291820.02,Calvary & Mount Zion Cemeteries
21-May,36081022900,4022900,13432,85618,99050,Queens,14291820.02,Calvary & Mount Zion Cemeteries
19-Jun,36081022900,4022900,0,164662,164662,Queens,14291820.02,Calvary & Mount Zion Cemeteries
21-Jun,36081022900,4022900,14858,69244,84102,Queens,14291820.02,Calvary & Mount Zion Cemeteries
19-Jul,36081022900,4022900,5546,52509,58055,Queens,14291820.02,Calvary & Mount Zion Cemeteries
21-Jul,36081022900,4022900,5960,81766,87726,Queens,14291820.02,Calvary & Mount Zion Cemeteries
19-Aug,36081022900,4022900,16662,105950,122612,Queens,14291820.02,Calvary & Mount Zion Cemeteries
21-Aug,36081022900,4022900,8543,159581,168124,Queens,14291820.02,Calvary & Mount Zion Cemeteries
19-May,36081051500,4051500,10547,44764,55311,Queens,2419769.123,Maspeth
21-May,36081051500,4051500,3519,75256,78775,Queens,2419769.123,Maspeth
19-Jun,36081051500,4051500,8208,128744,136952,Queens,2419769.123,Maspeth
21-Jun,36081051500,4051500,10091,99473,109564,Queens,2419769.123,Maspeth
19-Jul,36081051500,4051500,10333,91364,101697,Queens,2419769.123,Maspeth
21-Jul,36081051500,4051500,5771,66618,72389,Queens,2419769.123,Maspeth
19-Aug,36081051500,4051500,7453,130035,137488,Queens,2419769.123,Maspeth
21-Aug,36081051500,4051500,9723,104561,114284,Queens,2419769.123,Maspeth
19-May,36081000102,4000102,9021,113753,122774,Queens,1202283.443,Long Island City-Hunters Point
21-May,36081000102,4000102,16566,61591,78157,Queens,1202283.443,Long Island City-Hunters Point
19-Jun,36081000102,4000102,8660,49938,58598,Queens,1202283.443,Long Island City-Hunters Point
21-Jun,36081000102,4000102,13007,60077,73084,Queens,1202283.443,Long Island City-Hunters Point
19-Jul,36081000102,4000102,9081,66427,75508,Queens,1202283.443,Long Island City-Hunters Point
21-Jul,36081000102,4000102,2796,81976,84772,Queens,1202283.443,Long Island City-Hunters Point
19-Aug,36081000102,4000102,5360,69812,75172,Queens,1202283.443,Long Island City-Hunters Point
21-Aug,36081000102,4000102,13051,108846,121897,Queens,1202283.443,Long Island City-Hunters Point
19-May,36061018900,1018900,12266,128166,140432,Manhattan,2853971.298,Upper West Side-Manhattan Valley
21-May,36061018900,1018900,8318,131926,140244,Manhattan,2853971.298,Upper West Side-Manhattan Valley
19-Jun,36061018900,1018900,14175,86935,101110,Manhattan,2853971.298,Upper West Side-Manhattan Valley
21-Jun,36061018900,1018900,6935,127179,134114,Manhattan,2853971.298,Upper West Side-Manhattan Valley
19-Jul,36061018900,1018900,9250,71658,80908,Manhattan,2853971.298,Upper West Side-Manhattan Valley
21-Jul,36061018900,1018900,8807,25674,34481,Manhattan,2853971.298,Upper West Side-Manhattan Valley
19-Aug,36061018900,1018900,10233,60252,70485,Manhattan,2853971.298,Upper West Side-Manhattan Valley
21-Aug,36061018900,1018900,5421,116426,121847,Manhattan,2853971.298,Upper West Side-Manhattan Valley
19-May,36061013700,1013700,9632,51134,60766,Manhattan,2434387.924,Midtown-Times Square
21-May,36061013700,1013700,801,106944,107745,Manhattan,2434387.924,Midtown-Times Square
19-Jun,36061013700,1013700,0,16308,16308,Manhattan,2434387.924,Midtown-Times Square
21-Jun,36061013700,1013700,5641,61843,67484,Manhattan,2434387.924,Midtown-Times Square
19-Jul,36061013700,1013700,18420,4182,22602,Manhattan,2434387.924,Midtown-Times Square
21-Jul,36061013700,1013700,19918,21739,41657,Manhattan,2434387.924,Midtown-Times Square
19-Aug,36061013700,1013700,16267,10352,26619,Manhattan,2434387.924,Midtown-Times Square
21-Aug,36061013700,1013700,8254,107239,115493,Manhattan,2434387.924,Midtown-Times Square
19-May,36061013900,1013900,8719,142473,151192,Manhattan,1954943.59,Hell's Kitchen
21-May,36061013900,1013900,9673,5260,14933,Manhattan,1954943.59,Hell's Kitchen
19-Jun,36061013900,1013900,15157,127285,142442,Manhattan,1954943.59,Hell's Kitchen
21-Jun,36061013900,1013900,1611,36674,38285,Manhattan,1954943.59,Hell's Kitchen
19-Jul,36061013900,1013900,9941,99938,109879,Manhattan,1954943.59,Hell's Kitchen
21-Jul,36061013900,1013900,0,145898,145898,Manhattan,1954943.59,Hell's Kitchen
19-Aug,36061013900,1013900,8025,120674,128699,Manhattan,1954943.59,Hell's Kitchen
21-Aug,36061013900,1013900,7458,84547,92005,Manhattan,1954943.59,Hell's Kitchen
19-May,36061014500,1014500,10318,153895,164213,Manhattan,1899180.817,Upper West Side-Lincoln Square
21-May,36061014500,1014500,13449,79496,92945,Manhattan,1899180.817,Upper West Side-Lincoln Square
19-Jun,36061014500,1014500,3640,71,3711,Manhattan,1899180.817,Upper West Side-Lincoln Square
21-Jun,36061014500,1014500,20607,58898,79505,Manhattan,1899180.817,Upper West Side-Lincoln Square
19-Jul,36061014500,1014500,6635,71897,78532,Manhattan,1899180.817,Upper West Side-Lincoln Square
21-Jul,36061014500,1014500,1169,63286,64455,Manhattan,1899180.817,Upper West Side-Lincoln Square
19-Aug,36061014500,1014500,7190,77447,84637,Manhattan,1899180.817,Upper West Side-Lincoln Square
21-Aug,36061014500,1014500,13329,71,13400,Manhattan,1899180.817,Upper West Side-Lincoln Square
19-May,36061027700,1027700,7632,30313,37945,Manhattan,1762997.197,Washington Heights (North)
21-May,36061027700,1027700,10989,152020,163009,Manhattan,1762997.197,Washington Heights (North)
19-Jun,36061027700,1027700,7406,101300,108706,Manhattan,1762997.197,Washington Heights (North)
21-Jun,36061027700,1027700,8783,108328,117111,Manhattan,1762997.197,Washington Heights (North)
19-Jul,36061027700,1027700,17415,100027,117442,Manhattan,1762997.197,Washington Heights (North)
21-Jul,36061027700,1027700,9689,37707,47396,Manhattan,1762997.197,Washington Heights (North)
19-Aug,36061027700,1027700,7569,93545,101114,Manhattan,1762997.197,Washington Heights (North)
21-Aug,36061027700,1027700,9897,100508,110405,Manhattan,1762997.197,Washington Heights (North)
19-May,36081010600,4010600,6777,67323,74100,Queens,1862498.908,South Ozone Park
21-May,36081010600,4010600,6310,72973,79283,Queens,1862498.908,South Ozone Park
19-Jun,36081010600,4010600,0,51705,51705,Queens,1862498.908,South Ozone Park
21-Jun,36081010600,4010600,2120,58695,60815,Queens,1862498.908,South Ozone Park
19-Jul,36081010600,4010600,6720,65172,71892,Queens,1862498.908,South Ozone Park
21-Jul,36081010600,4010600,9028,19707,28735,Queens,1862498.908,South Ozone Park
19-Aug,36081010600,4010600,4909,12520,17429,Queens,1862498.908,South Ozone Park
21-Aug,36081010600,4010600,8247,63170,71417,Queens,1862498.908,South Ozone Park
19-May,36081016600,4016600,13282,33887,47169,Queens,2185345.716,South Ozone Park
21-May,36081016600,4016600,13299,64046,77345,Queens,2185345.716,South Ozone Park
19-Jun,36081016600,4016600,8899,83329,92228,Queens,2185345.716,South Ozone Park
21-Jun,36081016600,4016600,14215,37237,51452,Queens,2185345.716,South Ozone Park
19-Jul,36081016600,4016600,8675,25436,34111,Queens,2185345.716,South Ozone Park
21-Jul,36081016600,4016600,2461,92854,95315,Queens,2185345.716,South Ozone Park
19-Aug,36081016600,4016600,12498,109348,121846,Queens,2185345.716,South Ozone Park
21-Aug,36081016600,4016600,1632,47172,48804,Queens,2185345.716,South Ozone Park
19-May,36061001002,1001002,99,85379,85478,Manhattan,2195050.142,Lower East Side
21-May,36061001002,1001002,17985,32144,50129,Manhattan,2195050.142,Lower East Side
19-Jun,36061001002,1001002,953,32874,33827,Manhattan,2195050.142,Lower East Side
21-Jun,36061001002,1001002,4292,131391,135683,Manhattan,2195050.142,Lower East Side
19-Jul,36061001002,1001002,15297,83463,98760,Manhattan,2195050.142,Lower East Side
21-Jul,36061001002,1001002,10152,27306,37458,Manhattan,2195050.142,Lower East Side
19-Aug,36061001002,1001002,6963,57787,64750,Manhattan,2195050.142,Lower East Side
21-Aug,36061001002,1001002,7833,60945,68778,Manhattan,2195050.142,Lower East Side
19-May,36005003300,2003300,8810,71081,79891,Bronx,1639977.473,Mott Haven-Port Morris
21-May,36005003300,2003300,10484,84392,94876,Bronx,1639977.473,Mott Haven-Port Morris
19-Jun,36005003300,2003300,19055,110768,129823,Bronx,1639977.473,Mott Haven-Port Morris
21-Jun,36005003300,2003300,17883,98370,116253,Bronx,1639977.473,Mott Haven-Port Morris
19-Jul,36005003300,2003300,9681,36414,46095,Bronx,1639977.473,Mott Haven-Port Morris
21-Jul,36005003300,2003300,0,71,71,Bronx,1639977.473,Mott Haven-Port Morris
19-Aug,36005003300,2003300,7099,31041,38140,Bronx,1639977.473,Mott Haven-Port Morris
21-Aug,36005003300,2003300,2614,107366,109980,Bronx,1639977.473,Mott Haven-Port Morris
19-May,36081056000,4056000,16384,5186,21570,Queens,2300763.071,Queens Village
21-May,36081056000,4056000,7982,76925,84907,Queens,2300763.071,Queens Village
19-Jun,36081056000,4056000,5713,107594,113307,Queens,2300763.071,Queens Village
21-Jun,36081056000,4056000,4846,71,4917,Queens,2300763.071,Queens Village
19-Jul,36081056000,4056000,6290,82921,89211,Queens,2300763.071,Queens Village
21-Jul,36081056000,4056000,13398,98080,111478,Queens,2300763.071,Queens Village
19-Aug,36081056000,4056000,10414,43548,53962,Queens,2300763.071,Queens Village
21-Aug,36081056000,4056000,11592,75835,87427,Queens,2300763.071,Queens Village
19-May,36081045800,4045800,0,92864,92864,Queens,2640087.988,Jamaica Estates-Holliswood
21-May,36081045800,4045800,11485,62376,73861,Queens,2640087.988,Jamaica Estates-Holliswood
19-Jun,36081045800,4045800,11367,142014,153381,Queens,2640087.988,Jamaica Estates-Holliswood
21-Jun,36081045800,4045800,11321,132335,143656,Queens,2640087.988,Jamaica Estates-Holliswood
19-Jul,36081045800,4045800,9012,96860,105872,Queens,2640087.988,Jamaica Estates-Holliswood
21-Jul,36081045800,4045800,1610,51126,52736,Queens,2640087.988,Jamaica Estates-Holliswood
19-Aug,36081045800,4045800,3710,34467,38177,Queens,2640087.988,Jamaica Estates-Holliswood
21-Aug,36081045800,4045800,4523,75078,79601,Queens,2640087.988,Jamaica Estates-Holliswood
19-May,36081046200,4046200,7423,8348,15771,Queens,2685779.779,Jamaica
21-May,36081046200,4046200,18625,81436,100061,Queens,2685779.779,Jamaica
19-Jun,36081046200,4046200,9550,1141,10691,Queens,2685779.779,Jamaica
21-Jun,36081046200,4046200,2173,44969,47142,Queens,2685779.779,Jamaica
19-Jul,36081046200,4046200,2694,63860,66554,Queens,2685779.779,Jamaica
21-Jul,36081046200,4046200,10065,10485,20550,Queens,2685779.779,Jamaica
19-Aug,36081046200,4046200,11932,71,12003,Queens,2685779.779,Jamaica
21-Aug,36081046200,4046200,3786,39747,43533,Queens,2685779.779,Jamaica
19-May,36081046600,4046600,5766,141514,147280,Queens,2591346.529,Jamaica Estates-Holliswood
21-May,36081046600,4046600,8516,111966,120482,Queens,2591346.529,Jamaica Estates-Holliswood
19-Jun,36081046600,4046600,0,71,71,Queens,2591346.529,Jamaica Estates-Holliswood
21-Jun,36081046600,4046600,15827,62867,78694,Queens,2591346.529,Jamaica Estates-Holliswood
19-Jul,36081046600,4046600,5524,86168,91692,Queens,2591346.529,Jamaica Estates-Holliswood
21-Jul,36081046600,4046600,13312,56661,69973,Queens,2591346.529,Jamaica Estates-Holliswood
19-Aug,36081046600,4046600,3858,77873,81731,Queens,2591346.529,Jamaica Estates-Holliswood
21-Aug,36081046600,4046600,11002,74983,85985,Queens,2591346.529,Jamaica Estates-Holliswood
19-May,36061022700,1022700,9659,87920,97579,Manhattan,1621656.333,Hamilton Heights-Sugar Hill
21-May,36061022700,1022700,2077,29301,31378,Manhattan,1621656.333,Hamilton Heights-Sugar Hill
19-Jun,36061022700,1022700,12964,107547,120511,Manhattan,1621656.333,Hamilton Heights-Sugar Hill
21-Jun,36061022700,1022700,8781,53982,62763,Manhattan,1621656.333,Hamilton Heights-Sugar Hill
19-Jul,36061022700,1022700,5202,74249,79451,Manhattan,1621656.333,Hamilton Heights-Sugar Hill
21-Jul,36061022700,1022700,14616,88894,103510,Manhattan,1621656.333,Hamilton Heights-Sugar Hill
19-Aug,36061022700,1022700,14469,6166,20635,Manhattan,1621656.333,Hamilton Heights-Sugar Hill
21-Aug,36061022700,1022700,8211,35980,44191,Manhattan,1621656.333,Hamilton Heights-Sugar Hill
19-May,36061025900,1025900,15109,40942,56051,Manhattan,812095.0227,Harlem (North)
21-May,36061025900,1025900,6117,58391,64508,Manhattan,812095.0227,Harlem (North)
19-Jun,36061025900,1025900,24111,105489,129600,Manhattan,812095.0227,Harlem (North)
21-Jun,36061025900,1025900,6130,64245,70375,Manhattan,812095.0227,Harlem (North)
19-Jul,36061025900,1025900,1662,79973,81635,Manhattan,812095.0227,Harlem (North)
21-Jul,36061025900,1025900,12571,78992,91563,Manhattan,812095.0227,Harlem (North)
19-Aug,36061025900,1025900,8720,39378,48098,Manhattan,812095.0227,Harlem (North)
21-Aug,36061025900,1025900,173,57366,57539,Manhattan,812095.0227,Harlem (North)
19-May,36061006000,1006000,12337,80999,93336,Manhattan,1297728.465,Stuyvesant Town-Peter Cooper Village
21-May,36061006000,1006000,4454,24406,28860,Manhattan,1297728.465,Stuyvesant Town-Peter Cooper Village
19-Jun,36061006000,1006000,13323,101899,115222,Manhattan,1297728.465,Stuyvesant Town-Peter Cooper Village
21-Jun,36061006000,1006000,7918,82646,90564,Manhattan,1297728.465,Stuyvesant Town-Peter Cooper Village
19-Jul,36061006000,1006000,12426,138569,150995,Manhattan,1297728.465,Stuyvesant Town-Peter Cooper Village
21-Jul,36061006000,1006000,10263,47460,57723,Manhattan,1297728.465,Stuyvesant Town-Peter Cooper Village
19-Aug,36061006000,1006000,7081,72608,79689,Manhattan,1297728.465,Stuyvesant Town-Peter Cooper Village
21-Aug,36061006000,1006000,12493,61554,74047,Manhattan,1297728.465,Stuyvesant Town-Peter Cooper Village
19-May,36005001901,2001901,2392,138382,140774,Bronx,2232573.692,Mott Haven-Port Morris
21-May,36005001901,2001901,7063,74697,81760,Bronx,2232573.692,Mott Haven-Port Morris
19-Jun,36005001901,2001901,14996,43450,58446,Bronx,2232573.692,Mott Haven-Port Morris
21-Jun,36005001901,2001901,7303,68697,76000,Bronx,2232573.692,Mott Haven-Port Morris
19-Jul,36005001901,2001901,13079,73099,86178,Bronx,2232573.692,Mott Haven-Port Morris
21-Jul,36005001901,2001901,17224,86320,103544,Bronx,2232573.692,Mott Haven-Port Morris
19-Aug,36005001901,2001901,12836,29506,42342,Bronx,2232573.692,Mott Haven-Port Morris
21-Aug,36005001901,2001901,5261,73886,79147,Bronx,2232573.692,Mott Haven-Port Morris
19-May,36081015500,4015500,248,48077,48325,Queens,1587955.095,Astoria (East)-Woodside (North)
21-May,36081015500,4015500,11304,83818,95122,Queens,1587955.095,Astoria (East)-Woodside (North)
19-Jun,36081015500,4015500,10006,106702,116708,Queens,1587955.095,Astoria (East)-Woodside (North)
21-Jun,36081015500,4015500,7902,80550,88452,Queens,1587955.095,Astoria (East)-Woodside (North)
19-Jul,36081015500,4015500,10530,52897,63427,Queens,1587955.095,Astoria (East)-Woodside (North)
21-Jul,36081015500,4015500,13959,124041,138000,Queens,1587955.095,Astoria (East)-Woodside (North)
19-Aug,36081015500,4015500,12576,35919,48495,Queens,1587955.095,Astoria (East)-Woodside (North)
21-Aug,36081015500,4015500,4272,55898,60170,Queens,1587955.095,Astoria (East)-Woodside (North)
19-May,36081015900,4015900,18130,79251,97381,Queens,1826098.29,Astoria (East)-Woodside (North)
21-May,36081015900,4015900,2894,40659,43553,Queens,1826098.29,Astoria (East)-Woodside (North)
19-Jun,36081015900,4015900,8061,80406,88467,Queens,1826098.29,Astoria (East)-Woodside (North)
21-Jun,36081015900,4015900,8296,2044,10340,Queens,1826098.29,Astoria (East)-Woodside (North)
19-Jul,36081015900,4015900,9909,74023,83932,Queens,1826098.29,Astoria (East)-Woodside (North)
21-Jul,36081015900,4015900,5752,70679,76431,Queens,1826098.29,Astoria (East)-Woodside (North)
19-Aug,36081015900,4015900,16871,11320,28191,Queens,1826098.29,Astoria (East)-Woodside (North)
21-Aug,36081015900,4015900,4952,47703,52655,Queens,1826098.29,Astoria (East)-Woodside (North)
19-May,36061002000,1002000,13086,72210,85296,Manhattan,1387290.123,East Village
21-May,36061002000,1002000,9722,69000,78722,Manhattan,1387290.123,East Village
19-Jun,36061002000,1002000,3150,71,3221,Manhattan,1387290.123,East Village
21-Jun,36061002000,1002000,22504,65637,88141,Manhattan,1387290.123,East Village
19-Jul,36061002000,1002000,11975,81672,93647,Manhattan,1387290.123,East Village
21-Jul,36061002000,1002000,931,91798,92729,Manhattan,1387290.123,East Village
19-Aug,36061002000,1002000,9370,23128,32498,Manhattan,1387290.123,East Village
21-Aug,36061002000,1002000,11320,70167,81487,Manhattan,1387290.123,East Village
19-May,36081000101,4000101,11550,169194,180744,Queens,3170956.939,Long Island City-Hunters Point
21-May,36081000101,4000101,11891,68722,80613,Queens,3170956.939,Long Island City-Hunters Point
19-Jun,36081000101,4000101,5662,26204,31866,Queens,3170956.939,Long Island City-Hunters Point
21-Jun,36081000101,4000101,3816,108184,112000,Queens,3170956.939,Long Island City-Hunters Point
19-Jul,36081000101,4000101,9718,85310,95028,Queens,3170956.939,Long Island City-Hunters Point
21-Jul,36081000101,4000101,11123,5233,16356,Queens,3170956.939,Long Island City-Hunters Point
19-Aug,36081000101,4000101,7540,117852,125392,Queens,3170956.939,Long Island City-Hunters Point
21-Aug,36081000101,4000101,999,89637,90636,Queens,3170956.939,Long Island City-Hunters Point
19-May,36081107201,4107201,12588,61615,74203,Queens,15199225.21,Breezy Point-Belle Harbor-Rockaway Park-Broad Channel
21-May,36081107201,4107201,4156,153582,157738,Queens,15199225.21,Breezy Point-Belle Harbor-Rockaway Park-Broad Channel
19-Jun,36081107201,4107201,4043,92868,96911,Queens,15199225.21,Breezy Point-Belle Harbor-Rockaway Park-Broad Channel
21-Jun,36081107201,4107201,12810,64227,77037,Queens,15199225.21,Breezy Point-Belle Harbor-Rockaway Park-Broad Channel
19-Jul,36081107201,4107201,16654,81869,98523,Queens,15199225.21,Breezy Point-Belle Harbor-Rockaway Park-Broad Channel
21-Jul,36081107201,4107201,3468,147454,150922,Queens,15199225.21,Breezy Point-Belle Harbor-Rockaway Park-Broad Channel
19-Aug,36081107201,4107201,21367,105834,127201,Queens,15199225.21,Breezy Point-Belle Harbor-Rockaway Park-Broad Channel
21-Aug,36081107201,4107201,5164,28100,33264,Queens,15199225.21,Breezy Point-Belle Harbor-Rockaway Park-Broad Channel
19-May,36081107202,4107202,10630,88967,99597,Queens,69920670.56,Jamaica Bay (East)
21-May,36081107202,4107202,8177,49090,57267,Queens,69920670.56,Jamaica Bay (East)
19-Jun,36081107202,4107202,9625,42147,51772,Queens,69920670.56,Jamaica Bay (East)
21-Jun,36081107202,4107202,10736,50252,60988,Queens,69920670.56,Jamaica Bay (East)
19-Jul,36081107202,4107202,7415,48734,56149,Queens,69920670.56,Jamaica Bay (East)
21-Jul,36081107202,4107202,12996,158734,171730,Queens,69920670.56,Jamaica Bay (East)
19-Aug,36081107202,4107202,3920,62597,66517,Queens,69920670.56,Jamaica Bay (East)
21-Aug,36081107202,4107202,11222,106488,117710,Queens,69920670.56,Jamaica Bay (East)
19-May,36005020100,2020100,9174,54866,64040,Bronx,2986855.13,Highbridge
21-May,36005020100,2020100,11204,50081,61285,Bronx,2986855.13,Highbridge
19-Jun,36005020100,2020100,11406,115658,127064,Bronx,2986855.13,Highbridge
21-Jun,36005020100,2020100,7419,10592,18011,Bronx,2986855.13,Highbridge
19-Jul,36005020100,2020100,17382,118420,135802,Bronx,2986855.13,Highbridge
21-Jul,36005020100,2020100,7949,31204,39153,Bronx,2986855.13,Highbridge
19-Aug,36005020100,2020100,17884,18513,36397,Bronx,2986855.13,Highbridge
21-Aug,36005020100,2020100,4492,94972,99464,Bronx,2986855.13,Highbridge
19-May,36061009901,1009901,6429,46138,52567,Manhattan,4211423.919,Chelsea-Hudson Yards
21-May,36061009901,1009901,5993,113188,119181,Manhattan,4211423.919,Chelsea-Hudson Yards
19-Jun,36061009901,1009901,6534,10866,17400,Manhattan,4211423.919,Chelsea-Hudson Yards
21-Jun,36061009901,1009901,6357,69487,75844,Manhattan,4211423.919,Chelsea-Hudson Yards
19-Jul,36061009901,1009901,7313,130591,137904,Manhattan,4211423.919,Chelsea-Hudson Yards
21-Jul,36061009901,1009901,8330,71,8401,Manhattan,4211423.919,Chelsea-Hudson Yards
19-Aug,36061009901,1009901,11681,13577,25258,Manhattan,4211423.919,Chelsea-Hudson Yards
21-Aug,36061009901,1009901,1700,66395,68095,Manhattan,4211423.919,Chelsea-Hudson Yards
19-May,36061014601,1014601,5683,28580,34263,Manhattan,799778.075,Upper East Side-Yorkville
21-May,36061014601,1014601,5409,132115,137524,Manhattan,799778.075,Upper East Side-Yorkville
19-Jun,36061014601,1014601,10848,93075,103923,Manhattan,799778.075,Upper East Side-Yorkville
21-Jun,36061014601,1014601,7799,24032,31831,Manhattan,799778.075,Upper East Side-Yorkville
19-Jul,36061014601,1014601,12026,99351,111377,Manhattan,799778.075,Upper East Side-Yorkville
21-Jul,36061014601,1014601,19132,85011,104143,Manhattan,799778.075,Upper East Side-Yorkville
19-Aug,36061014601,1014601,13342,136675,150017,Manhattan,799778.075,Upper East Side-Yorkville
21-Aug,36061014601,1014601,8210,71,8281,Manhattan,799778.075,Upper East Side-Yorkville
19-May,36061014602,1014602,5295,100412,105707,Manhattan,1175299.121,Upper East Side-Yorkville
21-May,36061014602,1014602,11087,104309,115396,Manhattan,1175299.121,Upper East Side-Yorkville
19-Jun,36061014602,1014602,16196,104841,121037,Manhattan,1175299.121,Upper East Side-Yorkville
21-Jun,36061014602,1014602,10212,45712,55924,Manhattan,1175299.121,Upper East Side-Yorkville
19-Jul,36061014602,1014602,5411,74780,80191,Manhattan,1175299.121,Upper East Side-Yorkville
21-Jul,36061014602,1014602,2580,28092,30672,Manhattan,1175299.121,Upper East Side-Yorkville
19-Aug,36061014602,1014602,4202,69841,74043,Manhattan,1175299.121,Upper East Side-Yorkville
21-Aug,36061014602,1014602,11845,43698,55543,Manhattan,1175299.121,Upper East Side-Yorkville
19-May,36061014802,1014802,19020,64657,83677,Manhattan,1351072.749,Upper East Side-Carnegie Hill
21-May,36061014802,1014802,15820,90450,106270,Manhattan,1351072.749,Upper East Side-Carnegie Hill
19-Jun,36061014802,1014802,7295,101659,108954,Manhattan,1351072.749,Upper East Side-Carnegie Hill
21-Jun,36061014802,1014802,2817,40377,43194,Manhattan,1351072.749,Upper East Side-Carnegie Hill
19-Jul,36061014802,1014802,5207,141390,146597,Manhattan,1351072.749,Upper East Side-Carnegie Hill
21-Jul,36061014802,1014802,10266,48557,58823,Manhattan,1351072.749,Upper East Side-Carnegie Hill
19-Aug,36061014802,1014802,1623,13791,15414,Manhattan,1351072.749,Upper East Side-Carnegie Hill
21-Aug,36061014802,1014802,15023,65838,80861,Manhattan,1351072.749,Upper East Side-Carnegie Hill
19-May,36061026100,1026100,6152,184555,190707,Manhattan,1681538.973,Washington Heights (South)
21-May,36061026100,1026100,0,176051,176051,Manhattan,1681538.973,Washington Heights (South)
19-Jun,36061026100,1026100,7456,84773,92229,Manhattan,1681538.973,Washington Heights (South)
21-Jun,36061026100,1026100,10653,47348,58001,Manhattan,1681538.973,Washington Heights (South)
19-Jul,36061026100,1026100,0,91319,91319,Manhattan,1681538.973,Washington Heights (South)
21-Jul,36061026100,1026100,24379,35168,59547,Manhattan,1681538.973,Washington Heights (South)
19-Aug,36061026100,1026100,6176,47096,53272,Manhattan,1681538.973,Washington Heights (South)
21-Aug,36061026100,1026100,4707,103571,108278,Manhattan,1681538.973,Washington Heights (South)
19-May,36061025300,1025300,8080,60089,68169,Manhattan,1822865.881,Washington Heights (South)
21-May,36061025300,1025300,1902,87410,89312,Manhattan,1822865.881,Washington Heights (South)
19-Jun,36061025300,1025300,8117,51552,59669,Manhattan,1822865.881,Washington Heights (South)
21-Jun,36061025300,1025300,6786,81284,88070,Manhattan,1822865.881,Washington Heights (South)
19-Jul,36061025300,1025300,7600,108713,116313,Manhattan,1822865.881,Washington Heights (South)
21-Jul,36061025300,1025300,7429,16477,23906,Manhattan,1822865.881,Washington Heights (South)
19-Aug,36061025300,1025300,7648,51964,59612,Manhattan,1822865.881,Washington Heights (South)
21-Aug,36061025300,1025300,1102,76772,77874,Manhattan,1822865.881,Washington Heights (South)
19-May,36061026300,1026300,10915,94411,105326,Manhattan,1691892.092,Washington Heights (South)
21-May,36061026300,1026300,10547,2338,12885,Manhattan,1691892.092,Washington Heights (South)
19-Jun,36061026300,1026300,8395,91188,99583,Manhattan,1691892.092,Washington Heights (South)
21-Jun,36061026300,1026300,2680,111929,114609,Manhattan,1691892.092,Washington Heights (South)
19-Jul,36061026300,1026300,2086,49405,51491,Manhattan,1691892.092,Washington Heights (South)
21-Jul,36061026300,1026300,12619,133043,145662,Manhattan,1691892.092,Washington Heights (South)
19-Aug,36061026300,1026300,10575,113332,123907,Manhattan,1691892.092,Washington Heights (South)
21-Aug,36061026300,1026300,5540,44817,50357,Manhattan,1691892.092,Washington Heights (South)
19-May,36061019800,1019800,632,105143,105775,Manhattan,2431074.041,East Harlem (North)
21-May,36061019800,1019800,10990,106384,117374,Manhattan,2431074.041,East Harlem (North)
19-Jun,36061019800,1019800,5410,19901,25311,Manhattan,2431074.041,East Harlem (North)
21-Jun,36061019800,1019800,5681,9583,15264,Manhattan,2431074.041,East Harlem (North)
19-Jul,36061019800,1019800,362,71,433,Manhattan,2431074.041,East Harlem (North)
21-Jul,36061019800,1019800,3632,71,3703,Manhattan,2431074.041,East Harlem (North)
19-Aug,36061019800,1019800,9829,97588,107417,Manhattan,2431074.041,East Harlem (North)
21-Aug,36061019800,1019800,11126,92261,103387,Manhattan,2431074.041,East Harlem (North)
19-May,36061019000,1019000,11802,100125,111927,Manhattan,1117371.709,Harlem (South)
21-May,36061019000,1019000,7133,6865,13998,Manhattan,1117371.709,Harlem (South)
19-Jun,36061019000,1019000,1662,78306,79968,Manhattan,1117371.709,Harlem (South)
21-Jun,36061019000,1019000,12251,92988,105239,Manhattan,1117371.709,Harlem (South)
19-Jul,36061019000,1019000,2017,36250,38267,Manhattan,1117371.709,Harlem (South)
21-Jul,36061019000,1019000,6130,49358,55488,Manhattan,1117371.709,Harlem (South)
19-Aug,36061019000,1019000,10742,106587,117329,Manhattan,1117371.709,Harlem (South)
21-Aug,36061019000,1019000,10763,75579,86342,Manhattan,1117371.709,Harlem (South)
19-May,36061020000,1020000,6687,12935,19622,Manhattan,1391141.414,Harlem (South)
21-May,36061020000,1020000,9424,96830,106254,Manhattan,1391141.414,Harlem (South)
19-Jun,36061020000,1020000,2525,146533,149058,Manhattan,1391141.414,Harlem (South)
21-Jun,36061020000,1020000,13619,59850,73469,Manhattan,1391141.414,Harlem (South)
19-Jul,36061020000,1020000,5446,126873,132319,Manhattan,1391141.414,Harlem (South)
21-Jul,36061020000,1020000,14348,51183,65531,Manhattan,1391141.414,Harlem (South)
19-Aug,36061020000,1020000,4427,59199,63626,Manhattan,1391141.414,Harlem (South)
21-Aug,36061020000,1020000,5913,71792,77705,Manhattan,1391141.414,Harlem (South)
19-May,36061027500,1027500,10484,84256,94740,Manhattan,2971043.936,Washington Heights (North)
21-May,36061027500,1027500,15014,53240,68254,Manhattan,2971043.936,Washington Heights (North)
19-Jun,36061027500,1027500,2058,94538,96596,Manhattan,2971043.936,Washington Heights (North)
21-Jun,36061027500,1027500,2178,70777,72955,Manhattan,2971043.936,Washington Heights (North)
19-Jul,36061027500,1027500,15955,8738,24693,Manhattan,2971043.936,Washington Heights (North)
21-Jul,36061027500,1027500,6903,91182,98085,Manhattan,2971043.936,Washington Heights (North)
19-Aug,36061027500,1027500,0,62736,62736,Manhattan,2971043.936,Washington Heights (North)
21-Aug,36061027500,1027500,11446,110910,122356,Manhattan,2971043.936,Washington Heights (North)
19-May,36061000700,1000700,11770,85190,96960,Manhattan,2439446.117,Financial District-Battery Park City
21-May,36061000700,1000700,7187,113989,121176,Manhattan,2439446.117,Financial District-Battery Park City
19-Jun,36061000700,1000700,7628,81613,89241,Manhattan,2439446.117,Financial District-Battery Park City
21-Jun,36061000700,1000700,2034,133625,135659,Manhattan,2439446.117,Financial District-Battery Park City
19-Jul,36061000700,1000700,11358,143935,155293,Manhattan,2439446.117,Financial District-Battery Park City
21-Jul,36061000700,1000700,4994,106662,111656,Manhattan,2439446.117,Financial District-Battery Park City
19-Aug,36061000700,1000700,4548,62269,66817,Manhattan,2439446.117,Financial District-Battery Park City
21-Aug,36061000700,1000700,9432,58498,67930,Manhattan,2439446.117,Financial District-Battery Park City
19-May,36061000900,1000900,6835,95564,102399,Manhattan,3130256.317,Financial District-Battery Park City
21-May,36061000900,1000900,9583,53012,62595,Manhattan,3130256.317,Financial District-Battery Park City
19-Jun,36061000900,1000900,16570,41678,58248,Manhattan,3130256.317,Financial District-Battery Park City
21-Jun,36061000900,1000900,12348,80147,92495,Manhattan,3130256.317,Financial District-Battery Park City
19-Jul,36061000900,1000900,0,64521,64521,Manhattan,3130256.317,Financial District-Battery Park City
21-Jul,36061000900,1000900,7821,52397,60218,Manhattan,3130256.317,Financial District-Battery Park City
19-Aug,36061000900,1000900,2093,5745,7838,Manhattan,3130256.317,Financial District-Battery Park City
21-Aug,36061000900,1000900,10763,71,10834,Manhattan,3130256.317,Financial District-Battery Park City
19-May,36061003001,1003001,10984,81874,92858,Manhattan,1330481.618,Lower East Side
21-May,36061003001,1003001,7208,90965,98173,Manhattan,1330481.618,Lower East Side
19-Jun,36061003001,1003001,2921,126176,129097,Manhattan,1330481.618,Lower East Side
21-Jun,36061003001,1003001,1209,99500,100709,Manhattan,1330481.618,Lower East Side
19-Jul,36061003001,1003001,12826,32583,45409,Manhattan,1330481.618,Lower East Side
21-Jul,36061003001,1003001,14324,89663,103987,Manhattan,1330481.618,Lower East Side
19-Aug,36061003001,1003001,6436,101516,107952,Manhattan,1330481.618,Lower East Side
21-Aug,36061003001,1003001,8333,11543,19876,Manhattan,1330481.618,Lower East Side
19-May,36061005900,1005900,3724,102056,105780,Manhattan,1250316.207,Greenwich Village
21-May,36061005900,1005900,0,694,694,Manhattan,1250316.207,Greenwich Village
19-Jun,36061005900,1005900,14927,117303,132230,Manhattan,1250316.207,Greenwich Village
21-Jun,36061005900,1005900,11317,84874,96191,Manhattan,1250316.207,Greenwich Village
19-Jul,36061005900,1005900,5553,42804,48357,Manhattan,1250316.207,Greenwich Village
21-Jul,36061005900,1005900,2664,67775,70439,Manhattan,1250316.207,Greenwich Village
19-Aug,36061005900,1005900,4418,34013,38431,Manhattan,1250316.207,Greenwich Village
21-Aug,36061005900,1005900,7855,71,7926,Manhattan,1250316.207,Greenwich Village
19-May,36061006100,1006100,1855,37161,39016,Manhattan,1528504.225,Greenwich Village
21-May,36061006100,1006100,9454,71,9525,Manhattan,1528504.225,Greenwich Village
19-Jun,36061006100,1006100,8930,134954,143884,Manhattan,1528504.225,Greenwich Village
21-Jun,36061006100,1006100,13240,82878,96118,Manhattan,1528504.225,Greenwich Village
19-Jul,36061006100,1006100,6156,40548,46704,Manhattan,1528504.225,Greenwich Village
21-Jul,36061006100,1006100,5633,63986,69619,Manhattan,1528504.225,Greenwich Village
19-Aug,36061006100,1006100,2395,97388,99783,Manhattan,1528504.225,Greenwich Village
21-Aug,36061006100,1006100,12200,61393,73593,Manhattan,1528504.225,Greenwich Village
19-May,36061005000,1005000,11232,61835,73067,Manhattan,1793935.48,Gramercy
21-May,36061005000,1005000,6240,48881,55121,Manhattan,1793935.48,Gramercy
19-Jun,36061005000,1005000,8614,71363,79977,Manhattan,1793935.48,Gramercy
21-Jun,36061005000,1005000,7389,101978,109367,Manhattan,1793935.48,Gramercy
19-Jul,36061005000,1005000,4659,91487,96146,Manhattan,1793935.48,Gramercy
21-Jul,36061005000,1005000,9063,76214,85277,Manhattan,1793935.48,Gramercy
19-Aug,36061005000,1005000,3975,185546,189521,Manhattan,1793935.48,Gramercy
21-Aug,36061005000,1005000,9370,26726,36096,Manhattan,1793935.48,Gramercy
19-May,36061010601,1010601,11495,137397,148892,Manhattan,1313234.837,East Midtown-Turtle Bay
21-May,36061010601,1010601,6965,71,7036,Manhattan,1313234.837,East Midtown-Turtle Bay
19-Jun,36061010601,1010601,7545,49219,56764,Manhattan,1313234.837,East Midtown-Turtle Bay
21-Jun,36061010601,1010601,12675,89319,101994,Manhattan,1313234.837,East Midtown-Turtle Bay
19-Jul,36061010601,1010601,4126,93593,97719,Manhattan,1313234.837,East Midtown-Turtle Bay
21-Jul,36061010601,1010601,6488,147218,153706,Manhattan,1313234.837,East Midtown-Turtle Bay
19-Aug,36061010601,1010601,7163,79325,86488,Manhattan,1313234.837,East Midtown-Turtle Bay
21-Aug,36061010601,1010601,13159,150825,163984,Manhattan,1313234.837,East Midtown-Turtle Bay
19-May,36061012800,1012800,5976,91526,97502,Manhattan,1924402.678,Upper East Side-Carnegie Hill
21-May,36061012800,1012800,19178,129112,148290,Manhattan,1924402.678,Upper East Side-Carnegie Hill
19-Jun,36061012800,1012800,8796,74470,83266,Manhattan,1924402.678,Upper East Side-Carnegie Hill
21-Jun,36061012800,1012800,11905,85511,97416,Manhattan,1924402.678,Upper East Side-Carnegie Hill
19-Jul,36061012800,1012800,13500,30414,43914,Manhattan,1924402.678,Upper East Side-Carnegie Hill
21-Jul,36061012800,1012800,15480,57488,72968,Manhattan,1924402.678,Upper East Side-Carnegie Hill
19-Aug,36061012800,1012800,15441,102674,118115,Manhattan,1924402.678,Upper East Side-Carnegie Hill
21-Aug,36061012800,1012800,4357,68751,73108,Manhattan,1924402.678,Upper East Side-Carnegie Hill
19-May,36061004700,1004700,9773,105030,114803,Manhattan,1780551.106,SoHo-Little Italy-Hudson Square
21-May,36061004700,1004700,6722,79486,86208,Manhattan,1780551.106,SoHo-Little Italy-Hudson Square
19-Jun,36061004700,1004700,14295,21892,36187,Manhattan,1780551.106,SoHo-Little Italy-Hudson Square
21-Jun,36061004700,1004700,9195,77925,87120,Manhattan,1780551.106,SoHo-Little Italy-Hudson Square
19-Jul,36061004700,1004700,2332,77662,79994,Manhattan,1780551.106,SoHo-Little Italy-Hudson Square
21-Jul,36061004700,1004700,9674,27927,37601,Manhattan,1780551.106,SoHo-Little Italy-Hudson Square
19-Aug,36061004700,1004700,13521,37932,51453,Manhattan,1780551.106,SoHo-Little Italy-Hudson Square
21-Aug,36061004700,1004700,1159,150444,151603,Manhattan,1780551.106,SoHo-Little Italy-Hudson Square
19-May,36061004900,1004900,10186,107344,117530,Manhattan,2226124.323,SoHo-Little Italy-Hudson Square
21-May,36061004900,1004900,12182,81596,93778,Manhattan,2226124.323,SoHo-Little Italy-Hudson Square
19-Jun,36061004900,1004900,6686,88391,95077,Manhattan,2226124.323,SoHo-Little Italy-Hudson Square
21-Jun,36061004900,1004900,11092,155340,166432,Manhattan,2226124.323,SoHo-Little Italy-Hudson Square
19-Jul,36061004900,1004900,4390,140719,145109,Manhattan,2226124.323,SoHo-Little Italy-Hudson Square
21-Jul,36061004900,1004900,11167,35499,46666,Manhattan,2226124.323,SoHo-Little Italy-Hudson Square
19-Aug,36061004900,1004900,3526,49238,52764,Manhattan,2226124.323,SoHo-Little Italy-Hudson Square
21-Aug,36061004900,1004900,9502,128470,137972,Manhattan,2226124.323,SoHo-Little Italy-Hudson Square
19-May,36061013203,1013203,17406,81750,99156,Manhattan,580532.9687,Upper East Side-Lenox Hill-Roosevelt Island
21-May,36061013203,1013203,5825,71,5896,Manhattan,580532.9687,Upper East Side-Lenox Hill-Roosevelt Island
19-Jun,36061013203,1013203,8246,71,8317,Manhattan,580532.9687,Upper East Side-Lenox Hill-Roosevelt Island
21-Jun,36061013203,1013203,5404,7702,13106,Manhattan,580532.9687,Upper East Side-Lenox Hill-Roosevelt Island
19-Jul,36061013203,1013203,8677,97514,106191,Manhattan,580532.9687,Upper East Side-Lenox Hill-Roosevelt Island
21-Jul,36061013203,1013203,9335,19700,29035,Manhattan,580532.9687,Upper East Side-Lenox Hill-Roosevelt Island
19-Aug,36061013203,1013203,407,5795,6202,Manhattan,580532.9687,Upper East Side-Lenox Hill-Roosevelt Island
21-Aug,36061013203,1013203,5782,113915,119697,Manhattan,580532.9687,Upper East Side-Lenox Hill-Roosevelt Island
19-May,36061013400,1013400,8109,60452,68561,Manhattan,1956780.7,Upper East Side-Lenox Hill-Roosevelt Island
21-May,36061013400,1013400,9974,90786,100760,Manhattan,1956780.7,Upper East Side-Lenox Hill-Roosevelt Island
19-Jun,36061013400,1013400,6067,109197,115264,Manhattan,1956780.7,Upper East Side-Lenox Hill-Roosevelt Island
21-Jun,36061013400,1013400,10087,79504,89591,Manhattan,1956780.7,Upper East Side-Lenox Hill-Roosevelt Island
19-Jul,36061013400,1013400,12579,60962,73541,Manhattan,1956780.7,Upper East Side-Lenox Hill-Roosevelt Island
21-Jul,36061013400,1013400,17924,72531,90455,Manhattan,1956780.7,Upper East Side-Lenox Hill-Roosevelt Island
19-Aug,36061013400,1013400,11160,108500,119660,Manhattan,1956780.7,Upper East Side-Lenox Hill-Roosevelt Island
21-Aug,36061013400,1013400,9218,27634,36852,Manhattan,1956780.7,Upper East Side-Lenox Hill-Roosevelt Island
19-May,36061011000,1011000,12184,77015,89199,Manhattan,1901324.29,Upper East Side-Lenox Hill-Roosevelt Island
21-May,36061011000,1011000,4442,111173,115615,Manhattan,1901324.29,Upper East Side-Lenox Hill-Roosevelt Island
19-Jun,36061011000,1011000,10669,86153,96822,Manhattan,1901324.29,Upper East Side-Lenox Hill-Roosevelt Island
21-Jun,36061011000,1011000,8461,153657,162118,Manhattan,1901324.29,Upper East Side-Lenox Hill-Roosevelt Island
19-Jul,36061011000,1011000,5792,60174,65966,Manhattan,1901324.29,Upper East Side-Lenox Hill-Roosevelt Island
21-Jul,36061011000,1011000,16853,99355,116208,Manhattan,1901324.29,Upper East Side-Lenox Hill-Roosevelt Island
19-Aug,36061011000,1011000,5029,21454,26483,Manhattan,1901324.29,Upper East Side-Lenox Hill-Roosevelt Island
21-Aug,36061011000,1011000,14032,59009,73041,Manhattan,1901324.29,Upper East Side-Lenox Hill-Roosevelt Island
19-May,36061013800,1013800,9906,103949,113855,Manhattan,1959555.778,Upper East Side-Yorkville
21-May,36061013800,1013800,19067,74243,93310,Manhattan,1959555.778,Upper East Side-Yorkville
19-Jun,36061013800,1013800,10773,117731,128504,Manhattan,1959555.778,Upper East Side-Yorkville
21-Jun,36061013800,1013800,3108,84520,87628,Manhattan,1959555.778,Upper East Side-Yorkville
19-Jul,36061013800,1013800,5380,71,5451,Manhattan,1959555.778,Upper East Side-Yorkville
21-Jul,36061013800,1013800,3756,124202,127958,Manhattan,1959555.778,Upper East Side-Yorkville
19-Aug,36061013800,1013800,8658,78725,87383,Manhattan,1959555.778,Upper East Side-Yorkville
21-Aug,36061013800,1013800,7088,43772,50860,Manhattan,1959555.778,Upper East Side-Yorkville
19-May,36061014000,1014000,9036,142806,151842,Manhattan,1925984.244,Upper East Side-Carnegie Hill
21-May,36061014000,1014000,9136,61496,70632,Manhattan,1925984.244,Upper East Side-Carnegie Hill
19-Jun,36061014000,1014000,8673,52401,61074,Manhattan,1925984.244,Upper East Side-Carnegie Hill
21-Jun,36061014000,1014000,0,106472,106472,Manhattan,1925984.244,Upper East Side-Carnegie Hill
19-Jul,36061014000,1014000,12017,102557,114574,Manhattan,1925984.244,Upper East Side-Carnegie Hill
21-Jul,36061014000,1014000,12628,53728,66356,Manhattan,1925984.244,Upper East Side-Carnegie Hill
19-Aug,36061014000,1014000,6391,44773,51164,Manhattan,1925984.244,Upper East Side-Carnegie Hill
21-Aug,36061014000,1014000,5437,68010,73447,Manhattan,1925984.244,Upper East Side-Carnegie Hill
19-May,36061013603,1013603,14352,154988,169340,Manhattan,579210.5083,Upper East Side-Yorkville
21-May,36061013603,1013603,8439,63202,71641,Manhattan,579210.5083,Upper East Side-Yorkville
19-Jun,36061013603,1013603,6874,55032,61906,Manhattan,579210.5083,Upper East Side-Yorkville
21-Jun,36061013603,1013603,8195,78737,86932,Manhattan,579210.5083,Upper East Side-Yorkville
19-Jul,36061013603,1013603,7828,44078,51906,Manhattan,579210.5083,Upper East Side-Yorkville
21-Jul,36061013603,1013603,2618,76293,78911,Manhattan,579210.5083,Upper East Side-Yorkville
19-Aug,36061013603,1013603,9273,116516,125789,Manhattan,579210.5083,Upper East Side-Yorkville
21-Aug,36061013603,1013603,12406,71,12477,Manhattan,579210.5083,Upper East Side-Yorkville
19-May,36061013604,1013604,7369,54112,61481,Manhattan,771854.0037,Upper East Side-Yorkville
21-May,36061013604,1013604,4807,92942,97749,Manhattan,771854.0037,Upper East Side-Yorkville
19-Jun,36061013604,1013604,13018,77797,90815,Manhattan,771854.0037,Upper East Side-Yorkville
21-Jun,36061013604,1013604,9864,114149,124013,Manhattan,771854.0037,Upper East Side-Yorkville
19-Jul,36061013604,1013604,10720,136713,147433,Manhattan,771854.0037,Upper East Side-Yorkville
21-Jul,36061013604,1013604,6578,80563,87141,Manhattan,771854.0037,Upper East Side-Yorkville
19-Aug,36061013604,1013604,11895,60294,72189,Manhattan,771854.0037,Upper East Side-Yorkville
21-Aug,36061013604,1013604,6308,46499,52807,Manhattan,771854.0037,Upper East Side-Yorkville
19-May,36061014402,1014402,10809,130184,140993,Manhattan,1878963.533,Upper East Side-Yorkville
21-May,36061014402,1014402,9909,90367,100276,Manhattan,1878963.533,Upper East Side-Yorkville
19-Jun,36061014402,1014402,8353,66853,75206,Manhattan,1878963.533,Upper East Side-Yorkville
21-Jun,36061014402,1014402,944,52050,52994,Manhattan,1878963.533,Upper East Side-Yorkville
19-Jul,36061014402,1014402,2726,108379,111105,Manhattan,1878963.533,Upper East Side-Yorkville
21-Jul,36061014402,1014402,13481,50621,64102,Manhattan,1878963.533,Upper East Side-Yorkville
19-Aug,36061014402,1014402,15955,75839,91794,Manhattan,1878963.533,Upper East Side-Yorkville
21-Aug,36061014402,1014402,805,33916,34721,Manhattan,1878963.533,Upper East Side-Yorkville
19-May,36061014200,1014200,17383,80361,97744,Manhattan,1927688.319,Upper East Side-Carnegie Hill
21-May,36061014200,1014200,0,81484,81484,Manhattan,1927688.319,Upper East Side-Carnegie Hill
19-Jun,36061014200,1014200,4030,54988,59018,Manhattan,1927688.319,Upper East Side-Carnegie Hill
21-Jun,36061014200,1014200,9163,41718,50881,Manhattan,1927688.319,Upper East Side-Carnegie Hill
19-Jul,36061014200,1014200,14307,24723,39030,Manhattan,1927688.319,Upper East Side-Carnegie Hill
21-Jul,36061014200,1014200,8950,131772,140722,Manhattan,1927688.319,Upper East Side-Carnegie Hill
19-Aug,36061014200,1014200,6636,71,6707,Manhattan,1927688.319,Upper East Side-Carnegie Hill
21-Aug,36061014200,1014200,13132,31904,45036,Manhattan,1927688.319,Upper East Side-Carnegie Hill
19-May,36061002202,1002202,5885,60458,66343,Manhattan,603922.2042,East Village
21-May,36061002202,1002202,5625,91797,97422,Manhattan,603922.2042,East Village
19-Jun,36061002202,1002202,4560,105933,110493,Manhattan,603922.2042,East Village
21-Jun,36061002202,1002202,12432,120103,132535,Manhattan,603922.2042,East Village
19-Jul,36061002202,1002202,8802,90408,99210,Manhattan,603922.2042,East Village
21-Jul,36061002202,1002202,8985,26886,35871,Manhattan,603922.2042,East Village
19-Aug,36061002202,1002202,13148,67015,80163,Manhattan,603922.2042,East Village
21-Aug,36061002202,1002202,5083,64043,69126,Manhattan,603922.2042,East Village
19-May,36061003002,1003002,11115,71,11186,Manhattan,841097.8676,East Village
21-May,36061003002,1003002,9813,159620,169433,Manhattan,841097.8676,East Village
19-Jun,36061003002,1003002,12206,74784,86990,Manhattan,841097.8676,East Village
21-Jun,36061003002,1003002,13045,107086,120131,Manhattan,841097.8676,East Village
19-Jul,36061003002,1003002,18197,92334,110531,Manhattan,841097.8676,East Village
21-Jul,36061003002,1003002,4536,111063,115599,Manhattan,841097.8676,East Village
19-Aug,36061003002,1003002,3599,88454,92053,Manhattan,841097.8676,East Village
21-Aug,36061003002,1003002,8397,84757,93154,Manhattan,841097.8676,East Village
19-May,36061018200,1018200,4221,89122,93343,Manhattan,1904007.709,East Harlem (North)
21-May,36061018200,1018200,4705,13534,18239,Manhattan,1904007.709,East Harlem (North)
19-Jun,36061018200,1018200,6549,117846,124395,Manhattan,1904007.709,East Harlem (North)
21-Jun,36061018200,1018200,7031,75425,82456,Manhattan,1904007.709,East Harlem (North)
19-Jul,36061018200,1018200,10433,99106,109539,Manhattan,1904007.709,East Harlem (North)
21-Jul,36061018200,1018200,11079,65124,76203,Manhattan,1904007.709,East Harlem (North)
19-Aug,36061018200,1018200,14026,66365,80391,Manhattan,1904007.709,East Harlem (North)
21-Aug,36061018200,1018200,4220,81710,85930,Manhattan,1904007.709,East Harlem (North)
19-May,36061018800,1018800,8285,111234,119519,Manhattan,1599420.557,East Harlem (North)
21-May,36061018800,1018800,7860,87959,95819,Manhattan,1599420.557,East Harlem (North)
19-Jun,36061018800,1018800,10199,27712,37911,Manhattan,1599420.557,East Harlem (North)
21-Jun,36061018800,1018800,7698,104584,112282,Manhattan,1599420.557,East Harlem (North)
19-Jul,36061018800,1018800,7591,92852,100443,Manhattan,1599420.557,East Harlem (North)
21-Jul,36061018800,1018800,5066,83511,88577,Manhattan,1599420.557,East Harlem (North)
19-Aug,36061018800,1018800,3204,117837,121041,Manhattan,1599420.557,East Harlem (North)
21-Aug,36061018800,1018800,15295,50985,66280,Manhattan,1599420.557,East Harlem (North)
19-May,36061017900,1017900,7478,85892,93370,Manhattan,2278484.154,Upper West Side (Central)
21-May,36061017900,1017900,2626,120471,123097,Manhattan,2278484.154,Upper West Side (Central)
19-Jun,36061017900,1017900,4314,108832,113146,Manhattan,2278484.154,Upper West Side (Central)
21-Jun,36061017900,1017900,3039,39970,43009,Manhattan,2278484.154,Upper West Side (Central)
19-Jul,36061017900,1017900,4004,63962,67966,Manhattan,2278484.154,Upper West Side (Central)
21-Jul,36061017900,1017900,12996,60449,73445,Manhattan,2278484.154,Upper West Side (Central)
19-Aug,36061017900,1017900,9921,73647,83568,Manhattan,2278484.154,Upper West Side (Central)
21-Aug,36061017900,1017900,8385,13654,22039,Manhattan,2278484.154,Upper West Side (Central)
19-May,36061018300,1018300,2240,62577,64817,Manhattan,2391021.042,Upper West Side (Central)
21-May,36061018300,1018300,13145,71,13216,Manhattan,2391021.042,Upper West Side (Central)
19-Jun,36061018300,1018300,12042,93937,105979,Manhattan,2391021.042,Upper West Side (Central)
21-Jun,36061018300,1018300,1184,71,1255,Manhattan,2391021.042,Upper West Side (Central)
19-Jul,36061018300,1018300,16524,71,16595,Manhattan,2391021.042,Upper West Side (Central)
21-Jul,36061018300,1018300,4458,126090,130548,Manhattan,2391021.042,Upper West Side (Central)
19-Aug,36061018300,1018300,5367,28648,34015,Manhattan,2391021.042,Upper West Side (Central)
21-Aug,36061018300,1018300,0,82208,82208,Manhattan,2391021.042,Upper West Side (Central)
19-May,36081045500,4045500,6946,66015,72961,Queens,1594376.384,Corona
21-May,36081045500,4045500,15448,139189,154637,Queens,1594376.384,Corona
19-Jun,36081045500,4045500,9713,118030,127743,Queens,1594376.384,Corona
21-Jun,36081045500,4045500,7648,97644,105292,Queens,1594376.384,Corona
19-Jul,36081045500,4045500,3866,67506,71372,Queens,1594376.384,Corona
21-Jul,36081045500,4045500,9864,13637,23501,Queens,1594376.384,Corona
19-Aug,36081045500,4045500,1139,124627,125766,Queens,1594376.384,Corona
21-Aug,36081045500,4045500,7085,78091,85176,Queens,1594376.384,Corona
19-May,36081071702,4071702,16002,91552,107554,Queens,2446733.028,Rego Park
21-May,36081071702,4071702,11375,65118,76493,Queens,2446733.028,Rego Park
19-Jun,36081071702,4071702,2478,63687,66165,Queens,2446733.028,Rego Park
21-Jun,36081071702,4071702,5257,121527,126784,Queens,2446733.028,Rego Park
19-Jul,36081071702,4071702,5862,138152,144014,Queens,2446733.028,Rego Park
21-Jul,36081071702,4071702,10413,71,10484,Queens,2446733.028,Rego Park
19-Aug,36081071702,4071702,9834,73044,82878,Queens,2446733.028,Rego Park
21-Aug,36081071702,4071702,10857,89437,100294,Queens,2446733.028,Rego Park
19-May,36005006700,2006700,2385,64112,66497,Bronx,2277490.13,Melrose
21-May,36005006700,2006700,5727,90166,95893,Bronx,2277490.13,Melrose
19-Jun,36005006700,2006700,2453,37799,40252,Bronx,2277490.13,Melrose
21-Jun,36005006700,2006700,8846,58811,67657,Bronx,2277490.13,Melrose
19-Jul,36005006700,2006700,15592,77672,93264,Bronx,2277490.13,Melrose
21-Jul,36005006700,2006700,4564,78577,83141,Bronx,2277490.13,Melrose
19-Aug,36005006700,2006700,9094,105442,114536,Bronx,2277490.13,Melrose
21-Aug,36005006700,2006700,0,151660,151660,Bronx,2277490.13,Melrose
19-May,36005006900,2006900,6899,34225,41124,Bronx,2029126.221,Melrose
21-May,36005006900,2006900,10400,108558,118958,Bronx,2029126.221,Melrose
19-Jun,36005006900,2006900,14801,116088,130889,Bronx,2029126.221,Melrose
21-Jun,36005006900,2006900,11091,108132,119223,Bronx,2029126.221,Melrose
19-Jul,36005006900,2006900,8265,112100,120365,Bronx,2029126.221,Melrose
21-Jul,36005006900,2006900,7413,50459,57872,Bronx,2029126.221,Melrose
19-Aug,36005006900,2006900,2943,68608,71551,Bronx,2029126.221,Melrose
21-Aug,36005006900,2006900,11811,84028,95839,Bronx,2029126.221,Melrose
19-May,36005038304,2038304,15693,4132,19825,Bronx,753194.9109,Belmont
21-May,36005038304,2038304,6710,43946,50656,Bronx,753194.9109,Belmont
19-Jun,36005038304,2038304,4861,24117,28978,Bronx,753194.9109,Belmont
21-Jun,36005038304,2038304,5504,58074,63578,Bronx,753194.9109,Belmont
19-Jul,36005038304,2038304,8991,65081,74072,Bronx,753194.9109,Belmont
21-Jul,36005038304,2038304,16186,64617,80803,Bronx,753194.9109,Belmont
19-Aug,36005038304,2038304,12517,92655,105172,Bronx,753194.9109,Belmont
21-Aug,36005038304,2038304,4481,103367,107848,Bronx,753194.9109,Belmont
19-May,36005036502,2036502,7018,24037,31055,Bronx,1050346.611,Tremont
21-May,36005036502,2036502,9053,103038,112091,Bronx,1050346.611,Tremont
19-Jun,36005036502,2036502,5320,108234,113554,Bronx,1050346.611,Tremont
21-Jun,36005036502,2036502,13353,3758,17111,Bronx,1050346.611,Tremont
19-Jul,36005036502,2036502,1728,107719,109447,Bronx,1050346.611,Tremont
21-Jul,36005036502,2036502,6917,83601,90518,Bronx,1050346.611,Tremont
19-Aug,36005036502,2036502,10361,56653,67014,Bronx,1050346.611,Tremont
21-Aug,36005036502,2036502,0,22337,22337,Bronx,1050346.611,Tremont
19-May,36005036700,2036700,9982,60021,70003,Bronx,1005438.138,Tremont
21-May,36005036700,2036700,5504,50189,55693,Bronx,1005438.138,Tremont
19-Jun,36005036700,2036700,6685,35879,42564,Bronx,1005438.138,Tremont
21-Jun,36005036700,2036700,7878,75292,83170,Bronx,1005438.138,Tremont
19-Jul,36005036700,2036700,542,127204,127746,Bronx,1005438.138,Tremont
21-Jul,36005036700,2036700,11054,63980,75034,Bronx,1005438.138,Tremont
19-Aug,36005036700,2036700,10209,83114,93323,Bronx,1005438.138,Tremont
21-Aug,36005036700,2036700,10924,111737,122661,Bronx,1005438.138,Tremont
19-May,36005002001,2002001,6952,124855,131807,Bronx,2131637.857,Soundview-Clason Point
21-May,36005002001,2002001,1765,84859,86624,Bronx,2131637.857,Soundview-Clason Point
19-Jun,36005002001,2002001,7752,68714,76466,Bronx,2131637.857,Soundview-Clason Point
21-Jun,36005002001,2002001,2339,52040,54379,Bronx,2131637.857,Soundview-Clason Point
19-Jul,36005002001,2002001,13377,84187,97564,Bronx,2131637.857,Soundview-Clason Point
21-Jul,36005002001,2002001,12574,33369,45943,Bronx,2131637.857,Soundview-Clason Point
19-Aug,36005002001,2002001,11862,35338,47200,Bronx,2131637.857,Soundview-Clason Point
21-Aug,36005002001,2002001,8857,44194,53051,Bronx,2131637.857,Soundview-Clason Point
19-May,36005002400,2002400,7644,107196,114840,Bronx,7798457.59,Soundview Park
21-May,36005002400,2002400,14421,102110,116531,Bronx,7798457.59,Soundview Park
19-Jun,36005002400,2002400,12459,49967,62426,Bronx,7798457.59,Soundview Park
21-Jun,36005002400,2002400,8864,39707,48571,Bronx,7798457.59,Soundview Park
19-Jul,36005002400,2002400,9145,127471,136616,Bronx,7798457.59,Soundview Park
21-Jul,36005002400,2002400,2118,71,2189,Bronx,7798457.59,Soundview Park
19-Aug,36005002400,2002400,6484,72237,78721,Bronx,7798457.59,Soundview Park
21-Aug,36005002400,2002400,7905,84978,92883,Bronx,7798457.59,Soundview Park
19-May,36005007700,2007700,11845,69259,81104,Bronx,1214306.322,Melrose
21-May,36005007700,2007700,13517,130783,144300,Bronx,1214306.322,Melrose
19-Jun,36005007700,2007700,14267,92699,106966,Bronx,1214306.322,Melrose
21-Jun,36005007700,2007700,5192,60326,65518,Bronx,1214306.322,Melrose
19-Jul,36005007700,2007700,3921,105513,109434,Bronx,1214306.322,Melrose
21-Jul,36005007700,2007700,11138,625,11763,Bronx,1214306.322,Melrose
19-Aug,36005007700,2007700,14459,75346,89805,Bronx,1214306.322,Melrose
21-Aug,36005007700,2007700,6415,97716,104131,Bronx,1214306.322,Melrose
19-May,36061023000,1023000,11962,61603,73565,Manhattan,1869850.736,Harlem (North)
21-May,36061023000,1023000,4542,68996,73538,Manhattan,1869850.736,Harlem (North)
19-Jun,36061023000,1023000,912,36048,36960,Manhattan,1869850.736,Harlem (North)
21-Jun,36061023000,1023000,3948,54445,58393,Manhattan,1869850.736,Harlem (North)
19-Jul,36061023000,1023000,1454,69119,70573,Manhattan,1869850.736,Harlem (North)
21-Jul,36061023000,1023000,15668,71389,87057,Manhattan,1869850.736,Harlem (North)
19-Aug,36061023000,1023000,10258,57121,67379,Manhattan,1869850.736,Harlem (North)
21-Aug,36061023000,1023000,11225,57305,68530,Manhattan,1869850.736,Harlem (North)
19-May,36061023200,1023200,10696,37502,48198,Manhattan,1943381.06,Harlem (North)
21-May,36061023200,1023200,12725,37748,50473,Manhattan,1943381.06,Harlem (North)
19-Jun,36061023200,1023200,14561,137608,152169,Manhattan,1943381.06,Harlem (North)
21-Jun,36061023200,1023200,143,150454,150597,Manhattan,1943381.06,Harlem (North)
19-Jul,36061023200,1023200,12352,85185,97537,Manhattan,1943381.06,Harlem (North)
21-Jul,36061023200,1023200,7606,71,7677,Manhattan,1943381.06,Harlem (North)
19-Aug,36061023200,1023200,4893,151622,156515,Manhattan,1943381.06,Harlem (North)
21-Aug,36061023200,1023200,9426,66836,76262,Manhattan,1943381.06,Harlem (North)
19-May,36005043502,2043502,11623,94511,106134,Bronx,17886378.53,Woodlawn Cemetery
21-May,36005043502,2043502,15342,77559,92901,Bronx,17886378.53,Woodlawn Cemetery
19-Jun,36005043502,2043502,13273,71,13344,Bronx,17886378.53,Woodlawn Cemetery
21-Jun,36005043502,2043502,7087,30589,37676,Bronx,17886378.53,Woodlawn Cemetery
19-Jul,36005043502,2043502,727,13448,14175,Bronx,17886378.53,Woodlawn Cemetery
21-Jul,36005043502,2043502,6153,60905,67058,Bronx,17886378.53,Woodlawn Cemetery
19-Aug,36005043502,2043502,6709,32375,39084,Bronx,17886378.53,Woodlawn Cemetery
21-Aug,36005043502,2043502,14277,60770,75047,Bronx,17886378.53,Woodlawn Cemetery
19-May,36005022401,2022401,8404,74884,83288,Bronx,923976.2103,Pelham Parkway-Van Nest
21-May,36005022401,2022401,9406,82054,91460,Bronx,923976.2103,Pelham Parkway-Van Nest
19-Jun,36005022401,2022401,13618,126313,139931,Bronx,923976.2103,Pelham Parkway-Van Nest
21-Jun,36005022401,2022401,8764,71492,80256,Bronx,923976.2103,Pelham Parkway-Van Nest
19-Jul,36005022401,2022401,3502,139248,142750,Bronx,923976.2103,Pelham Parkway-Van Nest
21-Jul,36005022401,2022401,3964,58696,62660,Bronx,923976.2103,Pelham Parkway-Van Nest
19-Aug,36005022401,2022401,5668,112050,117718,Bronx,923976.2103,Pelham Parkway-Van Nest
21-Aug,36005022401,2022401,14748,103460,118208,Bronx,923976.2103,Pelham Parkway-Van Nest
19-May,36061020901,1020901,0,79247,79247,Manhattan,1246712.332,Morningside Heights
21-May,36061020901,1020901,8991,51849,60840,Manhattan,1246712.332,Morningside Heights
19-Jun,36061020901,1020901,10795,100638,111433,Manhattan,1246712.332,Morningside Heights
21-Jun,36061020901,1020901,10187,165840,176027,Manhattan,1246712.332,Morningside Heights
19-Jul,36061020901,1020901,8107,66001,74108,Manhattan,1246712.332,Morningside Heights
21-Jul,36061020901,1020901,11263,34602,45865,Manhattan,1246712.332,Morningside Heights
19-Aug,36061020901,1020901,6601,63100,69701,Manhattan,1246712.332,Morningside Heights
21-Aug,36061020901,1020901,6744,35665,42409,Manhattan,1246712.332,Morningside Heights
19-May,36061025700,1025700,12435,114684,127119,Manhattan,1550590.101,Harlem (South)
21-May,36061025700,1025700,17673,71,17744,Manhattan,1550590.101,Harlem (South)
19-Jun,36061025700,1025700,12917,35448,48365,Manhattan,1550590.101,Harlem (South)
21-Jun,36061025700,1025700,8728,47059,55787,Manhattan,1550590.101,Harlem (South)
19-Jul,36061025700,1025700,13301,79327,92628,Manhattan,1550590.101,Harlem (South)
21-Jul,36061025700,1025700,13613,73644,87257,Manhattan,1550590.101,Harlem (South)
19-Aug,36061025700,1025700,12034,68656,80690,Manhattan,1550590.101,Harlem (South)
21-Aug,36061025700,1025700,0,59571,59571,Manhattan,1550590.101,Harlem (South)
19-May,36061019701,1019701,6049,123140,129189,Manhattan,2535936.665,Morningside Heights
21-May,36061019701,1019701,6518,80764,87282,Manhattan,2535936.665,Morningside Heights
19-Jun,36061019701,1019701,17087,193527,210614,Manhattan,2535936.665,Morningside Heights
21-Jun,36061019701,1019701,3745,77317,81062,Manhattan,2535936.665,Morningside Heights
19-Jul,36061019701,1019701,13960,59773,73733,Manhattan,2535936.665,Morningside Heights
21-Jul,36061019701,1019701,3361,94153,97514,Manhattan,2535936.665,Morningside Heights
19-Aug,36061019701,1019701,4862,105595,110457,Manhattan,2535936.665,Morningside Heights
21-Aug,36061019701,1019701,5009,127839,132848,Manhattan,2535936.665,Morningside Heights
19-May,36061020102,1020102,17715,84693,102408,Manhattan,901944.2295,Harlem (South)
21-May,36061020102,1020102,6084,107047,113131,Manhattan,901944.2295,Harlem (South)
19-Jun,36061020102,1020102,15169,62696,77865,Manhattan,901944.2295,Harlem (South)
21-Jun,36061020102,1020102,2712,87815,90527,Manhattan,901944.2295,Harlem (South)
19-Jul,36061020102,1020102,7691,57338,65029,Manhattan,901944.2295,Harlem (South)
21-Jul,36061020102,1020102,1055,127248,128303,Manhattan,901944.2295,Harlem (South)
19-Aug,36061020102,1020102,9794,132773,142567,Manhattan,901944.2295,Harlem (South)
21-Aug,36061020102,1020102,7975,62523,70498,Manhattan,901944.2295,Harlem (South)
19-May,36005015500,2015500,4235,49990,54225,Bronx,1230923.832,Crotona Park East
21-May,36005015500,2015500,12778,15511,28289,Bronx,1230923.832,Crotona Park East
19-Jun,36005015500,2015500,8410,71,8481,Bronx,1230923.832,Crotona Park East
21-Jun,36005015500,2015500,10485,105177,115662,Bronx,1230923.832,Crotona Park East
19-Jul,36005015500,2015500,12504,44532,57036,Bronx,1230923.832,Crotona Park East
21-Jul,36005015500,2015500,6222,54382,60604,Bronx,1230923.832,Crotona Park East
19-Aug,36005015500,2015500,4187,112930,117117,Bronx,1230923.832,Crotona Park East
21-Aug,36005015500,2015500,0,78803,78803,Bronx,1230923.832,Crotona Park East
19-May,36005038500,2038500,3751,60651,64402,Bronx,2050957.4,Belmont
21-May,36005038500,2038500,6054,86418,92472,Bronx,2050957.4,Belmont
19-Jun,36005038500,2038500,9150,113333,122483,Bronx,2050957.4,Belmont
21-Jun,36005038500,2038500,1119,72067,73186,Bronx,2050957.4,Belmont
19-Jul,36005038500,2038500,11992,83312,95304,Bronx,2050957.4,Belmont
21-Jul,36005038500,2038500,12058,34011,46069,Bronx,2050957.4,Belmont
19-Aug,36005038500,2038500,7878,61932,69810,Bronx,2050957.4,Belmont
21-Aug,36005038500,2038500,11922,18366,30288,Bronx,2050957.4,Belmont
19-May,36005039500,2039500,3568,42219,45787,Bronx,4416473.06,Tremont
21-May,36005039500,2039500,15655,166803,182458,Bronx,4416473.06,Tremont
19-Jun,36005039500,2039500,10967,42109,53076,Bronx,4416473.06,Tremont
21-Jun,36005039500,2039500,15408,56892,72300,Bronx,4416473.06,Tremont
19-Jul,36005039500,2039500,10488,135851,146339,Bronx,4416473.06,Tremont
21-Jul,36005039500,2039500,0,47942,47942,Bronx,4416473.06,Tremont
19-Aug,36005039500,2039500,8742,81946,90688,Bronx,4416473.06,Tremont
21-Aug,36005039500,2039500,4011,72335,76346,Bronx,4416473.06,Tremont
19-May,36005028300,2028300,5277,71,5348,Bronx,2465441.355,Kingsbridge-Marble Hill
21-May,36005028300,2028300,10822,52538,63360,Bronx,2465441.355,Kingsbridge-Marble Hill
19-Jun,36005028300,2028300,10398,62223,72621,Bronx,2465441.355,Kingsbridge-Marble Hill
21-Jun,36005028300,2028300,5822,71,5893,Bronx,2465441.355,Kingsbridge-Marble Hill
19-Jul,36005028300,2028300,5123,53272,58395,Bronx,2465441.355,Kingsbridge-Marble Hill
21-Jul,36005028300,2028300,12798,81119,93917,Bronx,2465441.355,Kingsbridge-Marble Hill
19-Aug,36005028300,2028300,9957,135894,145851,Bronx,2465441.355,Kingsbridge-Marble Hill
21-Aug,36005028300,2028300,7336,75224,82560,Bronx,2465441.355,Kingsbridge-Marble Hill
19-May,36005028500,2028500,10039,71004,81043,Bronx,2824771.022,Kingsbridge-Marble Hill
21-May,36005028500,2028500,13496,83748,97244,Bronx,2824771.022,Kingsbridge-Marble Hill
19-Jun,36005028500,2028500,17327,43003,60330,Bronx,2824771.022,Kingsbridge-Marble Hill
21-Jun,36005028500,2028500,9921,53960,63881,Bronx,2824771.022,Kingsbridge-Marble Hill
19-Jul,36005028500,2028500,11711,23468,35179,Bronx,2824771.022,Kingsbridge-Marble Hill
21-Jul,36005028500,2028500,7673,62513,70186,Bronx,2824771.022,Kingsbridge-Marble Hill
19-Aug,36005028500,2028500,3616,96771,100387,Bronx,2824771.022,Kingsbridge-Marble Hill
21-Aug,36005028500,2028500,1649,130846,132495,Bronx,2824771.022,Kingsbridge-Marble Hill
19-May,36061006600,1006600,2438,44960,47398,Manhattan,1880521.001,Murray Hill-Kips Bay
21-May,36061006600,1006600,6104,47163,53267,Manhattan,1880521.001,Murray Hill-Kips Bay
19-Jun,36061006600,1006600,13289,106714,120003,Manhattan,1880521.001,Murray Hill-Kips Bay
21-Jun,36061006600,1006600,9615,61464,71079,Manhattan,1880521.001,Murray Hill-Kips Bay
19-Jul,36061006600,1006600,451,91704,92155,Manhattan,1880521.001,Murray Hill-Kips Bay
21-Jul,36061006600,1006600,12993,82685,95678,Manhattan,1880521.001,Murray Hill-Kips Bay
19-Aug,36061006600,1006600,7320,96237,103557,Manhattan,1880521.001,Murray Hill-Kips Bay
21-Aug,36061006600,1006600,6928,95493,102421,Manhattan,1880521.001,Murray Hill-Kips Bay
19-May,36061005600,1005600,7608,57860,65468,Manhattan,1878253.49,Midtown South-Flatiron-Union Square
21-May,36061005600,1005600,0,99614,99614,Manhattan,1878253.49,Midtown South-Flatiron-Union Square
19-Jun,36061005600,1005600,3051,123549,126600,Manhattan,1878253.49,Midtown South-Flatiron-Union Square
21-Jun,36061005600,1005600,2140,38215,40355,Manhattan,1878253.49,Midtown South-Flatiron-Union Square
19-Jul,36061005600,1005600,19226,67647,86873,Manhattan,1878253.49,Midtown South-Flatiron-Union Square
21-Jul,36061005600,1005600,10607,97753,108360,Manhattan,1878253.49,Midtown South-Flatiron-Union Square
19-Aug,36061005600,1005600,4138,72447,76585,Manhattan,1878253.49,Midtown South-Flatiron-Union Square
21-Aug,36061005600,1005600,1373,71,1444,Manhattan,1878253.49,Midtown South-Flatiron-Union Square
19-May,36061007400,1007400,12944,83633,96577,Manhattan,1879420.449,Midtown South-Flatiron-Union Square
21-May,36061007400,1007400,8146,85594,93740,Manhattan,1879420.449,Midtown South-Flatiron-Union Square
19-Jun,36061007400,1007400,6605,2957,9562,Manhattan,1879420.449,Midtown South-Flatiron-Union Square
21-Jun,36061007400,1007400,9292,72766,82058,Manhattan,1879420.449,Midtown South-Flatiron-Union Square
19-Jul,36061007400,1007400,5020,88495,93515,Manhattan,1879420.449,Midtown South-Flatiron-Union Square
21-Jul,36061007400,1007400,10128,729,10857,Manhattan,1879420.449,Midtown South-Flatiron-Union Square
19-Aug,36061007400,1007400,6589,74981,81570,Manhattan,1879420.449,Midtown South-Flatiron-Union Square
21-Aug,36061007400,1007400,0,34268,34268,Manhattan,1879420.449,Midtown South-Flatiron-Union Square
19-May,36081009100,4009100,7741,76322,84063,Queens,2008480.751,Old Astoria-Hallets Point
21-May,36081009100,4009100,4169,107538,111707,Queens,2008480.751,Old Astoria-Hallets Point
19-Jun,36081009100,4009100,12756,140250,153006,Queens,2008480.751,Old Astoria-Hallets Point
21-Jun,36081009100,4009100,12710,143914,156624,Queens,2008480.751,Old Astoria-Hallets Point
19-Jul,36081009100,4009100,7427,75207,82634,Queens,2008480.751,Old Astoria-Hallets Point
21-Jul,36081009100,4009100,4707,49840,54547,Queens,2008480.751,Old Astoria-Hallets Point
19-Aug,36081009100,4009100,0,66812,66812,Queens,2008480.751,Old Astoria-Hallets Point
21-Aug,36081009100,4009100,14087,97649,111736,Queens,2008480.751,Old Astoria-Hallets Point
19-May,36061015200,1015200,0,83862,83862,Manhattan,1963680.638,Upper East Side-Yorkville
21-May,36061015200,1015200,864,56107,56971,Manhattan,1963680.638,Upper East Side-Yorkville
19-Jun,36061015200,1015200,6482,44874,51356,Manhattan,1963680.638,Upper East Side-Yorkville
21-Jun,36061015200,1015200,12857,96588,109445,Manhattan,1963680.638,Upper East Side-Yorkville
19-Jul,36061015200,1015200,15634,31371,47005,Manhattan,1963680.638,Upper East Side-Yorkville
21-Jul,36061015200,1015200,6962,90266,97228,Manhattan,1963680.638,Upper East Side-Yorkville
19-Aug,36061015200,1015200,4980,113843,118823,Manhattan,1963680.638,Upper East Side-Yorkville
21-Aug,36061015200,1015200,12760,107611,120371,Manhattan,1963680.638,Upper East Side-Yorkville
19-May,36081033100,4033100,11855,86612,98467,Queens,30591952.27,LaGuardia Airport
21-May,36081033100,4033100,0,132793,132793,Queens,30591952.27,LaGuardia Airport
19-Jun,36081033100,4033100,19551,102767,122318,Queens,30591952.27,LaGuardia Airport
21-Jun,36081033100,4033100,12313,92036,104349,Queens,30591952.27,LaGuardia Airport
19-Jul,36081033100,4033100,8344,71518,79862,Queens,30591952.27,LaGuardia Airport
21-Jul,36081033100,4033100,5027,82773,87800,Queens,30591952.27,LaGuardia Airport
19-Aug,36081033100,4033100,4636,93526,98162,Queens,30591952.27,LaGuardia Airport
21-Aug,36081033100,4033100,2505,161468,163973,Queens,30591952.27,LaGuardia Airport
19-May,36081076901,4076901,11339,83428,94767,Queens,1938313.901,Forest Hills
21-May,36081076901,4076901,12736,85783,98519,Queens,1938313.901,Forest Hills
19-Jun,36081076901,4076901,9447,106562,116009,Queens,1938313.901,Forest Hills
21-Jun,36081076901,4076901,5472,95938,101410,Queens,1938313.901,Forest Hills
19-Jul,36081076901,4076901,9730,33514,43244,Queens,1938313.901,Forest Hills
21-Jul,36081076901,4076901,6058,106525,112583,Queens,1938313.901,Forest Hills
19-Aug,36081076901,4076901,18576,6322,24898,Queens,1938313.901,Forest Hills
21-Aug,36081076901,4076901,11683,113994,125677,Queens,1938313.901,Forest Hills
19-May,36081076902,4076902,3519,120145,123664,Queens,1097828.741,Forest Hills
21-May,36081076902,4076902,377,65431,65808,Queens,1097828.741,Forest Hills
19-Jun,36081076902,4076902,15451,133628,149079,Queens,1097828.741,Forest Hills
21-Jun,36081076902,4076902,11882,105293,117175,Queens,1097828.741,Forest Hills
19-Jul,36081076902,4076902,3709,71,3780,Queens,1097828.741,Forest Hills
21-Jul,36081076902,4076902,9219,112071,121290,Queens,1097828.741,Forest Hills
19-Aug,36081076902,4076902,8897,50161,59058,Queens,1097828.741,Forest Hills
21-Aug,36081076902,4076902,3345,39629,42974,Queens,1097828.741,Forest Hills
19-May,36081029900,4029900,8427,67287,75714,Queens,4388717.373,St. Michael's Cemetery
21-May,36081029900,4029900,6038,39303,45341,Queens,4388717.373,St. Michael's Cemetery
19-Jun,36081029900,4029900,2905,120866,123771,Queens,4388717.373,St. Michael's Cemetery
21-Jun,36081029900,4029900,6296,152460,158756,Queens,4388717.373,St. Michael's Cemetery
19-Jul,36081029900,4029900,10179,84206,94385,Queens,4388717.373,St. Michael's Cemetery
21-Jul,36081029900,4029900,0,91803,91803,Queens,4388717.373,St. Michael's Cemetery
19-Aug,36081029900,4029900,15080,52120,67200,Queens,4388717.373,St. Michael's Cemetery
21-Aug,36081029900,4029900,9789,125451,135240,Queens,4388717.373,St. Michael's Cemetery
19-May,36081031700,4031700,3495,47432,50927,Queens,8247619.119,Astoria (North)-Ditmars-Steinway
21-May,36081031700,4031700,3259,8781,12040,Queens,8247619.119,Astoria (North)-Ditmars-Steinway
19-Jun,36081031700,4031700,13153,62843,75996,Queens,8247619.119,Astoria (North)-Ditmars-Steinway
21-Jun,36081031700,4031700,3686,68555,72241,Queens,8247619.119,Astoria (North)-Ditmars-Steinway
19-Jul,36081031700,4031700,2999,80386,83385,Queens,8247619.119,Astoria (North)-Ditmars-Steinway
21-Jul,36081031700,4031700,2126,36209,38335,Queens,8247619.119,Astoria (North)-Ditmars-Steinway
19-Aug,36081031700,4031700,4451,45162,49613,Queens,8247619.119,Astoria (North)-Ditmars-Steinway
21-Aug,36081031700,4031700,10937,46640,57577,Queens,8247619.119,Astoria (North)-Ditmars-Steinway
19-May,36061002500,1002500,12400,19837,32237,Manhattan,1408269.914,Chinatown-Two Bridges
21-May,36061002500,1002500,5562,141033,146595,Manhattan,1408269.914,Chinatown-Two Bridges
19-Jun,36061002500,1002500,5992,79655,85647,Manhattan,1408269.914,Chinatown-Two Bridges
21-Jun,36061002500,1002500,15060,76888,91948,Manhattan,1408269.914,Chinatown-Two Bridges
19-Jul,36061002500,1002500,9527,11309,20836,Manhattan,1408269.914,Chinatown-Two Bridges
21-Jul,36061002500,1002500,15719,83377,99096,Manhattan,1408269.914,Chinatown-Two Bridges
19-Aug,36061002500,1002500,11592,71,11663,Manhattan,1408269.914,Chinatown-Two Bridges
21-Aug,36061002500,1002500,5872,118736,124608,Manhattan,1408269.914,Chinatown-Two Bridges
19-May,36005027401,2027401,3569,43494,47063,Bronx,7554415.665,Pelham Bay-Country Club-City Island
21-May,36005027401,2027401,2939,135730,138669,Bronx,7554415.665,Pelham Bay-Country Club-City Island
19-Jun,36005027401,2027401,8563,36694,45257,Bronx,7554415.665,Pelham Bay-Country Club-City Island
21-Jun,36005027401,2027401,6720,141756,148476,Bronx,7554415.665,Pelham Bay-Country Club-City Island
19-Jul,36005027401,2027401,6998,61616,68614,Bronx,7554415.665,Pelham Bay-Country Club-City Island
21-Jul,36005027401,2027401,10571,2344,12915,Bronx,7554415.665,Pelham Bay-Country Club-City Island
19-Aug,36005027401,2027401,12616,73177,85793,Bronx,7554415.665,Pelham Bay-Country Club-City Island
21-Aug,36005027401,2027401,16337,29685,46022,Bronx,7554415.665,Pelham Bay-Country Club-City Island
19-May,36005027402,2027402,13849,62366,76215,Bronx,5709854.359,Pelham Bay-Country Club-City Island
21-May,36005027402,2027402,10720,60186,70906,Bronx,5709854.359,Pelham Bay-Country Club-City Island
19-Jun,36005027402,2027402,886,38552,39438,Bronx,5709854.359,Pelham Bay-Country Club-City Island
21-Jun,36005027402,2027402,15091,27455,42546,Bronx,5709854.359,Pelham Bay-Country Club-City Island
19-Jul,36005027402,2027402,2430,85733,88163,Bronx,5709854.359,Pelham Bay-Country Club-City Island
21-Jul,36005027402,2027402,13830,130275,144105,Bronx,5709854.359,Pelham Bay-Country Club-City Island
19-Aug,36005027402,2027402,8970,70835,79805,Bronx,5709854.359,Pelham Bay-Country Club-City Island
21-Aug,36005027402,2027402,6126,88439,94565,Bronx,5709854.359,Pelham Bay-Country Club-City Island
19-May,36081071306,4071306,11318,44040,55358,Queens,1953708.862,Forest Hills
21-May,36081071306,4071306,6714,56396,63110,Queens,1953708.862,Forest Hills
19-Jun,36081071306,4071306,6613,19928,26541,Queens,1953708.862,Forest Hills
21-Jun,36081071306,4071306,15577,60466,76043,Queens,1953708.862,Forest Hills
19-Jul,36081071306,4071306,0,98770,98770,Queens,1953708.862,Forest Hills
21-Jul,36081071306,4071306,6844,55455,62299,Queens,1953708.862,Forest Hills
19-Aug,36081071306,4071306,12499,48358,60857,Queens,1953708.862,Forest Hills
21-Aug,36081071306,4071306,12696,122065,134761,Queens,1953708.862,Forest Hills
19-May,36061016700,1016700,11114,12012,23126,Manhattan,2195045.978,Upper West Side (Central)
21-May,36061016700,1016700,8699,54589,63288,Manhattan,2195045.978,Upper West Side (Central)
19-Jun,36061016700,1016700,0,77227,77227,Manhattan,2195045.978,Upper West Side (Central)
21-Jun,36061016700,1016700,11186,47099,58285,Manhattan,2195045.978,Upper West Side (Central)
19-Jul,36061016700,1016700,8436,50974,59410,Manhattan,2195045.978,Upper West Side (Central)
21-Jul,36061016700,1016700,8014,52269,60283,Manhattan,2195045.978,Upper West Side (Central)
19-Aug,36061016700,1016700,12765,67255,80020,Manhattan,2195045.978,Upper West Side (Central)
21-Aug,36061016700,1016700,6624,44691,51315,Manhattan,2195045.978,Upper West Side (Central)
19-May,36081000104,4000104,9839,32195,42034,Queens,5978794.113,Long Island City-Hunters Point
21-May,36081000104,4000104,0,118490,118490,Queens,5978794.113,Long Island City-Hunters Point
19-Jun,36081000104,4000104,7306,105062,112368,Queens,5978794.113,Long Island City-Hunters Point
21-Jun,36081000104,4000104,4837,35410,40247,Queens,5978794.113,Long Island City-Hunters Point
19-Jul,36081000104,4000104,9736,95719,105455,Queens,5978794.113,Long Island City-Hunters Point
21-Jul,36081000104,4000104,11018,116422,127440,Queens,5978794.113,Long Island City-Hunters Point
19-Aug,36081000104,4000104,6584,113239,119823,Queens,5978794.113,Long Island City-Hunters Point
21-Aug,36081000104,4000104,9148,69038,78186,Queens,5978794.113,Long Island City-Hunters Point
19-May,36081129103,4129103,8785,125645,134430,Queens,4939340.702,Oakland Gardens-Hollis Hills
21-May,36081129103,4129103,3328,144113,147441,Queens,4939340.702,Oakland Gardens-Hollis Hills
19-Jun,36081129103,4129103,3268,35707,38975,Queens,4939340.702,Oakland Gardens-Hollis Hills
21-Jun,36081129103,4129103,14196,46029,60225,Queens,4939340.702,Oakland Gardens-Hollis Hills
19-Jul,36081129103,4129103,3356,72854,76210,Queens,4939340.702,Oakland Gardens-Hollis Hills
21-Jul,36081129103,4129103,4880,95657,100537,Queens,4939340.702,Oakland Gardens-Hollis Hills
19-Aug,36081129103,4129103,8259,50686,58945,Queens,4939340.702,Oakland Gardens-Hollis Hills
21-Aug,36081129103,4129103,4754,88700,93454,Queens,4939340.702,Oakland Gardens-Hollis Hills
19-May,36061023300,1023300,6604,71,6675,Manhattan,2507139.112,Hamilton Heights-Sugar Hill
21-May,36061023300,1023300,6229,111857,118086,Manhattan,2507139.112,Hamilton Heights-Sugar Hill
19-Jun,36061023300,1023300,9313,71,9384,Manhattan,2507139.112,Hamilton Heights-Sugar Hill
21-Jun,36061023300,1023300,5238,110838,116076,Manhattan,2507139.112,Hamilton Heights-Sugar Hill
19-Jul,36061023300,1023300,10681,56819,67500,Manhattan,2507139.112,Hamilton Heights-Sugar Hill
21-Jul,36061023300,1023300,0,67768,67768,Manhattan,2507139.112,Hamilton Heights-Sugar Hill
19-Aug,36061023300,1023300,4032,95392,99424,Manhattan,2507139.112,Hamilton Heights-Sugar Hill
21-Aug,36061023300,1023300,10732,37904,48636,Manhattan,2507139.112,Hamilton Heights-Sugar Hill
19-May,36061023700,1023700,6952,48399,55351,Manhattan,2896787.353,Hamilton Heights-Sugar Hill
21-May,36061023700,1023700,9411,76079,85490,Manhattan,2896787.353,Hamilton Heights-Sugar Hill
19-Jun,36061023700,1023700,10268,66225,76493,Manhattan,2896787.353,Hamilton Heights-Sugar Hill
21-Jun,36061023700,1023700,12877,78056,90933,Manhattan,2896787.353,Hamilton Heights-Sugar Hill
19-Jul,36061023700,1023700,5126,61333,66459,Manhattan,2896787.353,Hamilton Heights-Sugar Hill
21-Jul,36061023700,1023700,6954,24207,31161,Manhattan,2896787.353,Hamilton Heights-Sugar Hill
19-Aug,36061023700,1023700,7028,80864,87892,Manhattan,2896787.353,Hamilton Heights-Sugar Hill
21-Aug,36061023700,1023700,12722,26322,39044,Manhattan,2896787.353,Hamilton Heights-Sugar Hill
19-May,36005041400,2041400,10601,53530,64131,Bronx,5946470.202,Wakefield-Woodlawn
21-May,36005041400,2041400,17460,23296,40756,Bronx,5946470.202,Wakefield-Woodlawn
19-Jun,36005041400,2041400,12922,39122,52044,Bronx,5946470.202,Wakefield-Woodlawn
21-Jun,36005041400,2041400,3652,117372,121024,Bronx,5946470.202,Wakefield-Woodlawn
19-Jul,36005041400,2041400,10638,64648,75286,Bronx,5946470.202,Wakefield-Woodlawn
21-Jul,36005041400,2041400,11971,76816,88787,Bronx,5946470.202,Wakefield-Woodlawn
19-Aug,36005041400,2041400,7424,62271,69695,Bronx,5946470.202,Wakefield-Woodlawn
21-Aug,36005041400,2041400,9679,57031,66710,Bronx,5946470.202,Wakefield-Woodlawn
19-May,36005041800,2041800,10616,92730,103346,Bronx,2930549.099,Wakefield-Woodlawn
21-May,36005041800,2041800,4990,195155,200145,Bronx,2930549.099,Wakefield-Woodlawn
19-Jun,36005041800,2041800,7303,99337,106640,Bronx,2930549.099,Wakefield-Woodlawn
21-Jun,36005041800,2041800,6932,36065,42997,Bronx,2930549.099,Wakefield-Woodlawn
19-Jul,36005041800,2041800,13516,66348,79864,Bronx,2930549.099,Wakefield-Woodlawn
21-Jul,36005041800,2041800,15221,89217,104438,Bronx,2930549.099,Wakefield-Woodlawn
19-Aug,36005041800,2041800,518,19618,20136,Bronx,2930549.099,Wakefield-Woodlawn
21-Aug,36005041800,2041800,5981,49268,55249,Bronx,2930549.099,Wakefield-Woodlawn
19-May,36081053501,4053501,8702,58725,67427,Queens,1916282.662,Maspeth
21-May,36081053501,4053501,8141,95967,104108,Queens,1916282.662,Maspeth
19-Jun,36081053501,4053501,10962,124006,134968,Queens,1916282.662,Maspeth
21-Jun,36081053501,4053501,7822,109108,116930,Queens,1916282.662,Maspeth
19-Jul,36081053501,4053501,9268,21673,30941,Queens,1916282.662,Maspeth
21-Jul,36081053501,4053501,13264,113378,126642,Queens,1916282.662,Maspeth
19-Aug,36081053501,4053501,9739,91747,101486,Queens,1916282.662,Maspeth
21-Aug,36081053501,4053501,7658,17797,25455,Queens,1916282.662,Maspeth
19-May,36081052500,4052500,12560,127710,140270,Queens,2175165.059,Maspeth
21-May,36081052500,4052500,3717,68951,72668,Queens,2175165.059,Maspeth
19-Jun,36081052500,4052500,7733,29105,36838,Queens,2175165.059,Maspeth
21-Jun,36081052500,4052500,12819,80189,93008,Queens,2175165.059,Maspeth
19-Jul,36081052500,4052500,12014,123815,135829,Queens,2175165.059,Maspeth
21-Jul,36081052500,4052500,12835,64984,77819,Queens,2175165.059,Maspeth
19-Aug,36081052500,4052500,12871,60722,73593,Queens,2175165.059,Maspeth
21-Aug,36081052500,4052500,15699,77757,93456,Queens,2175165.059,Maspeth
19-May,36081059502,4059502,12431,60421,72852,Queens,2487250.121,Maspeth
21-May,36081059502,4059502,11327,154386,165713,Queens,2487250.121,Maspeth
19-Jun,36081059502,4059502,16247,66086,82333,Queens,2487250.121,Maspeth
21-Jun,36081059502,4059502,7111,115807,122918,Queens,2487250.121,Maspeth
19-Jul,36081059502,4059502,3920,91253,95173,Queens,2487250.121,Maspeth
21-Jul,36081059502,4059502,11414,137052,148466,Queens,2487250.121,Maspeth
19-Aug,36081059502,4059502,12852,150188,163040,Queens,2487250.121,Maspeth
21-Aug,36081059502,4059502,1588,103008,104596,Queens,2487250.121,Maspeth
19-May,36005016500,2016500,6684,67431,74115,Bronx,2083442.162,Claremont Village-Claremont (East)
21-May,36005016500,2016500,10183,56380,66563,Bronx,2083442.162,Claremont Village-Claremont (East)
19-Jun,36005016500,2016500,8145,84076,92221,Bronx,2083442.162,Claremont Village-Claremont (East)
21-Jun,36005016500,2016500,4200,122770,126970,Bronx,2083442.162,Claremont Village-Claremont (East)
19-Jul,36005016500,2016500,8075,65815,73890,Bronx,2083442.162,Claremont Village-Claremont (East)
21-Jul,36005016500,2016500,12506,28190,40696,Bronx,2083442.162,Claremont Village-Claremont (East)
19-Aug,36005016500,2016500,4988,71,5059,Bronx,2083442.162,Claremont Village-Claremont (East)
21-Aug,36005016500,2016500,18496,82210,100706,Bronx,2083442.162,Claremont Village-Claremont (East)
19-May,36005016700,2016700,8575,69975,78550,Bronx,2217493.495,Claremont Village-Claremont (East)
21-May,36005016700,2016700,12921,108553,121474,Bronx,2217493.495,Claremont Village-Claremont (East)
19-Jun,36005016700,2016700,12978,54664,67642,Bronx,2217493.495,Claremont Village-Claremont (East)
21-Jun,36005016700,2016700,4288,125096,129384,Bronx,2217493.495,Claremont Village-Claremont (East)
19-Jul,36005016700,2016700,11025,87081,98106,Bronx,2217493.495,Claremont Village-Claremont (East)
21-Jul,36005016700,2016700,11397,67863,79260,Bronx,2217493.495,Claremont Village-Claremont (East)
19-Aug,36005016700,2016700,3679,80927,84606,Bronx,2217493.495,Claremont Village-Claremont (East)
21-Aug,36005016700,2016700,11773,96964,108737,Bronx,2217493.495,Claremont Village-Claremont (East)
19-May,36081002500,4002500,5118,78772,83890,Queens,2266376.455,Queensbridge-Ravenswood-Dutch Kills
21-May,36081002500,4002500,2555,71,2626,Queens,2266376.455,Queensbridge-Ravenswood-Dutch Kills
19-Jun,36081002500,4002500,4539,51808,56347,Queens,2266376.455,Queensbridge-Ravenswood-Dutch Kills
21-Jun,36081002500,4002500,490,50123,50613,Queens,2266376.455,Queensbridge-Ravenswood-Dutch Kills
19-Jul,36081002500,4002500,5178,109676,114854,Queens,2266376.455,Queensbridge-Ravenswood-Dutch Kills
21-Jul,36081002500,4002500,6609,69141,75750,Queens,2266376.455,Queensbridge-Ravenswood-Dutch Kills
19-Aug,36081002500,4002500,9501,109064,118565,Queens,2266376.455,Queensbridge-Ravenswood-Dutch Kills
21-Aug,36081002500,4002500,8074,28929,37003,Queens,2266376.455,Queensbridge-Ravenswood-Dutch Kills
19-May,36061021400,1021400,15556,56326,71882,Manhattan,1453439.916,Harlem (North)
21-May,36061021400,1021400,11243,7788,19031,Manhattan,1453439.916,Harlem (North)
19-Jun,36061021400,1021400,5454,72994,78448,Manhattan,1453439.916,Harlem (North)
21-Jun,36061021400,1021400,4231,69597,73828,Manhattan,1453439.916,Harlem (North)
19-Jul,36061021400,1021400,9443,105104,114547,Manhattan,1453439.916,Harlem (North)
21-Jul,36061021400,1021400,9130,39687,48817,Manhattan,1453439.916,Harlem (North)
19-Aug,36061021400,1021400,3367,4608,7975,Manhattan,1453439.916,Harlem (North)
21-Aug,36061021400,1021400,6002,115356,121358,Manhattan,1453439.916,Harlem (North)
19-May,36005041100,2041100,7321,71,7392,Bronx,1309721.189,Bedford Park
21-May,36005041100,2041100,3377,142284,145661,Bronx,1309721.189,Bedford Park
19-Jun,36005041100,2041100,8089,85654,93743,Bronx,1309721.189,Bedford Park
21-Jun,36005041100,2041100,937,18084,19021,Bronx,1309721.189,Bedford Park
19-Jul,36005041100,2041100,9980,105662,115642,Bronx,1309721.189,Bedford Park
21-Jul,36005041100,2041100,3067,104608,107675,Bronx,1309721.189,Bedford Park
19-Aug,36005041100,2041100,10380,12567,22947,Bronx,1309721.189,Bedford Park
21-Aug,36005041100,2041100,5520,2158,7678,Bronx,1309721.189,Bedford Park
19-May,36005041300,2041300,14815,81689,96504,Bronx,1865498.642,Bedford Park
21-May,36005041300,2041300,13819,63555,77374,Bronx,1865498.642,Bedford Park
19-Jun,36005041300,2041300,18398,30910,49308,Bronx,1865498.642,Bedford Park
21-Jun,36005041300,2041300,10860,150048,160908,Bronx,1865498.642,Bedford Park
19-Jul,36005041300,2041300,0,107097,107097,Bronx,1865498.642,Bedford Park
21-Jul,36005041300,2041300,4198,44832,49030,Bronx,1865498.642,Bedford Park
19-Aug,36005041300,2041300,8503,84022,92525,Bronx,1865498.642,Bedford Park
21-Aug,36005041300,2041300,8888,150642,159530,Bronx,1865498.642,Bedford Park
19-May,36005030202,2030202,9870,78215,88085,Bronx,3349142.36,Co-op City
21-May,36005030202,2030202,4449,81719,86168,Bronx,3349142.36,Co-op City
19-Jun,36005030202,2030202,7731,32312,40043,Bronx,3349142.36,Co-op City
21-Jun,36005030202,2030202,9893,9775,19668,Bronx,3349142.36,Co-op City
19-Jul,36005030202,2030202,9805,113374,123179,Bronx,3349142.36,Co-op City
21-Jul,36005030202,2030202,10043,99103,109146,Bronx,3349142.36,Co-op City
19-Aug,36005030202,2030202,1637,84932,86569,Bronx,3349142.36,Co-op City
21-Aug,36005030202,2030202,5048,83376,88424,Bronx,3349142.36,Co-op City
19-May,36005046205,2046205,13180,97692,110872,Bronx,9427018.634,Co-op City
21-May,36005046205,2046205,1871,121847,123718,Bronx,9427018.634,Co-op City
19-Jun,36005046205,2046205,12929,94861,107790,Bronx,9427018.634,Co-op City
21-Jun,36005046205,2046205,2964,24419,27383,Bronx,9427018.634,Co-op City
19-Jul,36005046205,2046205,6003,110651,116654,Bronx,9427018.634,Co-op City
21-Jul,36005046205,2046205,8958,60277,69235,Bronx,9427018.634,Co-op City
19-Aug,36005046205,2046205,8634,11458,20092,Bronx,9427018.634,Co-op City
21-Aug,36005046205,2046205,5924,60148,66072,Bronx,9427018.634,Co-op City
19-May,36081157101,4157101,13511,64415,77926,Queens,13186425.49,Bellerose
21-May,36081157101,4157101,17451,161567,179018,Queens,13186425.49,Bellerose
19-Jun,36081157101,4157101,15384,60360,75744,Queens,13186425.49,Bellerose
21-Jun,36081157101,4157101,9114,76558,85672,Queens,13186425.49,Bellerose
19-Jul,36081157101,4157101,54,99604,99658,Queens,13186425.49,Bellerose
21-Jul,36081157101,4157101,3975,49692,53667,Queens,13186425.49,Bellerose
19-Aug,36081157101,4157101,2841,79459,82300,Queens,13186425.49,Bellerose
21-Aug,36081157101,4157101,4505,37835,42340,Queens,13186425.49,Bellerose
19-May,36081157102,4157102,15500,158647,174147,Queens,3458891.85,Bellerose
21-May,36081157102,4157102,8817,106046,114863,Queens,3458891.85,Bellerose
19-Jun,36081157102,4157102,11487,33815,45302,Queens,3458891.85,Bellerose
21-Jun,36081157102,4157102,19785,30540,50325,Queens,3458891.85,Bellerose
19-Jul,36081157102,4157102,11116,49974,61090,Queens,3458891.85,Bellerose
21-Jul,36081157102,4157102,9605,76650,86255,Queens,3458891.85,Bellerose
19-Aug,36081157102,4157102,14236,100489,114725,Queens,3458891.85,Bellerose
21-Aug,36081157102,4157102,13157,76812,89969,Queens,3458891.85,Bellerose
19-May,36005043501,2043501,5041,41830,46871,Bronx,4259155.928,Williamsbridge-Olinville
21-May,36005043501,2043501,7183,82061,89244,Bronx,4259155.928,Williamsbridge-Olinville
19-Jun,36005043501,2043501,6774,88981,95755,Bronx,4259155.928,Williamsbridge-Olinville
21-Jun,36005043501,2043501,7906,62230,70136,Bronx,4259155.928,Williamsbridge-Olinville
19-Jul,36005043501,2043501,11405,63112,74517,Bronx,4259155.928,Williamsbridge-Olinville
21-Jul,36005043501,2043501,526,12484,13010,Bronx,4259155.928,Williamsbridge-Olinville
19-Aug,36005043501,2043501,1734,24879,26613,Bronx,4259155.928,Williamsbridge-Olinville
21-Aug,36005043501,2043501,4401,126113,130514,Bronx,4259155.928,Williamsbridge-Olinville
19-May,36005045101,2045101,6890,55804,62694,Bronx,1877554.835,Wakefield-Woodlawn
21-May,36005045101,2045101,8712,56132,64844,Bronx,1877554.835,Wakefield-Woodlawn
19-Jun,36005045101,2045101,14657,160586,175243,Bronx,1877554.835,Wakefield-Woodlawn
21-Jun,36005045101,2045101,1381,69946,71327,Bronx,1877554.835,Wakefield-Woodlawn
19-Jul,36005045101,2045101,7695,5018,12713,Bronx,1877554.835,Wakefield-Woodlawn
21-Jul,36005045101,2045101,5653,36755,42408,Bronx,1877554.835,Wakefield-Woodlawn
19-Aug,36005045101,2045101,12384,39604,51988,Bronx,1877554.835,Wakefield-Woodlawn
21-Aug,36005045101,2045101,8123,76649,84772,Bronx,1877554.835,Wakefield-Woodlawn
19-May,36081000701,4000701,12189,70668,82857,Queens,2590006.989,Long Island City-Hunters Point
21-May,36081000701,4000701,3080,74976,78056,Queens,2590006.989,Long Island City-Hunters Point
19-Jun,36081000701,4000701,14370,25301,39671,Queens,2590006.989,Long Island City-Hunters Point
21-Jun,36081000701,4000701,10220,25427,35647,Queens,2590006.989,Long Island City-Hunters Point
19-Jul,36081000701,4000701,1289,16752,18041,Queens,2590006.989,Long Island City-Hunters Point
21-Jul,36081000701,4000701,17644,115302,132946,Queens,2590006.989,Long Island City-Hunters Point
19-Aug,36081000701,4000701,8441,56923,65364,Queens,2590006.989,Long Island City-Hunters Point
21-Aug,36081000701,4000701,5923,69620,75543,Queens,2590006.989,Long Island City-Hunters Point
19-May,36081001901,4001901,14383,82693,97076,Queens,2470533.583,Long Island City-Hunters Point
21-May,36081001901,4001901,14348,83081,97429,Queens,2470533.583,Long Island City-Hunters Point
19-Jun,36081001901,4001901,7381,65240,72621,Queens,2470533.583,Long Island City-Hunters Point
21-Jun,36081001901,4001901,5397,65817,71214,Queens,2470533.583,Long Island City-Hunters Point
19-Jul,36081001901,4001901,6975,27562,34537,Queens,2470533.583,Long Island City-Hunters Point
21-Jul,36081001901,4001901,9332,27505,36837,Queens,2470533.583,Long Island City-Hunters Point
19-Aug,36081001901,4001901,10397,50995,61392,Queens,2470533.583,Long Island City-Hunters Point
21-Aug,36081001901,4001901,9066,6852,15918,Queens,2470533.583,Long Island City-Hunters Point
19-May,36061012902,1012902,9024,109184,118208,Manhattan,2063182.36,Hell's Kitchen
21-May,36061012902,1012902,3666,36202,39868,Manhattan,2063182.36,Hell's Kitchen
19-Jun,36061012902,1012902,9549,95653,105202,Manhattan,2063182.36,Hell's Kitchen
21-Jun,36061012902,1012902,5645,17875,23520,Manhattan,2063182.36,Hell's Kitchen
19-Jul,36061012902,1012902,10434,55690,66124,Manhattan,2063182.36,Hell's Kitchen
21-Jul,36061012902,1012902,4988,87305,92293,Manhattan,2063182.36,Hell's Kitchen
19-Aug,36061012902,1012902,6752,92895,99647,Manhattan,2063182.36,Hell's Kitchen
21-Aug,36061012902,1012902,10605,74657,85262,Manhattan,2063182.36,Hell's Kitchen
19-May,36061013501,1013501,7443,63065,70508,Manhattan,2175808.697,Hell's Kitchen
21-May,36061013501,1013501,4977,50730,55707,Manhattan,2175808.697,Hell's Kitchen
19-Jun,36061013501,1013501,4141,72857,76998,Manhattan,2175808.697,Hell's Kitchen
21-Jun,36061013501,1013501,5996,51026,57022,Manhattan,2175808.697,Hell's Kitchen
19-Jul,36061013501,1013501,12919,55272,68191,Manhattan,2175808.697,Hell's Kitchen
21-Jul,36061013501,1013501,5796,124555,130351,Manhattan,2175808.697,Hell's Kitchen
19-Aug,36061013501,1013501,6551,57946,64497,Manhattan,2175808.697,Hell's Kitchen
21-Aug,36061013501,1013501,1786,140132,141918,Manhattan,2175808.697,Hell's Kitchen
19-May,36061013502,1013502,13428,32891,46319,Manhattan,2326895.589,Hell's Kitchen
21-May,36061013502,1013502,1825,80966,82791,Manhattan,2326895.589,Hell's Kitchen
19-Jun,36061013502,1013502,6099,58183,64282,Manhattan,2326895.589,Hell's Kitchen
21-Jun,36061013502,1013502,2761,128752,131513,Manhattan,2326895.589,Hell's Kitchen
19-Jul,36061013502,1013502,4581,44013,48594,Manhattan,2326895.589,Hell's Kitchen
21-Jul,36061013502,1013502,5780,144008,149788,Manhattan,2326895.589,Hell's Kitchen
19-Aug,36061013502,1013502,10197,71,10268,Manhattan,2326895.589,Hell's Kitchen
21-Aug,36061013502,1013502,7653,119726,127379,Manhattan,2326895.589,Hell's Kitchen
19-May,36005014500,2014500,13386,57878,71264,Bronx,1958133.393,Claremont Village-Claremont (East)
21-May,36005014500,2014500,6902,90367,97269,Bronx,1958133.393,Claremont Village-Claremont (East)
19-Jun,36005014500,2014500,112,112167,112279,Bronx,1958133.393,Claremont Village-Claremont (East)
21-Jun,36005014500,2014500,7345,138635,145980,Bronx,1958133.393,Claremont Village-Claremont (East)
19-Jul,36005014500,2014500,1426,99811,101237,Bronx,1958133.393,Claremont Village-Claremont (East)
21-Jul,36005014500,2014500,12274,76186,88460,Bronx,1958133.393,Claremont Village-Claremont (East)
19-Aug,36005014500,2014500,9924,33889,43813,Bronx,1958133.393,Claremont Village-Claremont (East)
21-Aug,36005014500,2014500,19192,13223,32415,Bronx,1958133.393,Claremont Village-Claremont (East)
19-May,36005014701,2014701,11534,56768,68302,Bronx,1490474.935,Claremont Village-Claremont (East)
21-May,36005014701,2014701,13882,97469,111351,Bronx,1490474.935,Claremont Village-Claremont (East)
19-Jun,36005014701,2014701,3737,76987,80724,Bronx,1490474.935,Claremont Village-Claremont (East)
21-Jun,36005014701,2014701,13779,120199,133978,Bronx,1490474.935,Claremont Village-Claremont (East)
19-Jul,36005014701,2014701,11334,82931,94265,Bronx,1490474.935,Claremont Village-Claremont (East)
21-Jul,36005014701,2014701,16029,92964,108993,Bronx,1490474.935,Claremont Village-Claremont (East)
19-Aug,36005014701,2014701,3547,34385,37932,Bronx,1490474.935,Claremont Village-Claremont (East)
21-Aug,36005014701,2014701,3585,28469,32054,Bronx,1490474.935,Claremont Village-Claremont (East)
19-May,36081001903,4001903,5393,113808,119201,Queens,5010495.42,Long Island City-Hunters Point
21-May,36081001903,4001903,17722,56083,73805,Queens,5010495.42,Long Island City-Hunters Point
19-Jun,36081001903,4001903,4769,105394,110163,Queens,5010495.42,Long Island City-Hunters Point
21-Jun,36081001903,4001903,4612,137023,141635,Queens,5010495.42,Long Island City-Hunters Point
19-Jul,36081001903,4001903,4875,79662,84537,Queens,5010495.42,Long Island City-Hunters Point
21-Jul,36081001903,4001903,10969,137952,148921,Queens,5010495.42,Long Island City-Hunters Point
19-Aug,36081001903,4001903,11658,70266,81924,Queens,5010495.42,Long Island City-Hunters Point
21-Aug,36081001903,4001903,10421,72078,82499,Queens,5010495.42,Long Island City-Hunters Point
19-May,36081003301,4003301,8413,93756,102169,Queens,2066862.126,Queensbridge-Ravenswood-Dutch Kills
21-May,36081003301,4003301,6720,28051,34771,Queens,2066862.126,Queensbridge-Ravenswood-Dutch Kills
19-Jun,36081003301,4003301,7151,51543,58694,Queens,2066862.126,Queensbridge-Ravenswood-Dutch Kills
21-Jun,36081003301,4003301,4069,58304,62373,Queens,2066862.126,Queensbridge-Ravenswood-Dutch Kills
19-Jul,36081003301,4003301,7476,126082,133558,Queens,2066862.126,Queensbridge-Ravenswood-Dutch Kills
21-Jul,36081003301,4003301,3936,130100,134036,Queens,2066862.126,Queensbridge-Ravenswood-Dutch Kills
19-Aug,36081003301,4003301,7307,90207,97514,Queens,2066862.126,Queensbridge-Ravenswood-Dutch Kills
21-Aug,36081003301,4003301,17025,34970,51995,Queens,2066862.126,Queensbridge-Ravenswood-Dutch Kills
19-May,36061011500,1011500,14132,163769,177901,Manhattan,1889849.287,Hell's Kitchen
21-May,36061011500,1011500,4861,69474,74335,Manhattan,1889849.287,Hell's Kitchen
19-Jun,36061011500,1011500,7558,67408,74966,Manhattan,1889849.287,Hell's Kitchen
21-Jun,36061011500,1011500,15944,89541,105485,Manhattan,1889849.287,Hell's Kitchen
19-Jul,36061011500,1011500,10072,149734,159806,Manhattan,1889849.287,Hell's Kitchen
21-Jul,36061011500,1011500,12758,93797,106555,Manhattan,1889849.287,Hell's Kitchen
19-Aug,36061011500,1011500,984,33427,34411,Manhattan,1889849.287,Hell's Kitchen
21-Aug,36061011500,1011500,3345,118406,121751,Manhattan,1889849.287,Hell's Kitchen
19-May,36081008800,4008800,11496,58391,69887,Queens,4847018.441,Ozone Park
21-May,36081008800,4008800,6678,28356,35034,Queens,4847018.441,Ozone Park
19-Jun,36081008800,4008800,2818,80708,83526,Queens,4847018.441,Ozone Park
21-Jun,36081008800,4008800,4585,38739,43324,Queens,4847018.441,Ozone Park
19-Jul,36081008800,4008800,15852,72622,88474,Queens,4847018.441,Ozone Park
21-Jul,36081008800,4008800,7279,49791,57070,Queens,4847018.441,Ozone Park
19-Aug,36081008800,4008800,10341,30184,40525,Queens,4847018.441,Ozone Park
21-Aug,36081008800,4008800,6554,67847,74401,Queens,4847018.441,Ozone Park
19-May,36081006202,4006202,7108,59228,66336,Queens,12442767.4,Howard Beach-Lindenwood
21-May,36081006202,4006202,9889,50093,59982,Queens,12442767.4,Howard Beach-Lindenwood
19-Jun,36081006202,4006202,4818,118848,123666,Queens,12442767.4,Howard Beach-Lindenwood
21-Jun,36081006202,4006202,12815,71,12886,Queens,12442767.4,Howard Beach-Lindenwood
19-Jul,36081006202,4006202,7121,74107,81228,Queens,12442767.4,Howard Beach-Lindenwood
21-Jul,36081006202,4006202,6750,114593,121343,Queens,12442767.4,Howard Beach-Lindenwood
19-Aug,36081006202,4006202,11588,58519,70107,Queens,12442767.4,Howard Beach-Lindenwood
21-Aug,36081006202,4006202,9226,99166,108392,Queens,12442767.4,Howard Beach-Lindenwood
19-May,36061015900,1015900,6462,66791,73253,Manhattan,1874866.352,Upper West Side-Lincoln Square
21-May,36061015900,1015900,12475,78121,90596,Manhattan,1874866.352,Upper West Side-Lincoln Square
19-Jun,36061015900,1015900,6762,21534,28296,Manhattan,1874866.352,Upper West Side-Lincoln Square
21-Jun,36061015900,1015900,6346,99037,105383,Manhattan,1874866.352,Upper West Side-Lincoln Square
19-Jul,36061015900,1015900,18997,102570,121567,Manhattan,1874866.352,Upper West Side-Lincoln Square
21-Jul,36061015900,1015900,1331,50143,51474,Manhattan,1874866.352,Upper West Side-Lincoln Square
19-Aug,36061015900,1015900,165,69604,69769,Manhattan,1874866.352,Upper West Side-Lincoln Square
21-Aug,36061015900,1015900,15772,80856,96628,Manhattan,1874866.352,Upper West Side-Lincoln Square
19-May,36061016300,1016300,15886,32764,48650,Manhattan,2861363.32,Upper West Side (Central)
21-May,36061016300,1016300,2573,32001,34574,Manhattan,2861363.32,Upper West Side (Central)
19-Jun,36061016300,1016300,10264,61736,72000,Manhattan,2861363.32,Upper West Side (Central)
21-Jun,36061016300,1016300,8140,95289,103429,Manhattan,2861363.32,Upper West Side (Central)
19-Jul,36061016300,1016300,10873,50362,61235,Manhattan,2861363.32,Upper West Side (Central)
21-Jul,36061016300,1016300,9436,89967,99403,Manhattan,2861363.32,Upper West Side (Central)
19-Aug,36061016300,1016300,9381,90494,99875,Manhattan,2861363.32,Upper West Side (Central)
21-Aug,36061016300,1016300,7894,71,7965,Manhattan,2861363.32,Upper West Side (Central)
19-May,36085000300,5000300,4294,65639,69933,Staten Island,4116728.665,St. George-New Brighton
21-May,36085000300,5000300,0,114251,114251,Staten Island,4116728.665,St. George-New Brighton
19-Jun,36085000300,5000300,4665,102518,107183,Staten Island,4116728.665,St. George-New Brighton
21-Jun,36085000300,5000300,6512,11435,17947,Staten Island,4116728.665,St. George-New Brighton
19-Jul,36085000300,5000300,7426,90256,97682,Staten Island,4116728.665,St. George-New Brighton
21-Jul,36085000300,5000300,9330,61288,70618,Staten Island,4116728.665,St. George-New Brighton
19-Aug,36085000300,5000300,8334,50937,59271,Staten Island,4116728.665,St. George-New Brighton
21-Aug,36085000300,5000300,9266,142581,151847,Staten Island,4116728.665,St. George-New Brighton
19-May,36085000600,5000600,4102,139339,143441,Staten Island,7194727.831,Rosebank-Shore Acres-Park Hill
21-May,36085000600,5000600,11048,146130,157178,Staten Island,7194727.831,Rosebank-Shore Acres-Park Hill
19-Jun,36085000600,5000600,8381,125839,134220,Staten Island,7194727.831,Rosebank-Shore Acres-Park Hill
21-Jun,36085000600,5000600,7926,110190,118116,Staten Island,7194727.831,Rosebank-Shore Acres-Park Hill
19-Jul,36085000600,5000600,17950,65444,83394,Staten Island,7194727.831,Rosebank-Shore Acres-Park Hill
21-Jul,36085000600,5000600,6890,45484,52374,Staten Island,7194727.831,Rosebank-Shore Acres-Park Hill
19-Aug,36085000600,5000600,15412,88290,103702,Staten Island,7194727.831,Rosebank-Shore Acres-Park Hill
21-Aug,36085000600,5000600,1969,114715,116684,Staten Island,7194727.831,Rosebank-Shore Acres-Park Hill
19-May,36085000700,5000700,9862,53603,63465,Staten Island,5500140.827,St. George-New Brighton
21-May,36085000700,5000700,10889,53004,63893,Staten Island,5500140.827,St. George-New Brighton
19-Jun,36085000700,5000700,9240,36536,45776,Staten Island,5500140.827,St. George-New Brighton
21-Jun,36085000700,5000700,19512,82704,102216,Staten Island,5500140.827,St. George-New Brighton
19-Jul,36085000700,5000700,9298,50312,59610,Staten Island,5500140.827,St. George-New Brighton
21-Jul,36085000700,5000700,7203,86819,94022,Staten Island,5500140.827,St. George-New Brighton
19-Aug,36085000700,5000700,1428,83536,84964,Staten Island,5500140.827,St. George-New Brighton
21-Aug,36085000700,5000700,14398,123380,137778,Staten Island,5500140.827,St. George-New Brighton
19-May,36085000800,5000800,5891,75207,81098,Staten Island,8571797.357,Rosebank-Shore Acres-Park Hill
21-May,36085000800,5000800,21432,51409,72841,Staten Island,8571797.357,Rosebank-Shore Acres-Park Hill
19-Jun,36085000800,5000800,11255,99817,111072,Staten Island,8571797.357,Rosebank-Shore Acres-Park Hill
21-Jun,36085000800,5000800,6741,120241,126982,Staten Island,8571797.357,Rosebank-Shore Acres-Park Hill
19-Jul,36085000800,5000800,8696,131834,140530,Staten Island,8571797.357,Rosebank-Shore Acres-Park Hill
21-Jul,36085000800,5000800,8444,125702,134146,Staten Island,8571797.357,Rosebank-Shore Acres-Park Hill
19-Aug,36085000800,5000800,3051,30969,34020,Staten Island,8571797.357,Rosebank-Shore Acres-Park Hill
21-Aug,36085000800,5000800,12887,88343,101230,Staten Island,8571797.357,Rosebank-Shore Acres-Park Hill
19-May,36085000900,5000900,4242,20076,24318,Staten Island,2497009.684,St. George-New Brighton
21-May,36085000900,5000900,16357,71,16428,Staten Island,2497009.684,St. George-New Brighton
19-Jun,36085000900,5000900,4515,62236,66751,Staten Island,2497009.684,St. George-New Brighton
21-Jun,36085000900,5000900,3629,64212,67841,Staten Island,2497009.684,St. George-New Brighton
19-Jul,36085000900,5000900,669,21131,21800,Staten Island,2497009.684,St. George-New Brighton
21-Jul,36085000900,5000900,13051,60445,73496,Staten Island,2497009.684,St. George-New Brighton
19-Aug,36085000900,5000900,5906,36341,42247,Staten Island,2497009.684,St. George-New Brighton
21-Aug,36085000900,5000900,7891,37906,45797,Staten Island,2497009.684,St. George-New Brighton
19-May,36085001100,5001100,16132,78966,95098,Staten Island,3496829.938,St. George-New Brighton
21-May,36085001100,5001100,13961,83643,97604,Staten Island,3496829.938,St. George-New Brighton
19-Jun,36085001100,5001100,6614,51069,57683,Staten Island,3496829.938,St. George-New Brighton
21-Jun,36085001100,5001100,5690,51839,57529,Staten Island,3496829.938,St. George-New Brighton
19-Jul,36085001100,5001100,15540,40651,56191,Staten Island,3496829.938,St. George-New Brighton
21-Jul,36085001100,5001100,8871,42026,50897,Staten Island,3496829.938,St. George-New Brighton
19-Aug,36085001100,5001100,7786,71967,79753,Staten Island,3496829.938,St. George-New Brighton
21-Aug,36085001100,5001100,2962,81446,84408,Staten Island,3496829.938,St. George-New Brighton
19-May,36085001700,5001700,5310,81980,87290,Staten Island,3295780.603,Tompkinsville-Stapleton-Clifton-Fox Hills
21-May,36085001700,5001700,6052,64389,70441,Staten Island,3295780.603,Tompkinsville-Stapleton-Clifton-Fox Hills
19-Jun,36085001700,5001700,16180,109161,125341,Staten Island,3295780.603,Tompkinsville-Stapleton-Clifton-Fox Hills
21-Jun,36085001700,5001700,15092,118395,133487,Staten Island,3295780.603,Tompkinsville-Stapleton-Clifton-Fox Hills
19-Jul,36085001700,5001700,4675,33546,38221,Staten Island,3295780.603,Tompkinsville-Stapleton-Clifton-Fox Hills
21-Jul,36085001700,5001700,9620,90822,100442,Staten Island,3295780.603,Tompkinsville-Stapleton-Clifton-Fox Hills
19-Aug,36085001700,5001700,16642,66614,83256,Staten Island,3295780.603,Tompkinsville-Stapleton-Clifton-Fox Hills
21-Aug,36085001700,5001700,6927,18849,25776,Staten Island,3295780.603,Tompkinsville-Stapleton-Clifton-Fox Hills
19-May,36085002700,5002700,15202,103090,118292,Staten Island,2702766.381,Tompkinsville-Stapleton-Clifton-Fox Hills
21-May,36085002700,5002700,5008,114364,119372,Staten Island,2702766.381,Tompkinsville-Stapleton-Clifton-Fox Hills
19-Jun,36085002700,5002700,5443,133741,139184,Staten Island,2702766.381,Tompkinsville-Stapleton-Clifton-Fox Hills
21-Jun,36085002700,5002700,3496,13596,17092,Staten Island,2702766.381,Tompkinsville-Stapleton-Clifton-Fox Hills
19-Jul,36085002700,5002700,12735,92279,105014,Staten Island,2702766.381,Tompkinsville-Stapleton-Clifton-Fox Hills
21-Jul,36085002700,5002700,21320,119282,140602,Staten Island,2702766.381,Tompkinsville-Stapleton-Clifton-Fox Hills
19-Aug,36085002700,5002700,10679,106846,117525,Staten Island,2702766.381,Tompkinsville-Stapleton-Clifton-Fox Hills
21-Aug,36085002700,5002700,4991,47156,52147,Staten Island,2702766.381,Tompkinsville-Stapleton-Clifton-Fox Hills
19-May,36085002900,5002900,2378,71,2449,Staten Island,5669716.012,Tompkinsville-Stapleton-Clifton-Fox Hills
21-May,36085002900,5002900,15715,6949,22664,Staten Island,5669716.012,Tompkinsville-Stapleton-Clifton-Fox Hills
19-Jun,36085002900,5002900,15421,46742,62163,Staten Island,5669716.012,Tompkinsville-Stapleton-Clifton-Fox Hills
21-Jun,36085002900,5002900,5345,79118,84463,Staten Island,5669716.012,Tompkinsville-Stapleton-Clifton-Fox Hills
19-Jul,36085002900,5002900,13611,94442,108053,Staten Island,5669716.012,Tompkinsville-Stapleton-Clifton-Fox Hills
21-Jul,36085002900,5002900,7245,157518,164763,Staten Island,5669716.012,Tompkinsville-Stapleton-Clifton-Fox Hills
19-Aug,36085002900,5002900,7458,36093,43551,Staten Island,5669716.012,Tompkinsville-Stapleton-Clifton-Fox Hills
21-Aug,36085002900,5002900,13198,56719,69917,Staten Island,5669716.012,Tompkinsville-Stapleton-Clifton-Fox Hills
19-May,36085003300,5003300,5372,97251,102623,Staten Island,9208859.88,West New Brighton-Silver Lake-Grymes Hill
21-May,36085003300,5003300,4638,54262,58900,Staten Island,9208859.88,West New Brighton-Silver Lake-Grymes Hill
19-Jun,36085003300,5003300,13508,121685,135193,Staten Island,9208859.88,West New Brighton-Silver Lake-Grymes Hill
21-Jun,36085003300,5003300,8580,76899,85479,Staten Island,9208859.88,West New Brighton-Silver Lake-Grymes Hill
19-Jul,36085003300,5003300,3386,31799,35185,Staten Island,9208859.88,West New Brighton-Silver Lake-Grymes Hill
21-Jul,36085003300,5003300,15272,89328,104600,Staten Island,9208859.88,West New Brighton-Silver Lake-Grymes Hill
19-Aug,36085003300,5003300,14173,71,14244,Staten Island,9208859.88,West New Brighton-Silver Lake-Grymes Hill
21-Aug,36085003300,5003300,11940,3624,15564,Staten Island,9208859.88,West New Brighton-Silver Lake-Grymes Hill
19-May,36085004001,5004001,11036,71390,82426,Staten Island,3280268.14,Tompkinsville-Stapleton-Clifton-Fox Hills
21-May,36085004001,5004001,8376,126595,134971,Staten Island,3280268.14,Tompkinsville-Stapleton-Clifton-Fox Hills
19-Jun,36085004001,5004001,6084,70687,76771,Staten Island,3280268.14,Tompkinsville-Stapleton-Clifton-Fox Hills
21-Jun,36085004001,5004001,793,14320,15113,Staten Island,3280268.14,Tompkinsville-Stapleton-Clifton-Fox Hills
19-Jul,36085004001,5004001,13700,141812,155512,Staten Island,3280268.14,Tompkinsville-Stapleton-Clifton-Fox Hills
21-Jul,36085004001,5004001,14572,154114,168686,Staten Island,3280268.14,Tompkinsville-Stapleton-Clifton-Fox Hills
19-Aug,36085004001,5004001,7976,78112,86088,Staten Island,3280268.14,Tompkinsville-Stapleton-Clifton-Fox Hills
21-Aug,36085004001,5004001,5600,40501,46101,Staten Island,3280268.14,Tompkinsville-Stapleton-Clifton-Fox Hills
19-May,36085004002,5004002,11352,109130,120482,Staten Island,3489305.174,Rosebank-Shore Acres-Park Hill
21-May,36085004002,5004002,5723,88102,93825,Staten Island,3489305.174,Rosebank-Shore Acres-Park Hill
19-Jun,36085004002,5004002,0,16704,16704,Staten Island,3489305.174,Rosebank-Shore Acres-Park Hill
21-Jun,36085004002,5004002,11776,109722,121498,Staten Island,3489305.174,Rosebank-Shore Acres-Park Hill
19-Jul,36085004002,5004002,9615,75140,84755,Staten Island,3489305.174,Rosebank-Shore Acres-Park Hill
21-Jul,36085004002,5004002,0,51265,51265,Staten Island,3489305.174,Rosebank-Shore Acres-Park Hill
19-Aug,36085004002,5004002,4763,115442,120205,Staten Island,3489305.174,Rosebank-Shore Acres-Park Hill
21-Aug,36085004002,5004002,16070,120441,136511,Staten Island,3489305.174,Rosebank-Shore Acres-Park Hill
19-May,36085004003,5004003,4409,71,4480,Staten Island,2255580.677,Rosebank-Shore Acres-Park Hill
21-May,36085004003,5004003,0,83179,83179,Staten Island,2255580.677,Rosebank-Shore Acres-Park Hill
19-Jun,36085004003,5004003,8031,71,8102,Staten Island,2255580.677,Rosebank-Shore Acres-Park Hill
21-Jun,36085004003,5004003,8202,34976,43178,Staten Island,2255580.677,Rosebank-Shore Acres-Park Hill
19-Jul,36085004003,5004003,9906,102058,111964,Staten Island,2255580.677,Rosebank-Shore Acres-Park Hill
21-Jul,36085004003,5004003,0,83372,83372,Staten Island,2255580.677,Rosebank-Shore Acres-Park Hill
19-Aug,36085004003,5004003,6764,131551,138315,Staten Island,2255580.677,Rosebank-Shore Acres-Park Hill
21-Aug,36085004003,5004003,2013,32767,34780,Staten Island,2255580.677,Rosebank-Shore Acres-Park Hill
19-May,36085004004,5004004,13822,79025,92847,Staten Island,3812668.549,Rosebank-Shore Acres-Park Hill
21-May,36085004004,5004004,3342,165165,168507,Staten Island,3812668.549,Rosebank-Shore Acres-Park Hill
19-Jun,36085004004,5004004,2694,114726,117420,Staten Island,3812668.549,Rosebank-Shore Acres-Park Hill
21-Jun,36085004004,5004004,10534,100674,111208,Staten Island,3812668.549,Rosebank-Shore Acres-Park Hill
19-Jul,36085004004,5004004,7133,62461,69594,Staten Island,3812668.549,Rosebank-Shore Acres-Park Hill
21-Jul,36085004004,5004004,20149,82074,102223,Staten Island,3812668.549,Rosebank-Shore Acres-Park Hill
19-Aug,36085004004,5004004,10452,98526,108978,Staten Island,3812668.549,Rosebank-Shore Acres-Park Hill
21-Aug,36085004004,5004004,8923,100691,109614,Staten Island,3812668.549,Rosebank-Shore Acres-Park Hill
19-May,36085004700,5004700,6719,79222,85941,Staten Island,9615341.411,West New Brighton-Silver Lake-Grymes Hill
21-May,36085004700,5004700,9121,59135,68256,Staten Island,9615341.411,West New Brighton-Silver Lake-Grymes Hill
19-Jun,36085004700,5004700,14593,125501,140094,Staten Island,9615341.411,West New Brighton-Silver Lake-Grymes Hill
21-Jun,36085004700,5004700,17445,99724,117169,Staten Island,9615341.411,West New Brighton-Silver Lake-Grymes Hill
19-Jul,36085004700,5004700,12627,76171,88798,Staten Island,9615341.411,West New Brighton-Silver Lake-Grymes Hill
21-Jul,36085004700,5004700,9051,122019,131070,Staten Island,9615341.411,West New Brighton-Silver Lake-Grymes Hill
19-Aug,36085004700,5004700,0,55678,55678,Staten Island,9615341.411,West New Brighton-Silver Lake-Grymes Hill
21-Aug,36085004700,5004700,12359,71,12430,Staten Island,9615341.411,West New Brighton-Silver Lake-Grymes Hill
19-May,36085005000,5005000,4005,41811,45816,Staten Island,8988537.599,Grasmere-Arrochar-South Beach-Dongan Hills
21-May,36085005000,5005000,0,36485,36485,Staten Island,8988537.599,Grasmere-Arrochar-South Beach-Dongan Hills
19-Jun,36085005000,5005000,3674,60652,64326,Staten Island,8988537.599,Grasmere-Arrochar-South Beach-Dongan Hills
21-Jun,36085005000,5005000,7066,36572,43638,Staten Island,8988537.599,Grasmere-Arrochar-South Beach-Dongan Hills
19-Jul,36085005000,5005000,4346,94254,98600,Staten Island,8988537.599,Grasmere-Arrochar-South Beach-Dongan Hills
21-Jul,36085005000,5005000,10701,87232,97933,Staten Island,8988537.599,Grasmere-Arrochar-South Beach-Dongan Hills
19-Aug,36085005000,5005000,430,120804,121234,Staten Island,8988537.599,Grasmere-Arrochar-South Beach-Dongan Hills
21-Aug,36085005000,5005000,3606,54657,58263,Staten Island,8988537.599,Grasmere-Arrochar-South Beach-Dongan Hills
19-May,36085006700,5006700,7219,15051,22270,Staten Island,10256492.36,West New Brighton-Silver Lake-Grymes Hill
21-May,36085006700,5006700,14267,105816,120083,Staten Island,10256492.36,West New Brighton-Silver Lake-Grymes Hill
19-Jun,36085006700,5006700,12253,104576,116829,Staten Island,10256492.36,West New Brighton-Silver Lake-Grymes Hill
21-Jun,36085006700,5006700,9640,102658,112298,Staten Island,10256492.36,West New Brighton-Silver Lake-Grymes Hill
19-Jul,36085006700,5006700,7986,70704,78690,Staten Island,10256492.36,West New Brighton-Silver Lake-Grymes Hill
21-Jul,36085006700,5006700,13035,79982,93017,Staten Island,10256492.36,West New Brighton-Silver Lake-Grymes Hill
19-Aug,36085006700,5006700,6971,71868,78839,Staten Island,10256492.36,West New Brighton-Silver Lake-Grymes Hill
21-Aug,36085006700,5006700,717,92659,93376,Staten Island,10256492.36,West New Brighton-Silver Lake-Grymes Hill
19-May,36085007001,5007001,11446,65079,76525,Staten Island,5089009.422,Grasmere-Arrochar-South Beach-Dongan Hills
21-May,36085007001,5007001,15058,87774,102832,Staten Island,5089009.422,Grasmere-Arrochar-South Beach-Dongan Hills
19-Jun,36085007001,5007001,13282,119433,132715,Staten Island,5089009.422,Grasmere-Arrochar-South Beach-Dongan Hills
21-Jun,36085007001,5007001,2435,108627,111062,Staten Island,5089009.422,Grasmere-Arrochar-South Beach-Dongan Hills
19-Jul,36085007001,5007001,3967,62670,66637,Staten Island,5089009.422,Grasmere-Arrochar-South Beach-Dongan Hills
21-Jul,36085007001,5007001,13673,65137,78810,Staten Island,5089009.422,Grasmere-Arrochar-South Beach-Dongan Hills
19-Aug,36085007001,5007001,19666,70535,90201,Staten Island,5089009.422,Grasmere-Arrochar-South Beach-Dongan Hills
21-Aug,36085007001,5007001,8200,54990,63190,Staten Island,5089009.422,Grasmere-Arrochar-South Beach-Dongan Hills
19-May,36085007400,5007400,6342,82165,88507,Staten Island,5788237.976,Grasmere-Arrochar-South Beach-Dongan Hills
21-May,36085007400,5007400,11984,43893,55877,Staten Island,5788237.976,Grasmere-Arrochar-South Beach-Dongan Hills
19-Jun,36085007400,5007400,12611,37254,49865,Staten Island,5788237.976,Grasmere-Arrochar-South Beach-Dongan Hills
21-Jun,36085007400,5007400,6945,16046,22991,Staten Island,5788237.976,Grasmere-Arrochar-South Beach-Dongan Hills
19-Jul,36085007400,5007400,14327,42130,56457,Staten Island,5788237.976,Grasmere-Arrochar-South Beach-Dongan Hills
21-Jul,36085007400,5007400,4681,103399,108080,Staten Island,5788237.976,Grasmere-Arrochar-South Beach-Dongan Hills
19-Aug,36085007400,5007400,0,21690,21690,Staten Island,5788237.976,Grasmere-Arrochar-South Beach-Dongan Hills
21-Aug,36085007400,5007400,10299,89350,99649,Staten Island,5788237.976,Grasmere-Arrochar-South Beach-Dongan Hills
19-May,36085008100,5008100,8649,34168,42817,Staten Island,8222204.042,St. George-New Brighton
21-May,36085008100,5008100,15386,63255,78641,Staten Island,8222204.042,St. George-New Brighton
19-Jun,36085008100,5008100,5702,186696,192398,Staten Island,8222204.042,St. George-New Brighton
21-Jun,36085008100,5008100,17698,87419,105117,Staten Island,8222204.042,St. George-New Brighton
19-Jul,36085008100,5008100,8057,57882,65939,Staten Island,8222204.042,St. George-New Brighton
21-Jul,36085008100,5008100,14022,54071,68093,Staten Island,8222204.042,St. George-New Brighton
19-Aug,36085008100,5008100,6034,68745,74779,Staten Island,8222204.042,St. George-New Brighton
21-Aug,36085008100,5008100,0,79576,79576,Staten Island,8222204.042,St. George-New Brighton
19-May,36085009601,5009601,4775,117455,122230,Staten Island,8357605.75,Grasmere-Arrochar-South Beach-Dongan Hills
21-May,36085009601,5009601,13140,51683,64823,Staten Island,8357605.75,Grasmere-Arrochar-South Beach-Dongan Hills
19-Jun,36085009601,5009601,9059,50357,59416,Staten Island,8357605.75,Grasmere-Arrochar-South Beach-Dongan Hills
21-Jun,36085009601,5009601,5360,67542,72902,Staten Island,8357605.75,Grasmere-Arrochar-South Beach-Dongan Hills
19-Jul,36085009601,5009601,7952,18907,26859,Staten Island,8357605.75,Grasmere-Arrochar-South Beach-Dongan Hills
21-Jul,36085009601,5009601,8286,56964,65250,Staten Island,8357605.75,Grasmere-Arrochar-South Beach-Dongan Hills
19-Aug,36085009601,5009601,14082,59951,74033,Staten Island,8357605.75,Grasmere-Arrochar-South Beach-Dongan Hills
21-Aug,36085009601,5009601,9735,3757,13492,Staten Island,8357605.75,Grasmere-Arrochar-South Beach-Dongan Hills
19-May,36085009602,5009602,7402,90170,97572,Staten Island,6651764.246,Grasmere-Arrochar-South Beach-Dongan Hills
21-May,36085009602,5009602,4813,20527,25340,Staten Island,6651764.246,Grasmere-Arrochar-South Beach-Dongan Hills
19-Jun,36085009602,5009602,2188,47533,49721,Staten Island,6651764.246,Grasmere-Arrochar-South Beach-Dongan Hills
21-Jun,36085009602,5009602,3569,93697,97266,Staten Island,6651764.246,Grasmere-Arrochar-South Beach-Dongan Hills
19-Jul,36085009602,5009602,7275,75569,82844,Staten Island,6651764.246,Grasmere-Arrochar-South Beach-Dongan Hills
21-Jul,36085009602,5009602,8768,48192,56960,Staten Island,6651764.246,Grasmere-Arrochar-South Beach-Dongan Hills
19-Aug,36085009602,5009602,4809,133528,138337,Staten Island,6651764.246,Grasmere-Arrochar-South Beach-Dongan Hills
21-Aug,36085009602,5009602,9366,25656,35022,Staten Island,6651764.246,Grasmere-Arrochar-South Beach-Dongan Hills
19-May,36085009701,5009701,10698,6080,16778,Staten Island,7426370.74,West New Brighton-Silver Lake-Grymes Hill
21-May,36085009701,5009701,2358,59821,62179,Staten Island,7426370.74,West New Brighton-Silver Lake-Grymes Hill
19-Jun,36085009701,5009701,5696,25985,31681,Staten Island,7426370.74,West New Brighton-Silver Lake-Grymes Hill
21-Jun,36085009701,5009701,4967,101314,106281,Staten Island,7426370.74,West New Brighton-Silver Lake-Grymes Hill
19-Jul,36085009701,5009701,6773,62838,69611,Staten Island,7426370.74,West New Brighton-Silver Lake-Grymes Hill
21-Jul,36085009701,5009701,14887,97181,112068,Staten Island,7426370.74,West New Brighton-Silver Lake-Grymes Hill
19-Aug,36085009701,5009701,11980,44822,56802,Staten Island,7426370.74,West New Brighton-Silver Lake-Grymes Hill
21-Aug,36085009701,5009701,11931,97945,109876,Staten Island,7426370.74,West New Brighton-Silver Lake-Grymes Hill
19-May,36085009702,5009702,19904,40187,60091,Staten Island,3768355.175,Snug Harbor
21-May,36085009702,5009702,11307,83042,94349,Staten Island,3768355.175,Snug Harbor
19-Jun,36085009702,5009702,2025,57522,59547,Staten Island,3768355.175,Snug Harbor
21-Jun,36085009702,5009702,6564,58748,65312,Staten Island,3768355.175,Snug Harbor
19-Jul,36085009702,5009702,8233,77511,85744,Staten Island,3768355.175,Snug Harbor
21-Jul,36085009702,5009702,10470,50267,60737,Staten Island,3768355.175,Snug Harbor
19-Aug,36085009702,5009702,0,81792,81792,Staten Island,3768355.175,Snug Harbor
21-Aug,36085009702,5009702,7220,162215,169435,Staten Island,3768355.175,Snug Harbor
19-May,36085010500,5010500,8609,117462,126071,Staten Island,8794153.165,West New Brighton-Silver Lake-Grymes Hill
21-May,36085010500,5010500,6875,126968,133843,Staten Island,8794153.165,West New Brighton-Silver Lake-Grymes Hill
19-Jun,36085010500,5010500,12812,60976,73788,Staten Island,8794153.165,West New Brighton-Silver Lake-Grymes Hill
21-Jun,36085010500,5010500,11431,86394,97825,Staten Island,8794153.165,West New Brighton-Silver Lake-Grymes Hill
19-Jul,36085010500,5010500,8367,64444,72811,Staten Island,8794153.165,West New Brighton-Silver Lake-Grymes Hill
21-Jul,36085010500,5010500,4689,48800,53489,Staten Island,8794153.165,West New Brighton-Silver Lake-Grymes Hill
19-Aug,36085010500,5010500,17942,68937,86879,Staten Island,8794153.165,West New Brighton-Silver Lake-Grymes Hill
21-Aug,36085010500,5010500,12987,58054,71041,Staten Island,8794153.165,West New Brighton-Silver Lake-Grymes Hill
19-May,36085011201,5011201,3103,36158,39261,Staten Island,17602509.93,New Dorp-Midland Beach
21-May,36085011201,5011201,10847,112126,122973,Staten Island,17602509.93,New Dorp-Midland Beach
19-Jun,36085011201,5011201,11111,6876,17987,Staten Island,17602509.93,New Dorp-Midland Beach
21-Jun,36085011201,5011201,629,115061,115690,Staten Island,17602509.93,New Dorp-Midland Beach
19-Jul,36085011201,5011201,14470,38280,52750,Staten Island,17602509.93,New Dorp-Midland Beach
21-Jul,36085011201,5011201,14955,120245,135200,Staten Island,17602509.93,New Dorp-Midland Beach
19-Aug,36085011201,5011201,14286,64479,78765,Staten Island,17602509.93,New Dorp-Midland Beach
21-Aug,36085011201,5011201,2841,49003,51844,Staten Island,17602509.93,New Dorp-Midland Beach
19-May,36085011203,5011203,1370,103457,104827,Staten Island,10829860.3,New Dorp-Midland Beach
21-May,36085011203,5011203,15076,79809,94885,Staten Island,10829860.3,New Dorp-Midland Beach
19-Jun,36085011203,5011203,21345,63901,85246,Staten Island,10829860.3,New Dorp-Midland Beach
21-Jun,36085011203,5011203,12769,22133,34902,Staten Island,10829860.3,New Dorp-Midland Beach
19-Jul,36085011203,5011203,9006,71384,80390,Staten Island,10829860.3,New Dorp-Midland Beach
21-Jul,36085011203,5011203,4612,81185,85797,Staten Island,10829860.3,New Dorp-Midland Beach
19-Aug,36085011203,5011203,9852,8999,18851,Staten Island,10829860.3,New Dorp-Midland Beach
21-Aug,36085011203,5011203,0,117094,117094,Staten Island,10829860.3,New Dorp-Midland Beach
19-May,36085011401,5011401,3129,93808,96937,Staten Island,5672548.773,Grasmere-Arrochar-South Beach-Dongan Hills
21-May,36085011401,5011401,9181,113374,122555,Staten Island,5672548.773,Grasmere-Arrochar-South Beach-Dongan Hills
19-Jun,36085011401,5011401,3558,115618,119176,Staten Island,5672548.773,Grasmere-Arrochar-South Beach-Dongan Hills
21-Jun,36085011401,5011401,12158,29215,41373,Staten Island,5672548.773,Grasmere-Arrochar-South Beach-Dongan Hills
19-Jul,36085011401,5011401,11906,28009,39915,Staten Island,5672548.773,Grasmere-Arrochar-South Beach-Dongan Hills
21-Jul,36085011401,5011401,8397,95381,103778,Staten Island,5672548.773,Grasmere-Arrochar-South Beach-Dongan Hills
19-Aug,36085011401,5011401,7282,75304,82586,Staten Island,5672548.773,Grasmere-Arrochar-South Beach-Dongan Hills
21-Aug,36085011401,5011401,5429,54605,60034,Staten Island,5672548.773,Grasmere-Arrochar-South Beach-Dongan Hills
19-May,36085011402,5011402,4569,94302,98871,Staten Island,6228603.91,New Dorp-Midland Beach
21-May,36085011402,5011402,6348,112892,119240,Staten Island,6228603.91,New Dorp-Midland Beach
19-Jun,36085011402,5011402,11029,139026,150055,Staten Island,6228603.91,New Dorp-Midland Beach
21-Jun,36085011402,5011402,15454,64876,80330,Staten Island,6228603.91,New Dorp-Midland Beach
19-Jul,36085011402,5011402,3722,54573,58295,Staten Island,6228603.91,New Dorp-Midland Beach
21-Jul,36085011402,5011402,10029,58147,68176,Staten Island,6228603.91,New Dorp-Midland Beach
19-Aug,36085011402,5011402,2755,105709,108464,Staten Island,6228603.91,New Dorp-Midland Beach
21-Aug,36085011402,5011402,7319,44871,52190,Staten Island,6228603.91,New Dorp-Midland Beach
19-May,36085012100,5012100,6631,102653,109284,Staten Island,7991818.062,West New Brighton-Silver Lake-Grymes Hill
21-May,36085012100,5012100,14005,25662,39667,Staten Island,7991818.062,West New Brighton-Silver Lake-Grymes Hill
19-Jun,36085012100,5012100,6326,71,6397,Staten Island,7991818.062,West New Brighton-Silver Lake-Grymes Hill
21-Jun,36085012100,5012100,13230,58156,71386,Staten Island,7991818.062,West New Brighton-Silver Lake-Grymes Hill
19-Jul,36085012100,5012100,8263,84288,92551,Staten Island,7991818.062,West New Brighton-Silver Lake-Grymes Hill
21-Jul,36085012100,5012100,6028,66572,72600,Staten Island,7991818.062,West New Brighton-Silver Lake-Grymes Hill
19-Aug,36085012100,5012100,7889,121144,129033,Staten Island,7991818.062,West New Brighton-Silver Lake-Grymes Hill
21-Aug,36085012100,5012100,10839,59052,69891,Staten Island,7991818.062,West New Brighton-Silver Lake-Grymes Hill
19-May,36085012200,5012200,14529,65972,80501,Staten Island,8917444.276,New Dorp-Midland Beach
21-May,36085012200,5012200,19500,126204,145704,Staten Island,8917444.276,New Dorp-Midland Beach
19-Jun,36085012200,5012200,5350,81943,87293,Staten Island,8917444.276,New Dorp-Midland Beach
21-Jun,36085012200,5012200,10505,79955,90460,Staten Island,8917444.276,New Dorp-Midland Beach
19-Jul,36085012200,5012200,11326,32670,43996,Staten Island,8917444.276,New Dorp-Midland Beach
21-Jul,36085012200,5012200,8059,83997,92056,Staten Island,8917444.276,New Dorp-Midland Beach
19-Aug,36085012200,5012200,7945,59706,67651,Staten Island,8917444.276,New Dorp-Midland Beach
21-Aug,36085012200,5012200,472,85637,86109,Staten Island,8917444.276,New Dorp-Midland Beach
19-May,36085012805,5012805,5653,119242,124895,Staten Island,10625946.37,Oakwood-Richmondtown
21-May,36085012805,5012805,17062,67517,84579,Staten Island,10625946.37,Oakwood-Richmondtown
19-Jun,36085012805,5012805,16072,71,16143,Staten Island,10625946.37,Oakwood-Richmondtown
21-Jun,36085012805,5012805,14069,57193,71262,Staten Island,10625946.37,Oakwood-Richmondtown
19-Jul,36085012805,5012805,4568,82190,86758,Staten Island,10625946.37,Oakwood-Richmondtown
21-Jul,36085012805,5012805,16275,65804,82079,Staten Island,10625946.37,Oakwood-Richmondtown
19-Aug,36085012805,5012805,12622,57759,70381,Staten Island,10625946.37,Oakwood-Richmondtown
21-Aug,36085012805,5012805,3140,50993,54133,Staten Island,10625946.37,Oakwood-Richmondtown
19-May,36085012806,5012806,14584,71,14655,Staten Island,13858119.87,Oakwood-Richmondtown
21-May,36085012806,5012806,8945,77363,86308,Staten Island,13858119.87,Oakwood-Richmondtown
19-Jun,36085012806,5012806,8017,67421,75438,Staten Island,13858119.87,Oakwood-Richmondtown
21-Jun,36085012806,5012806,8633,71,8704,Staten Island,13858119.87,Oakwood-Richmondtown
19-Jul,36085012806,5012806,6747,66214,72961,Staten Island,13858119.87,Oakwood-Richmondtown
21-Jul,36085012806,5012806,0,67853,67853,Staten Island,13858119.87,Oakwood-Richmondtown
19-Aug,36085012806,5012806,2731,93541,96272,Staten Island,13858119.87,Oakwood-Richmondtown
21-Aug,36085012806,5012806,5629,71,5700,Staten Island,13858119.87,Oakwood-Richmondtown
19-May,36085013301,5013301,9531,124921,134452,Staten Island,721333.3602,West New Brighton-Silver Lake-Grymes Hill
21-May,36085013301,5013301,5843,56296,62139,Staten Island,721333.3602,West New Brighton-Silver Lake-Grymes Hill
19-Jun,36085013301,5013301,16326,79670,95996,Staten Island,721333.3602,West New Brighton-Silver Lake-Grymes Hill
21-Jun,36085013301,5013301,11113,78956,90069,Staten Island,721333.3602,West New Brighton-Silver Lake-Grymes Hill
19-Jul,36085013301,5013301,12901,53445,66346,Staten Island,721333.3602,West New Brighton-Silver Lake-Grymes Hill
21-Jul,36085013301,5013301,2838,839,3677,Staten Island,721333.3602,West New Brighton-Silver Lake-Grymes Hill
19-Aug,36085013301,5013301,11164,28392,39556,Staten Island,721333.3602,West New Brighton-Silver Lake-Grymes Hill
21-Aug,36085013301,5013301,14730,81666,96396,Staten Island,721333.3602,West New Brighton-Silver Lake-Grymes Hill
19-May,36085013302,5013302,9488,36117,45605,Staten Island,9313661.843,Port Richmond
21-May,36085013302,5013302,6965,93517,100482,Staten Island,9313661.843,Port Richmond
19-Jun,36085013302,5013302,10370,78842,89212,Staten Island,9313661.843,Port Richmond
21-Jun,36085013302,5013302,6935,77961,84896,Staten Island,9313661.843,Port Richmond
19-Jul,36085013302,5013302,13992,91774,105766,Staten Island,9313661.843,Port Richmond
21-Jul,36085013302,5013302,9805,95399,105204,Staten Island,9313661.843,Port Richmond
19-Aug,36085013302,5013302,11073,74206,85279,Staten Island,9313661.843,Port Richmond
21-Aug,36085013302,5013302,7299,105492,112791,Staten Island,9313661.843,Port Richmond
19-May,36085013400,5013400,8554,113197,121751,Staten Island,9158025.407,New Dorp-Midland Beach
21-May,36085013400,5013400,16426,22407,38833,Staten Island,9158025.407,New Dorp-Midland Beach
19-Jun,36085013400,5013400,10184,36814,46998,Staten Island,9158025.407,New Dorp-Midland Beach
21-Jun,36085013400,5013400,3042,69948,72990,Staten Island,9158025.407,New Dorp-Midland Beach
19-Jul,36085013400,5013400,13546,92048,105594,Staten Island,9158025.407,New Dorp-Midland Beach
21-Jul,36085013400,5013400,16287,71,16358,Staten Island,9158025.407,New Dorp-Midland Beach
19-Aug,36085013400,5013400,5668,69945,75613,Staten Island,9158025.407,New Dorp-Midland Beach
21-Aug,36085013400,5013400,7477,147139,154616,Staten Island,9158025.407,New Dorp-Midland Beach
19-May,36085014607,5014607,10379,34502,44881,Staten Island,7353796.246,Great Kills-Eltingville
21-May,36085014607,5014607,11009,72651,83660,Staten Island,7353796.246,Great Kills-Eltingville
19-Jun,36085014607,5014607,10701,75885,86586,Staten Island,7353796.246,Great Kills-Eltingville
21-Jun,36085014607,5014607,9279,47128,56407,Staten Island,7353796.246,Great Kills-Eltingville
19-Jul,36085014607,5014607,1819,44625,46444,Staten Island,7353796.246,Great Kills-Eltingville
21-Jul,36085014607,5014607,6134,80979,87113,Staten Island,7353796.246,Great Kills-Eltingville
19-Aug,36085014607,5014607,0,34281,34281,Staten Island,7353796.246,Great Kills-Eltingville
21-Aug,36085014607,5014607,9043,19804,28847,Staten Island,7353796.246,Great Kills-Eltingville
19-May,36085014608,5014608,8106,118626,126732,Staten Island,4831070.68,Great Kills-Eltingville
21-May,36085014608,5014608,4333,56377,60710,Staten Island,4831070.68,Great Kills-Eltingville
19-Jun,36085014608,5014608,12393,20993,33386,Staten Island,4831070.68,Great Kills-Eltingville
21-Jun,36085014608,5014608,3653,95356,99009,Staten Island,4831070.68,Great Kills-Eltingville
19-Jul,36085014608,5014608,3600,73659,77259,Staten Island,4831070.68,Great Kills-Eltingville
21-Jul,36085014608,5014608,15949,83210,99159,Staten Island,4831070.68,Great Kills-Eltingville
19-Aug,36085014608,5014608,1216,46748,47964,Staten Island,4831070.68,Great Kills-Eltingville
21-Aug,36085014608,5014608,7616,49110,56726,Staten Island,4831070.68,Great Kills-Eltingville
19-May,36085015100,5015100,18243,57032,75275,Staten Island,10826458.28,Westerleigh-Castleton Corners
21-May,36085015100,5015100,9601,75541,85142,Staten Island,10826458.28,Westerleigh-Castleton Corners
19-Jun,36085015100,5015100,6197,80007,86204,Staten Island,10826458.28,Westerleigh-Castleton Corners
21-Jun,36085015100,5015100,12461,28573,41034,Staten Island,10826458.28,Westerleigh-Castleton Corners
19-Jul,36085015100,5015100,4368,82421,86789,Staten Island,10826458.28,Westerleigh-Castleton Corners
21-Jul,36085015100,5015100,7277,47672,54949,Staten Island,10826458.28,Westerleigh-Castleton Corners
19-Aug,36085015100,5015100,4102,34946,39048,Staten Island,10826458.28,Westerleigh-Castleton Corners
21-Aug,36085015100,5015100,3508,7933,11441,Staten Island,10826458.28,Westerleigh-Castleton Corners
19-May,36085015400,5015400,6469,63872,70341,Staten Island,23377914.35,Great Kills Park
21-May,36085015400,5015400,14093,71,14164,Staten Island,23377914.35,Great Kills Park
19-Jun,36085015400,5015400,11053,32416,43469,Staten Island,23377914.35,Great Kills Park
21-Jun,36085015400,5015400,11062,51612,62674,Staten Island,23377914.35,Great Kills Park
19-Jul,36085015400,5015400,11267,55874,67141,Staten Island,23377914.35,Great Kills Park
21-Jul,36085015400,5015400,9606,85713,95319,Staten Island,23377914.35,Great Kills Park
19-Aug,36085015400,5015400,5738,26799,32537,Staten Island,23377914.35,Great Kills Park
21-Aug,36085015400,5015400,7731,83705,91436,Staten Island,23377914.35,Great Kills Park
19-May,36085015601,5015601,9480,116787,126267,Staten Island,15399913.81,Great Kills-Eltingville
21-May,36085015601,5015601,9136,37816,46952,Staten Island,15399913.81,Great Kills-Eltingville
19-Jun,36085015601,5015601,10454,92636,103090,Staten Island,15399913.81,Great Kills-Eltingville
21-Jun,36085015601,5015601,4548,15326,19874,Staten Island,15399913.81,Great Kills-Eltingville
19-Jul,36085015601,5015601,12653,120324,132977,Staten Island,15399913.81,Great Kills-Eltingville
21-Jul,36085015601,5015601,8132,103185,111317,Staten Island,15399913.81,Great Kills-Eltingville
19-Aug,36085015601,5015601,4298,38498,42796,Staten Island,15399913.81,Great Kills-Eltingville
21-Aug,36085015601,5015601,3114,14141,17255,Staten Island,15399913.81,Great Kills-Eltingville
19-May,36085015602,5015602,19509,59502,79011,Staten Island,9484314.944,Great Kills-Eltingville
21-May,36085015602,5015602,3170,93320,96490,Staten Island,9484314.944,Great Kills-Eltingville
19-Jun,36085015602,5015602,3341,28758,32099,Staten Island,9484314.944,Great Kills-Eltingville
21-Jun,36085015602,5015602,3109,123909,127018,Staten Island,9484314.944,Great Kills-Eltingville
19-Jul,36085015602,5015602,10297,45560,55857,Staten Island,9484314.944,Great Kills-Eltingville
21-Jul,36085015602,5015602,13153,43614,56767,Staten Island,9484314.944,Great Kills-Eltingville
19-Aug,36085015602,5015602,6648,81851,88499,Staten Island,9484314.944,Great Kills-Eltingville
21-Aug,36085015602,5015602,12303,106700,119003,Staten Island,9484314.944,Great Kills-Eltingville
19-May,36085016901,5016901,19024,109268,128292,Staten Island,8793357.855,Westerleigh-Castleton Corners
21-May,36085016901,5016901,0,71,71,Staten Island,8793357.855,Westerleigh-Castleton Corners
19-Jun,36085016901,5016901,6270,105593,111863,Staten Island,8793357.855,Westerleigh-Castleton Corners
21-Jun,36085016901,5016901,1620,65838,67458,Staten Island,8793357.855,Westerleigh-Castleton Corners
19-Jul,36085016901,5016901,5967,61065,67032,Staten Island,8793357.855,Westerleigh-Castleton Corners
21-Jul,36085016901,5016901,8358,58508,66866,Staten Island,8793357.855,Westerleigh-Castleton Corners
19-Aug,36085016901,5016901,2034,116930,118964,Staten Island,8793357.855,Westerleigh-Castleton Corners
21-Aug,36085016901,5016901,11760,71,11831,Staten Island,8793357.855,Westerleigh-Castleton Corners
19-May,36085017007,5017007,13995,63057,77052,Staten Island,15731555.58,Arden Heights-Rossville
21-May,36085017007,5017007,13384,73529,86913,Staten Island,15731555.58,Arden Heights-Rossville
19-Jun,36085017007,5017007,7585,74479,82064,Staten Island,15731555.58,Arden Heights-Rossville
21-Jun,36085017007,5017007,12417,24442,36859,Staten Island,15731555.58,Arden Heights-Rossville
19-Jul,36085017007,5017007,16347,71,16418,Staten Island,15731555.58,Arden Heights-Rossville
21-Jul,36085017007,5017007,9843,91384,101227,Staten Island,15731555.58,Arden Heights-Rossville
19-Aug,36085017007,5017007,10368,16897,27265,Staten Island,15731555.58,Arden Heights-Rossville
21-Aug,36085017007,5017007,6241,83547,89788,Staten Island,15731555.58,Arden Heights-Rossville
19-May,36085017009,5017009,4218,132241,136459,Staten Island,12741940.43,Annadale-Huguenot-Prince's Bay-Woodrow
21-May,36085017009,5017009,9594,76908,86502,Staten Island,12741940.43,Annadale-Huguenot-Prince's Bay-Woodrow
19-Jun,36085017009,5017009,15447,50109,65556,Staten Island,12741940.43,Annadale-Huguenot-Prince's Bay-Woodrow
21-Jun,36085017009,5017009,13692,51819,65511,Staten Island,12741940.43,Annadale-Huguenot-Prince's Bay-Woodrow
19-Jul,36085017009,5017009,5975,75636,81611,Staten Island,12741940.43,Annadale-Huguenot-Prince's Bay-Woodrow
21-Jul,36085017009,5017009,11792,71,11863,Staten Island,12741940.43,Annadale-Huguenot-Prince's Bay-Woodrow
19-Aug,36085017009,5017009,13934,37485,51419,Staten Island,12741940.43,Annadale-Huguenot-Prince's Bay-Woodrow
21-Aug,36085017009,5017009,9241,114883,124124,Staten Island,12741940.43,Annadale-Huguenot-Prince's Bay-Woodrow
19-May,36085017011,5017011,7517,71,7588,Staten Island,7745150.213,Great Kills-Eltingville
21-May,36085017011,5017011,6672,67648,74320,Staten Island,7745150.213,Great Kills-Eltingville
19-Jun,36085017011,5017011,8708,155647,164355,Staten Island,7745150.213,Great Kills-Eltingville
21-Jun,36085017011,5017011,10542,33634,44176,Staten Island,7745150.213,Great Kills-Eltingville
19-Jul,36085017011,5017011,6459,66001,72460,Staten Island,7745150.213,Great Kills-Eltingville
21-Jul,36085017011,5017011,12404,84881,97285,Staten Island,7745150.213,Great Kills-Eltingville
19-Aug,36085017011,5017011,14219,120709,134928,Staten Island,7745150.213,Great Kills-Eltingville
21-Aug,36085017011,5017011,5903,125818,131721,Staten Island,7745150.213,Great Kills-Eltingville
19-May,36085017012,5017012,6818,52787,59605,Staten Island,9897844.418,Great Kills-Eltingville
21-May,36085017012,5017012,2703,71,2774,Staten Island,9897844.418,Great Kills-Eltingville
19-Jun,36085017012,5017012,14892,35777,50669,Staten Island,9897844.418,Great Kills-Eltingville
21-Jun,36085017012,5017012,11991,115001,126992,Staten Island,9897844.418,Great Kills-Eltingville
19-Jul,36085017012,5017012,7460,53229,60689,Staten Island,9897844.418,Great Kills-Eltingville
21-Jul,36085017012,5017012,8818,105405,114223,Staten Island,9897844.418,Great Kills-Eltingville
19-Aug,36085017012,5017012,8216,95128,103344,Staten Island,9897844.418,Great Kills-Eltingville
21-Aug,36085017012,5017012,11146,129632,140778,Staten Island,9897844.418,Great Kills-Eltingville
19-May,36085017013,5017013,6338,75432,81770,Staten Island,5970920.217,Arden Heights-Rossville
21-May,36085017013,5017013,2250,81849,84099,Staten Island,5970920.217,Arden Heights-Rossville
19-Jun,36085017013,5017013,17782,81083,98865,Staten Island,5970920.217,Arden Heights-Rossville
21-Jun,36085017013,5017013,2657,48123,50780,Staten Island,5970920.217,Arden Heights-Rossville
19-Jul,36085017013,5017013,427,106813,107240,Staten Island,5970920.217,Arden Heights-Rossville
21-Jul,36085017013,5017013,15517,64896,80413,Staten Island,5970920.217,Arden Heights-Rossville
19-Aug,36085017013,5017013,6078,98910,104988,Staten Island,5970920.217,Arden Heights-Rossville
21-Aug,36085017013,5017013,910,18961,19871,Staten Island,5970920.217,Arden Heights-Rossville
19-May,36085017014,5017014,0,59814,59814,Staten Island,5985826.816,Arden Heights-Rossville
21-May,36085017014,5017014,8263,35382,43645,Staten Island,5985826.816,Arden Heights-Rossville
19-Jun,36085017014,5017014,7020,130447,137467,Staten Island,5985826.816,Arden Heights-Rossville
21-Jun,36085017014,5017014,9815,103123,112938,Staten Island,5985826.816,Arden Heights-Rossville
19-Jul,36085017014,5017014,17092,115409,132501,Staten Island,5985826.816,Arden Heights-Rossville
21-Jul,36085017014,5017014,6766,83347,90113,Staten Island,5985826.816,Arden Heights-Rossville
19-Aug,36085017014,5017014,11008,109514,120522,Staten Island,5985826.816,Arden Heights-Rossville
21-Aug,36085017014,5017014,13510,63479,76989,Staten Island,5985826.816,Arden Heights-Rossville
19-May,36085017015,5017015,5734,43307,49041,Staten Island,4928554.886,Arden Heights-Rossville
21-May,36085017015,5017015,9831,118277,128108,Staten Island,4928554.886,Arden Heights-Rossville
19-Jun,36085017015,5017015,16972,38659,55631,Staten Island,4928554.886,Arden Heights-Rossville
21-Jun,36085017015,5017015,2853,59261,62114,Staten Island,4928554.886,Arden Heights-Rossville
19-Jul,36085017015,5017015,19447,90016,109463,Staten Island,4928554.886,Arden Heights-Rossville
21-Jul,36085017015,5017015,5103,71889,76992,Staten Island,4928554.886,Arden Heights-Rossville
19-Aug,36085017015,5017015,11724,19083,30807,Staten Island,4928554.886,Arden Heights-Rossville
21-Aug,36085017015,5017015,10428,49543,59971,Staten Island,4928554.886,Arden Heights-Rossville
19-May,36085017300,5017300,0,66697,66697,Staten Island,3688472.163,Todt Hill-Emerson Hill-Lighthouse Hill-Manor Heights
21-May,36085017300,5017300,5648,44877,50525,Staten Island,3688472.163,Todt Hill-Emerson Hill-Lighthouse Hill-Manor Heights
19-Jun,36085017300,5017300,3381,141012,144393,Staten Island,3688472.163,Todt Hill-Emerson Hill-Lighthouse Hill-Manor Heights
21-Jun,36085017300,5017300,15469,112796,128265,Staten Island,3688472.163,Todt Hill-Emerson Hill-Lighthouse Hill-Manor Heights
19-Jul,36085017300,5017300,15279,72728,88007,Staten Island,3688472.163,Todt Hill-Emerson Hill-Lighthouse Hill-Manor Heights
21-Jul,36085017300,5017300,6661,57333,63994,Staten Island,3688472.163,Todt Hill-Emerson Hill-Lighthouse Hill-Manor Heights
19-Aug,36085017300,5017300,2315,52923,55238,Staten Island,3688472.163,Todt Hill-Emerson Hill-Lighthouse Hill-Manor Heights
21-Aug,36085017300,5017300,8798,92840,101638,Staten Island,3688472.163,Todt Hill-Emerson Hill-Lighthouse Hill-Manor Heights
19-May,36085017701,5017701,13336,22213,35549,Staten Island,31761506.3,Todt Hill-Emerson Hill-Lighthouse Hill-Manor Heights
21-May,36085017701,5017701,4969,89012,93981,Staten Island,31761506.3,Todt Hill-Emerson Hill-Lighthouse Hill-Manor Heights
19-Jun,36085017701,5017701,2155,17757,19912,Staten Island,31761506.3,Todt Hill-Emerson Hill-Lighthouse Hill-Manor Heights
21-Jun,36085017701,5017701,14462,71640,86102,Staten Island,31761506.3,Todt Hill-Emerson Hill-Lighthouse Hill-Manor Heights
19-Jul,36085017701,5017701,12127,118573,130700,Staten Island,31761506.3,Todt Hill-Emerson Hill-Lighthouse Hill-Manor Heights
21-Jul,36085017701,5017701,14669,3135,17804,Staten Island,31761506.3,Todt Hill-Emerson Hill-Lighthouse Hill-Manor Heights
19-Aug,36085017701,5017701,12187,94677,106864,Staten Island,31761506.3,Todt Hill-Emerson Hill-Lighthouse Hill-Manor Heights
21-Aug,36085017701,5017701,15502,71,15573,Staten Island,31761506.3,Todt Hill-Emerson Hill-Lighthouse Hill-Manor Heights
19-May,36085017702,5017702,9985,48250,58235,Staten Island,6308722.957,Todt Hill-Emerson Hill-Lighthouse Hill-Manor Heights
21-May,36085017702,5017702,4781,28267,33048,Staten Island,6308722.957,Todt Hill-Emerson Hill-Lighthouse Hill-Manor Heights
19-Jun,36085017702,5017702,0,118828,118828,Staten Island,6308722.957,Todt Hill-Emerson Hill-Lighthouse Hill-Manor Heights
21-Jun,36085017702,5017702,9745,42422,52167,Staten Island,6308722.957,Todt Hill-Emerson Hill-Lighthouse Hill-Manor Heights
19-Jul,36085017702,5017702,5339,83529,88868,Staten Island,6308722.957,Todt Hill-Emerson Hill-Lighthouse Hill-Manor Heights
21-Jul,36085017702,5017702,10393,85126,95519,Staten Island,6308722.957,Todt Hill-Emerson Hill-Lighthouse Hill-Manor Heights
19-Aug,36085017702,5017702,2602,88783,91385,Staten Island,6308722.957,Todt Hill-Emerson Hill-Lighthouse Hill-Manor Heights
21-Aug,36085017702,5017702,6249,53441,59690,Staten Island,6308722.957,Todt Hill-Emerson Hill-Lighthouse Hill-Manor Heights
19-May,36085018100,5018100,16907,65709,82616,Staten Island,56268491.45,Todt Hill-Emerson Hill-Lighthouse Hill-Manor Heights
21-May,36085018100,5018100,10669,104960,115629,Staten Island,56268491.45,Todt Hill-Emerson Hill-Lighthouse Hill-Manor Heights
19-Jun,36085018100,5018100,14169,163223,177392,Staten Island,56268491.45,Todt Hill-Emerson Hill-Lighthouse Hill-Manor Heights
21-Jun,36085018100,5018100,10407,149494,159901,Staten Island,56268491.45,Todt Hill-Emerson Hill-Lighthouse Hill-Manor Heights
19-Jul,36085018100,5018100,11017,49068,60085,Staten Island,56268491.45,Todt Hill-Emerson Hill-Lighthouse Hill-Manor Heights
21-Jul,36085018100,5018100,3312,53969,57281,Staten Island,56268491.45,Todt Hill-Emerson Hill-Lighthouse Hill-Manor Heights
19-Aug,36085018100,5018100,14127,5226,19353,Staten Island,56268491.45,Todt Hill-Emerson Hill-Lighthouse Hill-Manor Heights
21-Aug,36085018100,5018100,15296,54944,70240,Staten Island,56268491.45,Todt Hill-Emerson Hill-Lighthouse Hill-Manor Heights
19-May,36085018701,5018701,7402,59864,67266,Staten Island,4129152.293,Westerleigh-Castleton Corners
21-May,36085018701,5018701,10984,74419,85403,Staten Island,4129152.293,Westerleigh-Castleton Corners
19-Jun,36085018701,5018701,6928,56108,63036,Staten Island,4129152.293,Westerleigh-Castleton Corners
21-Jun,36085018701,5018701,12359,99994,112353,Staten Island,4129152.293,Westerleigh-Castleton Corners
19-Jul,36085018701,5018701,1398,7272,8670,Staten Island,4129152.293,Westerleigh-Castleton Corners
21-Jul,36085018701,5018701,6273,105763,112036,Staten Island,4129152.293,Westerleigh-Castleton Corners
19-Aug,36085018701,5018701,614,58045,58659,Staten Island,4129152.293,Westerleigh-Castleton Corners
21-Aug,36085018701,5018701,1063,87710,88773,Staten Island,4129152.293,Westerleigh-Castleton Corners
19-May,36085018703,5018703,6987,112822,119809,Staten Island,5103683.951,Todt Hill-Emerson Hill-Lighthouse Hill-Manor Heights
21-May,36085018703,5018703,6939,99498,106437,Staten Island,5103683.951,Todt Hill-Emerson Hill-Lighthouse Hill-Manor Heights
19-Jun,36085018703,5018703,19760,126545,146305,Staten Island,5103683.951,Todt Hill-Emerson Hill-Lighthouse Hill-Manor Heights
21-Jun,36085018703,5018703,2394,146221,148615,Staten Island,5103683.951,Todt Hill-Emerson Hill-Lighthouse Hill-Manor Heights
19-Jul,36085018703,5018703,4365,128578,132943,Staten Island,5103683.951,Todt Hill-Emerson Hill-Lighthouse Hill-Manor Heights
21-Jul,36085018703,5018703,3801,137181,140982,Staten Island,5103683.951,Todt Hill-Emerson Hill-Lighthouse Hill-Manor Heights
19-Aug,36085018703,5018703,7721,31602,39323,Staten Island,5103683.951,Todt Hill-Emerson Hill-Lighthouse Hill-Manor Heights
21-Aug,36085018703,5018703,10674,63182,73856,Staten Island,5103683.951,Todt Hill-Emerson Hill-Lighthouse Hill-Manor Heights
19-May,36085018704,5018704,1474,121961,123435,Staten Island,5819694.332,Todt Hill-Emerson Hill-Lighthouse Hill-Manor Heights
21-May,36085018704,5018704,13972,61392,75364,Staten Island,5819694.332,Todt Hill-Emerson Hill-Lighthouse Hill-Manor Heights
19-Jun,36085018704,5018704,16931,6032,22963,Staten Island,5819694.332,Todt Hill-Emerson Hill-Lighthouse Hill-Manor Heights
21-Jun,36085018704,5018704,11744,109838,121582,Staten Island,5819694.332,Todt Hill-Emerson Hill-Lighthouse Hill-Manor Heights
19-Jul,36085018704,5018704,14092,68697,82789,Staten Island,5819694.332,Todt Hill-Emerson Hill-Lighthouse Hill-Manor Heights
21-Jul,36085018704,5018704,2110,1000,3110,Staten Island,5819694.332,Todt Hill-Emerson Hill-Lighthouse Hill-Manor Heights
19-Aug,36085018704,5018704,1732,106150,107882,Staten Island,5819694.332,Todt Hill-Emerson Hill-Lighthouse Hill-Manor Heights
21-Aug,36085018704,5018704,15066,75958,91024,Staten Island,5819694.332,Todt Hill-Emerson Hill-Lighthouse Hill-Manor Heights
19-May,36085018901,5018901,13619,53084,66703,Staten Island,12226182.36,Westerleigh-Castleton Corners
21-May,36085018901,5018901,3526,74279,77805,Staten Island,12226182.36,Westerleigh-Castleton Corners
19-Jun,36085018901,5018901,13320,53636,66956,Staten Island,12226182.36,Westerleigh-Castleton Corners
21-Jun,36085018901,5018901,8264,67390,75654,Staten Island,12226182.36,Westerleigh-Castleton Corners
19-Jul,36085018901,5018901,12806,7553,20359,Staten Island,12226182.36,Westerleigh-Castleton Corners
21-Jul,36085018901,5018901,6492,117214,123706,Staten Island,12226182.36,Westerleigh-Castleton Corners
19-Aug,36085018901,5018901,5353,83331,88684,Staten Island,12226182.36,Westerleigh-Castleton Corners
21-Aug,36085018901,5018901,15780,96705,112485,Staten Island,12226182.36,Westerleigh-Castleton Corners
19-May,36085018902,5018902,13502,103741,117243,Staten Island,8112238.605,Todt Hill-Emerson Hill-Lighthouse Hill-Manor Heights
21-May,36085018902,5018902,1846,87864,89710,Staten Island,8112238.605,Todt Hill-Emerson Hill-Lighthouse Hill-Manor Heights
19-Jun,36085018902,5018902,19630,52895,72525,Staten Island,8112238.605,Todt Hill-Emerson Hill-Lighthouse Hill-Manor Heights
21-Jun,36085018902,5018902,1512,112328,113840,Staten Island,8112238.605,Todt Hill-Emerson Hill-Lighthouse Hill-Manor Heights
19-Jul,36085018902,5018902,6086,119799,125885,Staten Island,8112238.605,Todt Hill-Emerson Hill-Lighthouse Hill-Manor Heights
21-Jul,36085018902,5018902,0,120227,120227,Staten Island,8112238.605,Todt Hill-Emerson Hill-Lighthouse Hill-Manor Heights
19-Aug,36085018902,5018902,11932,100762,112694,Staten Island,8112238.605,Todt Hill-Emerson Hill-Lighthouse Hill-Manor Heights
21-Aug,36085018902,5018902,0,77004,77004,Staten Island,8112238.605,Todt Hill-Emerson Hill-Lighthouse Hill-Manor Heights
19-May,36085019700,5019700,14086,3022,17108,Staten Island,3231720.054,Westerleigh-Castleton Corners
21-May,36085019700,5019700,10344,78051,88395,Staten Island,3231720.054,Westerleigh-Castleton Corners
19-Jun,36085019700,5019700,6838,17969,24807,Staten Island,3231720.054,Westerleigh-Castleton Corners
21-Jun,36085019700,5019700,13750,74019,87769,Staten Island,3231720.054,Westerleigh-Castleton Corners
19-Jul,36085019700,5019700,14950,83011,97961,Staten Island,3231720.054,Westerleigh-Castleton Corners
21-Jul,36085019700,5019700,8389,25396,33785,Staten Island,3231720.054,Westerleigh-Castleton Corners
19-Aug,36085019700,5019700,7320,52276,59596,Staten Island,3231720.054,Westerleigh-Castleton Corners
21-Aug,36085019700,5019700,171,53380,53551,Staten Island,3231720.054,Westerleigh-Castleton Corners
19-May,36085020100,5020100,908,83016,83924,Staten Island,6757232.279,Westerleigh-Castleton Corners
21-May,36085020100,5020100,13790,156265,170055,Staten Island,6757232.279,Westerleigh-Castleton Corners
19-Jun,36085020100,5020100,0,93368,93368,Staten Island,6757232.279,Westerleigh-Castleton Corners
21-Jun,36085020100,5020100,7149,54643,61792,Staten Island,6757232.279,Westerleigh-Castleton Corners
19-Jul,36085020100,5020100,6849,36145,42994,Staten Island,6757232.279,Westerleigh-Castleton Corners
21-Jul,36085020100,5020100,59,154837,154896,Staten Island,6757232.279,Westerleigh-Castleton Corners
19-Aug,36085020100,5020100,8335,51411,59746,Staten Island,6757232.279,Westerleigh-Castleton Corners
21-Aug,36085020100,5020100,8021,62659,70680,Staten Island,6757232.279,Westerleigh-Castleton Corners
19-May,36085020701,5020701,9222,106487,115709,Staten Island,4470663.68,Port Richmond
21-May,36085020701,5020701,2585,91515,94100,Staten Island,4470663.68,Port Richmond
19-Jun,36085020701,5020701,7034,33931,40965,Staten Island,4470663.68,Port Richmond
21-Jun,36085020701,5020701,5629,52312,57941,Staten Island,4470663.68,Port Richmond
19-Jul,36085020701,5020701,4927,96898,101825,Staten Island,4470663.68,Port Richmond
21-Jul,36085020701,5020701,16868,93962,110830,Staten Island,4470663.68,Port Richmond
19-Aug,36085020701,5020701,5406,40442,45848,Staten Island,4470663.68,Port Richmond
21-Aug,36085020701,5020701,7544,104492,112036,Staten Island,4470663.68,Port Richmond
19-May,36085020702,5020702,15917,130338,146255,Staten Island,5506694.151,Port Richmond
21-May,36085020702,5020702,10482,106908,117390,Staten Island,5506694.151,Port Richmond
19-Jun,36085020702,5020702,6976,60369,67345,Staten Island,5506694.151,Port Richmond
21-Jun,36085020702,5020702,9096,24647,33743,Staten Island,5506694.151,Port Richmond
19-Jul,36085020702,5020702,12841,78390,91231,Staten Island,5506694.151,Port Richmond
21-Jul,36085020702,5020702,11572,71,11643,Staten Island,5506694.151,Port Richmond
19-Aug,36085020702,5020702,14818,5581,20399,Staten Island,5506694.151,Port Richmond
21-Aug,36085020702,5020702,5553,44536,50089,Staten Island,5506694.151,Port Richmond
19-May,36085020804,5020804,5804,120347,126151,Staten Island,14324579.98,Annadale-Huguenot-Prince's Bay-Woodrow
21-May,36085020804,5020804,8921,64160,73081,Staten Island,14324579.98,Annadale-Huguenot-Prince's Bay-Woodrow
19-Jun,36085020804,5020804,9416,125924,135340,Staten Island,14324579.98,Annadale-Huguenot-Prince's Bay-Woodrow
21-Jun,36085020804,5020804,4040,23041,27081,Staten Island,14324579.98,Annadale-Huguenot-Prince's Bay-Woodrow
19-Jul,36085020804,5020804,13615,28567,42182,Staten Island,14324579.98,Annadale-Huguenot-Prince's Bay-Woodrow
21-Jul,36085020804,5020804,17966,100869,118835,Staten Island,14324579.98,Annadale-Huguenot-Prince's Bay-Woodrow
19-Aug,36085020804,5020804,5036,146365,151401,Staten Island,14324579.98,Annadale-Huguenot-Prince's Bay-Woodrow
21-Aug,36085020804,5020804,9571,64342,73913,Staten Island,14324579.98,Annadale-Huguenot-Prince's Bay-Woodrow
19-May,36085020805,5020805,14107,71395,85502,Staten Island,12213857.91,Arden Heights-Rossville
21-May,36085020805,5020805,379,135444,135823,Staten Island,12213857.91,Arden Heights-Rossville
19-Jun,36085020805,5020805,10893,93256,104149,Staten Island,12213857.91,Arden Heights-Rossville
21-Jun,36085020805,5020805,14513,115776,130289,Staten Island,12213857.91,Arden Heights-Rossville
19-Jul,36085020805,5020805,1635,51972,53607,Staten Island,12213857.91,Arden Heights-Rossville
21-Jul,36085020805,5020805,7276,10981,18257,Staten Island,12213857.91,Arden Heights-Rossville
19-Aug,36085020805,5020805,10766,18300,29066,Staten Island,12213857.91,Arden Heights-Rossville
21-Aug,36085020805,5020805,14066,87458,101524,Staten Island,12213857.91,Arden Heights-Rossville
19-May,36085020806,5020806,14806,29134,43940,Staten Island,15801720.54,Arden Heights-Rossville
21-May,36085020806,5020806,4633,82173,86806,Staten Island,15801720.54,Arden Heights-Rossville
19-Jun,36085020806,5020806,2157,46650,48807,Staten Island,15801720.54,Arden Heights-Rossville
21-Jun,36085020806,5020806,14186,32122,46308,Staten Island,15801720.54,Arden Heights-Rossville
19-Jul,36085020806,5020806,10980,92008,102988,Staten Island,15801720.54,Arden Heights-Rossville
21-Jul,36085020806,5020806,7826,106221,114047,Staten Island,15801720.54,Arden Heights-Rossville
19-Aug,36085020806,5020806,14435,23506,37941,Staten Island,15801720.54,Arden Heights-Rossville
21-Aug,36085020806,5020806,4018,15757,19775,Staten Island,15801720.54,Arden Heights-Rossville
19-May,36085022300,5022300,14455,86518,100973,Staten Island,7078229.871,Mariner's Harbor-Arlington-Graniteville
21-May,36085022300,5022300,12816,101327,114143,Staten Island,7078229.871,Mariner's Harbor-Arlington-Graniteville
19-Jun,36085022300,5022300,1789,88410,90199,Staten Island,7078229.871,Mariner's Harbor-Arlington-Graniteville
21-Jun,36085022300,5022300,10149,61838,71987,Staten Island,7078229.871,Mariner's Harbor-Arlington-Graniteville
19-Jul,36085022300,5022300,5007,131479,136486,Staten Island,7078229.871,Mariner's Harbor-Arlington-Graniteville
21-Jul,36085022300,5022300,6345,60198,66543,Staten Island,7078229.871,Mariner's Harbor-Arlington-Graniteville
19-Aug,36085022300,5022300,1286,44186,45472,Staten Island,7078229.871,Mariner's Harbor-Arlington-Graniteville
21-Aug,36085022300,5022300,212,55740,55952,Staten Island,7078229.871,Mariner's Harbor-Arlington-Graniteville
19-May,36085022601,5022601,10666,116786,127452,Staten Island,18760157.85,Annadale-Huguenot-Prince's Bay-Woodrow
21-May,36085022601,5022601,3567,165725,169292,Staten Island,18760157.85,Annadale-Huguenot-Prince's Bay-Woodrow
19-Jun,36085022601,5022601,7576,48293,55869,Staten Island,18760157.85,Annadale-Huguenot-Prince's Bay-Woodrow
21-Jun,36085022601,5022601,3587,113314,116901,Staten Island,18760157.85,Annadale-Huguenot-Prince's Bay-Woodrow
19-Jul,36085022601,5022601,7460,35223,42683,Staten Island,18760157.85,Annadale-Huguenot-Prince's Bay-Woodrow
21-Jul,36085022601,5022601,13248,71523,84771,Staten Island,18760157.85,Annadale-Huguenot-Prince's Bay-Woodrow
19-Aug,36085022601,5022601,2842,84014,86856,Staten Island,18760157.85,Annadale-Huguenot-Prince's Bay-Woodrow
21-Aug,36085022601,5022601,14256,69566,83822,Staten Island,18760157.85,Annadale-Huguenot-Prince's Bay-Woodrow
19-May,36085022801,5022801,8347,48016,56363,Staten Island,47758768.57,Freshkills Park (South)
21-May,36085022801,5022801,3569,73752,77321,Staten Island,47758768.57,Freshkills Park (South)
19-Jun,36085022801,5022801,9262,79136,88398,Staten Island,47758768.57,Freshkills Park (South)
21-Jun,36085022801,5022801,10379,123342,133721,Staten Island,47758768.57,Freshkills Park (South)
19-Jul,36085022801,5022801,25,89254,89279,Staten Island,47758768.57,Freshkills Park (South)
21-Jul,36085022801,5022801,5831,71,5902,Staten Island,47758768.57,Freshkills Park (South)
19-Aug,36085022801,5022801,850,76229,77079,Staten Island,47758768.57,Freshkills Park (South)
21-Aug,36085022801,5022801,8586,98311,106897,Staten Island,47758768.57,Freshkills Park (South)
19-May,36085023100,5023100,17386,28248,45634,Staten Island,6280175.455,Mariner's Harbor-Arlington-Graniteville
21-May,36085023100,5023100,5778,122302,128080,Staten Island,6280175.455,Mariner's Harbor-Arlington-Graniteville
19-Jun,36085023100,5023100,4529,101329,105858,Staten Island,6280175.455,Mariner's Harbor-Arlington-Graniteville
21-Jun,36085023100,5023100,1263,86510,87773,Staten Island,6280175.455,Mariner's Harbor-Arlington-Graniteville
19-Jul,36085023100,5023100,15537,132640,148177,Staten Island,6280175.455,Mariner's Harbor-Arlington-Graniteville
21-Jul,36085023100,5023100,8528,69713,78241,Staten Island,6280175.455,Mariner's Harbor-Arlington-Graniteville
19-Aug,36085023100,5023100,8098,100709,108807,Staten Island,6280175.455,Mariner's Harbor-Arlington-Graniteville
21-Aug,36085023100,5023100,14021,81792,95813,Staten Island,6280175.455,Mariner's Harbor-Arlington-Graniteville
19-May,36085023900,5023900,4301,88435,92736,Staten Island,5704405.743,Mariner's Harbor-Arlington-Graniteville
21-May,36085023900,5023900,0,142898,142898,Staten Island,5704405.743,Mariner's Harbor-Arlington-Graniteville
19-Jun,36085023900,5023900,7773,129578,137351,Staten Island,5704405.743,Mariner's Harbor-Arlington-Graniteville
21-Jun,36085023900,5023900,11281,86656,97937,Staten Island,5704405.743,Mariner's Harbor-Arlington-Graniteville
19-Jul,36085023900,5023900,19773,11848,31621,Staten Island,5704405.743,Mariner's Harbor-Arlington-Graniteville
21-Jul,36085023900,5023900,8474,137647,146121,Staten Island,5704405.743,Mariner's Harbor-Arlington-Graniteville
19-Aug,36085023900,5023900,17810,103407,121217,Staten Island,5704405.743,Mariner's Harbor-Arlington-Graniteville
21-Aug,36085023900,5023900,16080,121314,137394,Staten Island,5704405.743,Mariner's Harbor-Arlington-Graniteville
19-May,36085024401,5024401,8400,71,8471,Staten Island,22561115.09,Tottenville-Charleston
21-May,36085024401,5024401,18819,61941,80760,Staten Island,22561115.09,Tottenville-Charleston
19-Jun,36085024401,5024401,8937,80108,89045,Staten Island,22561115.09,Tottenville-Charleston
21-Jun,36085024401,5024401,9619,76040,85659,Staten Island,22561115.09,Tottenville-Charleston
19-Jul,36085024401,5024401,4619,48402,53021,Staten Island,22561115.09,Tottenville-Charleston
21-Jul,36085024401,5024401,7849,32560,40409,Staten Island,22561115.09,Tottenville-Charleston
19-Aug,36085024401,5024401,8583,39074,47657,Staten Island,22561115.09,Tottenville-Charleston
21-Aug,36085024401,5024401,13855,48954,62809,Staten Island,22561115.09,Tottenville-Charleston
19-May,36085024402,5024402,12106,94724,106830,Staten Island,19138069.14,Tottenville-Charleston
21-May,36085024402,5024402,7740,69537,77277,Staten Island,19138069.14,Tottenville-Charleston
19-Jun,36085024402,5024402,8503,67570,76073,Staten Island,19138069.14,Tottenville-Charleston
21-Jun,36085024402,5024402,7521,97333,104854,Staten Island,19138069.14,Tottenville-Charleston
19-Jul,36085024402,5024402,0,134874,134874,Staten Island,19138069.14,Tottenville-Charleston
21-Jul,36085024402,5024402,4885,14005,18890,Staten Island,19138069.14,Tottenville-Charleston
19-Aug,36085024402,5024402,1777,26489,28266,Staten Island,19138069.14,Tottenville-Charleston
21-Aug,36085024402,5024402,11197,122123,133320,Staten Island,19138069.14,Tottenville-Charleston
19-May,36085025100,5025100,9576,75866,85442,Staten Island,12586951.55,Westerleigh-Castleton Corners
21-May,36085025100,5025100,2384,111399,113783,Staten Island,12586951.55,Westerleigh-Castleton Corners
19-Jun,36085025100,5025100,15925,96565,112490,Staten Island,12586951.55,Westerleigh-Castleton Corners
21-Jun,36085025100,5025100,11235,46500,57735,Staten Island,12586951.55,Westerleigh-Castleton Corners
19-Jul,36085025100,5025100,11921,92952,104873,Staten Island,12586951.55,Westerleigh-Castleton Corners
21-Jul,36085025100,5025100,6945,55757,62702,Staten Island,12586951.55,Westerleigh-Castleton Corners
19-Aug,36085025100,5025100,10536,87880,98416,Staten Island,12586951.55,Westerleigh-Castleton Corners
21-Aug,36085025100,5025100,4766,63304,68070,Staten Island,12586951.55,Westerleigh-Castleton Corners
19-May,36085027301,5027301,16592,36855,53447,Staten Island,32658814.05,New Springville-Willowbrook-Bulls Head-Travis
21-May,36085027301,5027301,0,32044,32044,Staten Island,32658814.05,New Springville-Willowbrook-Bulls Head-Travis
19-Jun,36085027301,5027301,5062,13622,18684,Staten Island,32658814.05,New Springville-Willowbrook-Bulls Head-Travis
21-Jun,36085027301,5027301,944,35111,36055,Staten Island,32658814.05,New Springville-Willowbrook-Bulls Head-Travis
19-Jul,36085027301,5027301,9534,65135,74669,Staten Island,32658814.05,New Springville-Willowbrook-Bulls Head-Travis
21-Jul,36085027301,5027301,16293,108273,124566,Staten Island,32658814.05,New Springville-Willowbrook-Bulls Head-Travis
19-Aug,36085027301,5027301,10147,48142,58289,Staten Island,32658814.05,New Springville-Willowbrook-Bulls Head-Travis
21-Aug,36085027301,5027301,4781,123371,128152,Staten Island,32658814.05,New Springville-Willowbrook-Bulls Head-Travis
19-May,36085027302,5027302,15447,81999,97446,Staten Island,11010889.77,Todt Hill-Emerson Hill-Lighthouse Hill-Manor Heights
21-May,36085027302,5027302,7412,58961,66373,Staten Island,11010889.77,Todt Hill-Emerson Hill-Lighthouse Hill-Manor Heights
19-Jun,36085027302,5027302,6592,25399,31991,Staten Island,11010889.77,Todt Hill-Emerson Hill-Lighthouse Hill-Manor Heights
21-Jun,36085027302,5027302,16268,44464,60732,Staten Island,11010889.77,Todt Hill-Emerson Hill-Lighthouse Hill-Manor Heights
19-Jul,36085027302,5027302,10150,35653,45803,Staten Island,11010889.77,Todt Hill-Emerson Hill-Lighthouse Hill-Manor Heights
21-Jul,36085027302,5027302,4382,36331,40713,Staten Island,11010889.77,Todt Hill-Emerson Hill-Lighthouse Hill-Manor Heights
19-Aug,36085027302,5027302,8425,54037,62462,Staten Island,11010889.77,Todt Hill-Emerson Hill-Lighthouse Hill-Manor Heights
21-Aug,36085027302,5027302,17137,62605,79742,Staten Island,11010889.77,Todt Hill-Emerson Hill-Lighthouse Hill-Manor Heights
19-May,36085027704,5027704,18174,86099,104273,Staten Island,5789587.914,New Springville-Willowbrook-Bulls Head-Travis
21-May,36085027704,5027704,5759,16853,22612,Staten Island,5789587.914,New Springville-Willowbrook-Bulls Head-Travis
19-Jun,36085027704,5027704,0,94733,94733,Staten Island,5789587.914,New Springville-Willowbrook-Bulls Head-Travis
21-Jun,36085027704,5027704,7095,3930,11025,Staten Island,5789587.914,New Springville-Willowbrook-Bulls Head-Travis
19-Jul,36085027704,5027704,3175,49258,52433,Staten Island,5789587.914,New Springville-Willowbrook-Bulls Head-Travis
21-Jul,36085027704,5027704,6588,9105,15693,Staten Island,5789587.914,New Springville-Willowbrook-Bulls Head-Travis
19-Aug,36085027704,5027704,9035,40494,49529,Staten Island,5789587.914,New Springville-Willowbrook-Bulls Head-Travis
21-Aug,36085027704,5027704,9975,118449,128424,Staten Island,5789587.914,New Springville-Willowbrook-Bulls Head-Travis
19-May,36085027705,5027705,7190,68906,76096,Staten Island,5721086.65,New Springville-Willowbrook-Bulls Head-Travis
21-May,36085027705,5027705,16850,64514,81364,Staten Island,5721086.65,New Springville-Willowbrook-Bulls Head-Travis
19-Jun,36085027705,5027705,8065,60339,68404,Staten Island,5721086.65,New Springville-Willowbrook-Bulls Head-Travis
21-Jun,36085027705,5027705,7747,59757,67504,Staten Island,5721086.65,New Springville-Willowbrook-Bulls Head-Travis
19-Jul,36085027705,5027705,10117,61970,72087,Staten Island,5721086.65,New Springville-Willowbrook-Bulls Head-Travis
21-Jul,36085027705,5027705,13628,71,13699,Staten Island,5721086.65,New Springville-Willowbrook-Bulls Head-Travis
19-Aug,36085027705,5027705,10554,74118,84672,Staten Island,5721086.65,New Springville-Willowbrook-Bulls Head-Travis
21-Aug,36085027705,5027705,7851,86641,94492,Staten Island,5721086.65,New Springville-Willowbrook-Bulls Head-Travis
19-May,36085027900,5027900,16097,58360,74457,Staten Island,58236964.47,Todt Hill-Emerson Hill-Lighthouse Hill-Manor Heights
21-May,36085027900,5027900,15207,50645,65852,Staten Island,58236964.47,Todt Hill-Emerson Hill-Lighthouse Hill-Manor Heights
19-Jun,36085027900,5027900,2548,75242,77790,Staten Island,58236964.47,Todt Hill-Emerson Hill-Lighthouse Hill-Manor Heights
21-Jun,36085027900,5027900,10647,95636,106283,Staten Island,58236964.47,Todt Hill-Emerson Hill-Lighthouse Hill-Manor Heights
19-Jul,36085027900,5027900,8893,48216,57109,Staten Island,58236964.47,Todt Hill-Emerson Hill-Lighthouse Hill-Manor Heights
21-Jul,36085027900,5027900,3043,84004,87047,Staten Island,58236964.47,Todt Hill-Emerson Hill-Lighthouse Hill-Manor Heights
19-Aug,36085027900,5027900,8977,173044,182021,Staten Island,58236964.47,Todt Hill-Emerson Hill-Lighthouse Hill-Manor Heights
21-Aug,36085027900,5027900,7539,60287,67826,Staten Island,58236964.47,Todt Hill-Emerson Hill-Lighthouse Hill-Manor Heights
19-May,36085029105,5029105,17742,32471,50213,Staten Island,17331554.93,New Springville-Willowbrook-Bulls Head-Travis
21-May,36085029105,5029105,11581,93760,105341,Staten Island,17331554.93,New Springville-Willowbrook-Bulls Head-Travis
19-Jun,36085029105,5029105,4326,115385,119711,Staten Island,17331554.93,New Springville-Willowbrook-Bulls Head-Travis
21-Jun,36085029105,5029105,10015,71464,81479,Staten Island,17331554.93,New Springville-Willowbrook-Bulls Head-Travis
19-Jul,36085029105,5029105,11547,11485,23032,Staten Island,17331554.93,New Springville-Willowbrook-Bulls Head-Travis
21-Jul,36085029105,5029105,3716,77804,81520,Staten Island,17331554.93,New Springville-Willowbrook-Bulls Head-Travis
19-Aug,36085029105,5029105,11055,114006,125061,Staten Island,17331554.93,New Springville-Willowbrook-Bulls Head-Travis
21-Aug,36085029105,5029105,8010,95848,103858,Staten Island,17331554.93,New Springville-Willowbrook-Bulls Head-Travis
19-May,36085030302,5030302,13260,25912,39172,Staten Island,9788180.62,Mariner's Harbor-Arlington-Graniteville
21-May,36085030302,5030302,0,172275,172275,Staten Island,9788180.62,Mariner's Harbor-Arlington-Graniteville
19-Jun,36085030302,5030302,16488,71,16559,Staten Island,9788180.62,Mariner's Harbor-Arlington-Graniteville
21-Jun,36085030302,5030302,6875,36079,42954,Staten Island,9788180.62,Mariner's Harbor-Arlington-Graniteville
19-Jul,36085030302,5030302,6648,119397,126045,Staten Island,9788180.62,Mariner's Harbor-Arlington-Graniteville
21-Jul,36085030302,5030302,0,31478,31478,Staten Island,9788180.62,Mariner's Harbor-Arlington-Graniteville
19-Aug,36085030302,5030302,13051,171761,184812,Staten Island,9788180.62,Mariner's Harbor-Arlington-Graniteville
21-Aug,36085030302,5030302,4198,55800,59998,Staten Island,9788180.62,Mariner's Harbor-Arlington-Graniteville
19-May,36085031902,5031902,9480,87222,96702,Staten Island,7019454.696,Mariner's Harbor-Arlington-Graniteville
21-May,36085031902,5031902,10313,98602,108915,Staten Island,7019454.696,Mariner's Harbor-Arlington-Graniteville
19-Jun,36085031902,5031902,6633,16270,22903,Staten Island,7019454.696,Mariner's Harbor-Arlington-Graniteville
21-Jun,36085031902,5031902,10044,150653,160697,Staten Island,7019454.696,Mariner's Harbor-Arlington-Graniteville
19-Jul,36085031902,5031902,7040,8596,15636,Staten Island,7019454.696,Mariner's Harbor-Arlington-Graniteville
21-Jul,36085031902,5031902,8082,11225,19307,Staten Island,7019454.696,Mariner's Harbor-Arlington-Graniteville
19-Aug,36085031902,5031902,3290,49200,52490,Staten Island,7019454.696,Mariner's Harbor-Arlington-Graniteville
21-Aug,36085031902,5031902,8371,34589,42960,Staten Island,7019454.696,Mariner's Harbor-Arlington-Graniteville
19-May,36047000100,3000100,10118,74415,84533,Brooklyn,2224101.05,Brooklyn Heights
21-May,36047000100,3000100,12826,82490,95316,Brooklyn,2224101.05,Brooklyn Heights
19-Jun,36047000100,3000100,8291,105124,113415,Brooklyn,2224101.05,Brooklyn Heights
21-Jun,36047000100,3000100,11911,105431,117342,Brooklyn,2224101.05,Brooklyn Heights
19-Jul,36047000100,3000100,7047,146549,153596,Brooklyn,2224101.05,Brooklyn Heights
21-Jul,36047000100,3000100,9437,28770,38207,Brooklyn,2224101.05,Brooklyn Heights
19-Aug,36047000100,3000100,11628,54189,65817,Brooklyn,2224101.05,Brooklyn Heights
21-Aug,36047000100,3000100,16812,167257,184069,Brooklyn,2224101.05,Brooklyn Heights
19-May,36047000301,3000301,14797,68943,83740,Brooklyn,2164337.284,Brooklyn Heights
21-May,36047000301,3000301,6874,147488,154362,Brooklyn,2164337.284,Brooklyn Heights
19-Jun,36047000301,3000301,15554,36518,52072,Brooklyn,2164337.284,Brooklyn Heights
21-Jun,36047000301,3000301,717,110178,110895,Brooklyn,2164337.284,Brooklyn Heights
19-Jul,36047000301,3000301,6214,17332,23546,Brooklyn,2164337.284,Brooklyn Heights
21-Jul,36047000301,3000301,13971,88596,102567,Brooklyn,2164337.284,Brooklyn Heights
19-Aug,36047000301,3000301,11380,103663,115043,Brooklyn,2164337.284,Brooklyn Heights
21-Aug,36047000301,3000301,5619,57714,63333,Brooklyn,2164337.284,Brooklyn Heights
19-May,36047000501,3000501,10702,115740,126442,Brooklyn,901507.0302,Brooklyn Heights
21-May,36047000501,3000501,5165,90107,95272,Brooklyn,901507.0302,Brooklyn Heights
19-Jun,36047000501,3000501,5460,7448,12908,Brooklyn,901507.0302,Brooklyn Heights
21-Jun,36047000501,3000501,11103,101042,112145,Brooklyn,901507.0302,Brooklyn Heights
19-Jul,36047000501,3000501,15946,102415,118361,Brooklyn,901507.0302,Brooklyn Heights
21-Jul,36047000501,3000501,7373,34008,41381,Brooklyn,901507.0302,Brooklyn Heights
19-Aug,36047000501,3000501,4627,35305,39932,Brooklyn,901507.0302,Brooklyn Heights
21-Aug,36047000501,3000501,10781,44856,55637,Brooklyn,901507.0302,Brooklyn Heights
19-May,36047000502,3000502,10440,117408,127848,Brooklyn,1041529.091,Brooklyn Heights
21-May,36047000502,3000502,5394,54817,60211,Brooklyn,1041529.091,Brooklyn Heights
19-Jun,36047000502,3000502,4669,63526,68195,Brooklyn,1041529.091,Brooklyn Heights
21-Jun,36047000502,3000502,14883,69265,84148,Brooklyn,1041529.091,Brooklyn Heights
19-Jul,36047000502,3000502,8862,71,8933,Brooklyn,1041529.091,Brooklyn Heights
21-Jul,36047000502,3000502,12511,112550,125061,Brooklyn,1041529.091,Brooklyn Heights
19-Aug,36047000502,3000502,0,47340,47340,Brooklyn,1041529.091,Brooklyn Heights
21-Aug,36047000502,3000502,11572,74953,86525,Brooklyn,1041529.091,Brooklyn Heights
19-May,36047000700,3000700,7018,116026,123044,Brooklyn,1881577.59,Brooklyn Heights
21-May,36047000700,3000700,16037,79712,95749,Brooklyn,1881577.59,Brooklyn Heights
19-Jun,36047000700,3000700,10432,81207,91639,Brooklyn,1881577.59,Brooklyn Heights
21-Jun,36047000700,3000700,7934,43116,51050,Brooklyn,1881577.59,Brooklyn Heights
19-Jul,36047000700,3000700,4984,59362,64346,Brooklyn,1881577.59,Brooklyn Heights
21-Jul,36047000700,3000700,11042,121596,132638,Brooklyn,1881577.59,Brooklyn Heights
19-Aug,36047000700,3000700,11838,75649,87487,Brooklyn,1881577.59,Brooklyn Heights
21-Aug,36047000700,3000700,4238,60031,64269,Brooklyn,1881577.59,Brooklyn Heights
19-May,36047001502,3001502,9952,20571,30523,Brooklyn,1520130.885,Downtown Brooklyn-DUMBO-Boerum Hill
21-May,36047001502,3001502,0,99907,99907,Brooklyn,1520130.885,Downtown Brooklyn-DUMBO-Boerum Hill
19-Jun,36047001502,3001502,1578,81260,82838,Brooklyn,1520130.885,Downtown Brooklyn-DUMBO-Boerum Hill
21-Jun,36047001502,3001502,16156,90458,106614,Brooklyn,1520130.885,Downtown Brooklyn-DUMBO-Boerum Hill
19-Jul,36047001502,3001502,18189,133530,151719,Brooklyn,1520130.885,Downtown Brooklyn-DUMBO-Boerum Hill
21-Jul,36047001502,3001502,585,123287,123872,Brooklyn,1520130.885,Downtown Brooklyn-DUMBO-Boerum Hill
19-Aug,36047001502,3001502,5739,48278,54017,Brooklyn,1520130.885,Downtown Brooklyn-DUMBO-Boerum Hill
21-Aug,36047001502,3001502,1334,73161,74495,Brooklyn,1520130.885,Downtown Brooklyn-DUMBO-Boerum Hill
19-May,36047001803,3001803,4768,48552,53320,Brooklyn,6887216.967,Sunset Park (West)
21-May,36047001803,3001803,11289,88278,99567,Brooklyn,6887216.967,Sunset Park (West)
19-Jun,36047001803,3001803,15713,102952,118665,Brooklyn,6887216.967,Sunset Park (West)
21-Jun,36047001803,3001803,10454,82650,93104,Brooklyn,6887216.967,Sunset Park (West)
19-Jul,36047001803,3001803,11898,36534,48432,Brooklyn,6887216.967,Sunset Park (West)
21-Jul,36047001803,3001803,3403,16658,20061,Brooklyn,6887216.967,Sunset Park (West)
19-Aug,36047001803,3001803,17882,129908,147790,Brooklyn,6887216.967,Sunset Park (West)
21-Aug,36047001803,3001803,2031,49695,51726,Brooklyn,6887216.967,Sunset Park (West)
19-May,36047002000,3002000,9327,77312,86639,Brooklyn,1620781.084,Sunset Park (West)
21-May,36047002000,3002000,7311,58794,66105,Brooklyn,1620781.084,Sunset Park (West)
19-Jun,36047002000,3002000,12966,82356,95322,Brooklyn,1620781.084,Sunset Park (West)
21-Jun,36047002000,3002000,6016,55847,61863,Brooklyn,1620781.084,Sunset Park (West)
19-Jul,36047002000,3002000,15258,70490,85748,Brooklyn,1620781.084,Sunset Park (West)
21-Jul,36047002000,3002000,0,8620,8620,Brooklyn,1620781.084,Sunset Park (West)
19-Aug,36047002000,3002000,5098,71,5169,Brooklyn,1620781.084,Sunset Park (West)
21-Aug,36047002000,3002000,5774,80703,86477,Brooklyn,1620781.084,Sunset Park (West)
19-May,36047003000,3003000,12057,49827,61884,Brooklyn,1185319.867,Bay Ridge
21-May,36047003000,3003000,11530,83654,95184,Brooklyn,1185319.867,Bay Ridge
19-Jun,36047003000,3003000,7353,75727,83080,Brooklyn,1185319.867,Bay Ridge
21-Jun,36047003000,3003000,4131,55352,59483,Brooklyn,1185319.867,Bay Ridge
19-Jul,36047003000,3003000,1966,74417,76383,Brooklyn,1185319.867,Bay Ridge
21-Jul,36047003000,3003000,3928,66254,70182,Brooklyn,1185319.867,Bay Ridge
19-Aug,36047003000,3003000,11563,67814,79377,Brooklyn,1185319.867,Bay Ridge
21-Aug,36047003000,3003000,4429,146899,151328,Brooklyn,1185319.867,Bay Ridge
19-May,36047003101,3003101,8786,163429,172215,Brooklyn,1622624.713,Fort Greene
21-May,36047003101,3003101,13186,66531,79717,Brooklyn,1622624.713,Fort Greene
19-Jun,36047003101,3003101,12068,82226,94294,Brooklyn,1622624.713,Fort Greene
21-Jun,36047003101,3003101,11687,40008,51695,Brooklyn,1622624.713,Fort Greene
19-Jul,36047003101,3003101,7878,105949,113827,Brooklyn,1622624.713,Fort Greene
21-Jul,36047003101,3003101,3481,43843,47324,Brooklyn,1622624.713,Fort Greene
19-Aug,36047003101,3003101,7934,48454,56388,Brooklyn,1622624.713,Fort Greene
21-Aug,36047003101,3003101,4220,125325,129545,Brooklyn,1622624.713,Fort Greene
19-May,36047003102,3003102,6980,72712,79692,Brooklyn,1467354.689,Fort Greene
21-May,36047003102,3003102,5002,61279,66281,Brooklyn,1467354.689,Fort Greene
19-Jun,36047003102,3003102,6531,124888,131419,Brooklyn,1467354.689,Fort Greene
21-Jun,36047003102,3003102,5595,46673,52268,Brooklyn,1467354.689,Fort Greene
19-Jul,36047003102,3003102,9114,138116,147230,Brooklyn,1467354.689,Fort Greene
21-Jul,36047003102,3003102,16255,46894,63149,Brooklyn,1467354.689,Fort Greene
19-Aug,36047003102,3003102,5420,68838,74258,Brooklyn,1467354.689,Fort Greene
21-Aug,36047003102,3003102,14814,40946,55760,Brooklyn,1467354.689,Fort Greene
19-May,36047003300,3003300,4678,67250,71928,Brooklyn,1770404.993,Fort Greene
21-May,36047003300,3003300,16002,111063,127065,Brooklyn,1770404.993,Fort Greene
19-Jun,36047003300,3003300,17672,63542,81214,Brooklyn,1770404.993,Fort Greene
21-Jun,36047003300,3003300,15409,55739,71148,Brooklyn,1770404.993,Fort Greene
19-Jul,36047003300,3003300,10402,110296,120698,Brooklyn,1770404.993,Fort Greene
21-Jul,36047003300,3003300,12754,80107,92861,Brooklyn,1770404.993,Fort Greene
19-Aug,36047003300,3003300,7316,51558,58874,Brooklyn,1770404.993,Fort Greene
21-Aug,36047003300,3003300,12606,78248,90854,Brooklyn,1770404.993,Fort Greene
19-May,36047003400,3003400,12485,5512,17997,Brooklyn,5196417.598,Bay Ridge
21-May,36047003400,3003400,8882,121051,129933,Brooklyn,5196417.598,Bay Ridge
19-Jun,36047003400,3003400,9706,22707,32413,Brooklyn,5196417.598,Bay Ridge
21-Jun,36047003400,3003400,3147,16573,19720,Brooklyn,5196417.598,Bay Ridge
19-Jul,36047003400,3003400,9258,146577,155835,Brooklyn,5196417.598,Bay Ridge
21-Jul,36047003400,3003400,4944,34678,39622,Brooklyn,5196417.598,Bay Ridge
19-Aug,36047003400,3003400,14644,38413,53057,Brooklyn,5196417.598,Bay Ridge
21-Aug,36047003400,3003400,3491,113487,116978,Brooklyn,5196417.598,Bay Ridge
19-May,36047003500,3003500,3784,26822,30606,Brooklyn,1433175.23,Fort Greene
21-May,36047003500,3003500,16083,89325,105408,Brooklyn,1433175.23,Fort Greene
19-Jun,36047003500,3003500,6295,60503,66798,Brooklyn,1433175.23,Fort Greene
21-Jun,36047003500,3003500,17771,79525,97296,Brooklyn,1433175.23,Fort Greene
19-Jul,36047003500,3003500,13929,65132,79061,Brooklyn,1433175.23,Fort Greene
21-Jul,36047003500,3003500,4046,93333,97379,Brooklyn,1433175.23,Fort Greene
19-Aug,36047003500,3003500,2879,93449,96328,Brooklyn,1433175.23,Fort Greene
21-Aug,36047003500,3003500,6192,46730,52922,Brooklyn,1433175.23,Fort Greene
19-May,36047003600,3003600,16838,90778,107616,Brooklyn,1348886.986,Bay Ridge
21-May,36047003600,3003600,5522,64572,70094,Brooklyn,1348886.986,Bay Ridge
19-Jun,36047003600,3003600,11536,57997,69533,Brooklyn,1348886.986,Bay Ridge
21-Jun,36047003600,3003600,11998,96217,108215,Brooklyn,1348886.986,Bay Ridge
19-Jul,36047003600,3003600,11773,22194,33967,Brooklyn,1348886.986,Bay Ridge
21-Jul,36047003600,3003600,5756,53325,59081,Brooklyn,1348886.986,Bay Ridge
19-Aug,36047003600,3003600,17933,61220,79153,Brooklyn,1348886.986,Bay Ridge
21-Aug,36047003600,3003600,0,88692,88692,Brooklyn,1348886.986,Bay Ridge
19-May,36047003700,3003700,0,71,71,Brooklyn,1788976.497,Downtown Brooklyn-DUMBO-Boerum Hill
21-May,36047003700,3003700,8931,42453,51384,Brooklyn,1788976.497,Downtown Brooklyn-DUMBO-Boerum Hill
19-Jun,36047003700,3003700,4803,32530,37333,Brooklyn,1788976.497,Downtown Brooklyn-DUMBO-Boerum Hill
21-Jun,36047003700,3003700,12824,73374,86198,Brooklyn,1788976.497,Downtown Brooklyn-DUMBO-Boerum Hill
19-Jul,36047003700,3003700,0,12987,12987,Brooklyn,1788976.497,Downtown Brooklyn-DUMBO-Boerum Hill
21-Jul,36047003700,3003700,5808,65884,71692,Brooklyn,1788976.497,Downtown Brooklyn-DUMBO-Boerum Hill
19-Aug,36047003700,3003700,14699,78166,92865,Brooklyn,1788976.497,Downtown Brooklyn-DUMBO-Boerum Hill
21-Aug,36047003700,3003700,5594,134880,140474,Brooklyn,1788976.497,Downtown Brooklyn-DUMBO-Boerum Hill
19-May,36047003800,3003800,14549,59269,73818,Brooklyn,1367702.874,Bay Ridge
21-May,36047003800,3003800,10541,112248,122789,Brooklyn,1367702.874,Bay Ridge
19-Jun,36047003800,3003800,7284,62748,70032,Brooklyn,1367702.874,Bay Ridge
21-Jun,36047003800,3003800,7245,87523,94768,Brooklyn,1367702.874,Bay Ridge
19-Jul,36047003800,3003800,8820,46671,55491,Brooklyn,1367702.874,Bay Ridge
21-Jul,36047003800,3003800,10469,68725,79194,Brooklyn,1367702.874,Bay Ridge
19-Aug,36047003800,3003800,4476,82124,86600,Brooklyn,1367702.874,Bay Ridge
21-Aug,36047003800,3003800,14071,62648,76719,Brooklyn,1367702.874,Bay Ridge
19-May,36047003900,3003900,4397,102592,106989,Brooklyn,1681273.004,Downtown Brooklyn-DUMBO-Boerum Hill
21-May,36047003900,3003900,9144,65895,75039,Brooklyn,1681273.004,Downtown Brooklyn-DUMBO-Boerum Hill
19-Jun,36047003900,3003900,7996,79647,87643,Brooklyn,1681273.004,Downtown Brooklyn-DUMBO-Boerum Hill
21-Jun,36047003900,3003900,3063,123872,126935,Brooklyn,1681273.004,Downtown Brooklyn-DUMBO-Boerum Hill
19-Jul,36047003900,3003900,4896,118717,123613,Brooklyn,1681273.004,Downtown Brooklyn-DUMBO-Boerum Hill
21-Jul,36047003900,3003900,10584,13187,23771,Brooklyn,1681273.004,Downtown Brooklyn-DUMBO-Boerum Hill
19-Aug,36047003900,3003900,8676,49092,57768,Brooklyn,1681273.004,Downtown Brooklyn-DUMBO-Boerum Hill
21-Aug,36047003900,3003900,5566,77267,82833,Brooklyn,1681273.004,Downtown Brooklyn-DUMBO-Boerum Hill
19-May,36047004100,3004100,4797,44381,49178,Brooklyn,1743811.534,Downtown Brooklyn-DUMBO-Boerum Hill
21-May,36047004100,3004100,4246,94115,98361,Brooklyn,1743811.534,Downtown Brooklyn-DUMBO-Boerum Hill
19-Jun,36047004100,3004100,10520,42931,53451,Brooklyn,1743811.534,Downtown Brooklyn-DUMBO-Boerum Hill
21-Jun,36047004100,3004100,12034,100420,112454,Brooklyn,1743811.534,Downtown Brooklyn-DUMBO-Boerum Hill
19-Jul,36047004100,3004100,3569,67218,70787,Brooklyn,1743811.534,Downtown Brooklyn-DUMBO-Boerum Hill
21-Jul,36047004100,3004100,10270,138738,149008,Brooklyn,1743811.534,Downtown Brooklyn-DUMBO-Boerum Hill
19-Aug,36047004100,3004100,12369,44298,56667,Brooklyn,1743811.534,Downtown Brooklyn-DUMBO-Boerum Hill
21-Aug,36047004100,3004100,12978,48394,61372,Brooklyn,1743811.534,Downtown Brooklyn-DUMBO-Boerum Hill
19-May,36047004300,3004300,4614,124336,128950,Brooklyn,1774542.768,Downtown Brooklyn-DUMBO-Boerum Hill
21-May,36047004300,3004300,0,56589,56589,Brooklyn,1774542.768,Downtown Brooklyn-DUMBO-Boerum Hill
19-Jun,36047004300,3004300,3781,36913,40694,Brooklyn,1774542.768,Downtown Brooklyn-DUMBO-Boerum Hill
21-Jun,36047004300,3004300,6784,113982,120766,Brooklyn,1774542.768,Downtown Brooklyn-DUMBO-Boerum Hill
19-Jul,36047004300,3004300,9263,15110,24373,Brooklyn,1774542.768,Downtown Brooklyn-DUMBO-Boerum Hill
21-Jul,36047004300,3004300,0,38700,38700,Brooklyn,1774542.768,Downtown Brooklyn-DUMBO-Boerum Hill
19-Aug,36047004300,3004300,0,8547,8547,Brooklyn,1774542.768,Downtown Brooklyn-DUMBO-Boerum Hill
21-Aug,36047004300,3004300,4393,66692,71085,Brooklyn,1774542.768,Downtown Brooklyn-DUMBO-Boerum Hill
19-May,36047004400,3004400,1733,71,1804,Brooklyn,4502927.988,Bay Ridge
21-May,36047004400,3004400,4639,76482,81121,Brooklyn,4502927.988,Bay Ridge
19-Jun,36047004400,3004400,5524,93058,98582,Brooklyn,4502927.988,Bay Ridge
21-Jun,36047004400,3004400,6129,97883,104012,Brooklyn,4502927.988,Bay Ridge
19-Jul,36047004400,3004400,3132,71732,74864,Brooklyn,4502927.988,Bay Ridge
21-Jul,36047004400,3004400,6084,65552,71636,Brooklyn,4502927.988,Bay Ridge
19-Aug,36047004400,3004400,14284,49674,63958,Brooklyn,4502927.988,Bay Ridge
21-Aug,36047004400,3004400,15794,154406,170200,Brooklyn,4502927.988,Bay Ridge
19-May,36047004500,3004500,9350,128062,137412,Brooklyn,1835597.21,Carroll Gardens-Cobble Hill-Gowanus-Red Hook
21-May,36047004500,3004500,1731,105204,106935,Brooklyn,1835597.21,Carroll Gardens-Cobble Hill-Gowanus-Red Hook
19-Jun,36047004500,3004500,10452,106788,117240,Brooklyn,1835597.21,Carroll Gardens-Cobble Hill-Gowanus-Red Hook
21-Jun,36047004500,3004500,5362,108602,113964,Brooklyn,1835597.21,Carroll Gardens-Cobble Hill-Gowanus-Red Hook
19-Jul,36047004500,3004500,10362,132750,143112,Brooklyn,1835597.21,Carroll Gardens-Cobble Hill-Gowanus-Red Hook
21-Jul,36047004500,3004500,12780,62624,75404,Brooklyn,1835597.21,Carroll Gardens-Cobble Hill-Gowanus-Red Hook
19-Aug,36047004500,3004500,4978,130054,135032,Brooklyn,1835597.21,Carroll Gardens-Cobble Hill-Gowanus-Red Hook
21-Aug,36047004500,3004500,0,24857,24857,Brooklyn,1835597.21,Carroll Gardens-Cobble Hill-Gowanus-Red Hook
19-May,36047004700,3004700,11046,87611,98657,Brooklyn,2928274.584,Carroll Gardens-Cobble Hill-Gowanus-Red Hook
21-May,36047004700,3004700,8208,43324,51532,Brooklyn,2928274.584,Carroll Gardens-Cobble Hill-Gowanus-Red Hook
19-Jun,36047004700,3004700,6477,111355,117832,Brooklyn,2928274.584,Carroll Gardens-Cobble Hill-Gowanus-Red Hook
21-Jun,36047004700,3004700,8421,61765,70186,Brooklyn,2928274.584,Carroll Gardens-Cobble Hill-Gowanus-Red Hook
19-Jul,36047004700,3004700,18890,62921,81811,Brooklyn,2928274.584,Carroll Gardens-Cobble Hill-Gowanus-Red Hook
21-Jul,36047004700,3004700,0,82252,82252,Brooklyn,2928274.584,Carroll Gardens-Cobble Hill-Gowanus-Red Hook
19-Aug,36047004700,3004700,2649,105162,107811,Brooklyn,2928274.584,Carroll Gardens-Cobble Hill-Gowanus-Red Hook
21-Aug,36047004700,3004700,491,92722,93213,Brooklyn,2928274.584,Carroll Gardens-Cobble Hill-Gowanus-Red Hook
19-May,36047004900,3004900,21170,17231,38401,Brooklyn,1051010.63,Carroll Gardens-Cobble Hill-Gowanus-Red Hook
21-May,36047004900,3004900,8933,68805,77738,Brooklyn,1051010.63,Carroll Gardens-Cobble Hill-Gowanus-Red Hook
19-Jun,36047004900,3004900,10376,69234,79610,Brooklyn,1051010.63,Carroll Gardens-Cobble Hill-Gowanus-Red Hook
21-Jun,36047004900,3004900,10423,115297,125720,Brooklyn,1051010.63,Carroll Gardens-Cobble Hill-Gowanus-Red Hook
19-Jul,36047004900,3004900,12142,78928,91070,Brooklyn,1051010.63,Carroll Gardens-Cobble Hill-Gowanus-Red Hook
21-Jul,36047004900,3004900,11763,69933,81696,Brooklyn,1051010.63,Carroll Gardens-Cobble Hill-Gowanus-Red Hook
19-Aug,36047004900,3004900,11826,49280,61106,Brooklyn,1051010.63,Carroll Gardens-Cobble Hill-Gowanus-Red Hook
21-Aug,36047004900,3004900,4555,130185,134740,Brooklyn,1051010.63,Carroll Gardens-Cobble Hill-Gowanus-Red Hook
19-May,36047005000,3005000,10117,51628,61745,Brooklyn,2388874.414,Bay Ridge
21-May,36047005000,3005000,6138,153998,160136,Brooklyn,2388874.414,Bay Ridge
19-Jun,36047005000,3005000,9912,66118,76030,Brooklyn,2388874.414,Bay Ridge
21-Jun,36047005000,3005000,10894,56246,67140,Brooklyn,2388874.414,Bay Ridge
19-Jul,36047005000,3005000,6759,26195,32954,Brooklyn,2388874.414,Bay Ridge
21-Jul,36047005000,3005000,9719,38036,47755,Brooklyn,2388874.414,Bay Ridge
19-Aug,36047005000,3005000,15819,45079,60898,Brooklyn,2388874.414,Bay Ridge
21-Aug,36047005000,3005000,826,67455,68281,Brooklyn,2388874.414,Bay Ridge
19-May,36047005201,3005201,5284,7230,12514,Brooklyn,1451018.352,Bay Ridge
21-May,36047005201,3005201,14103,87832,101935,Brooklyn,1451018.352,Bay Ridge
19-Jun,36047005201,3005201,9528,58698,68226,Brooklyn,1451018.352,Bay Ridge
21-Jun,36047005201,3005201,12101,86952,99053,Brooklyn,1451018.352,Bay Ridge
19-Jul,36047005201,3005201,17067,91941,109008,Brooklyn,1451018.352,Bay Ridge
21-Jul,36047005201,3005201,10113,10378,20491,Brooklyn,1451018.352,Bay Ridge
19-Aug,36047005201,3005201,2048,61940,63988,Brooklyn,1451018.352,Bay Ridge
21-Aug,36047005201,3005201,9730,30155,39885,Brooklyn,1451018.352,Bay Ridge
19-May,36047005202,3005202,20999,80786,101785,Brooklyn,1398134.521,Bay Ridge
21-May,36047005202,3005202,6823,132794,139617,Brooklyn,1398134.521,Bay Ridge
19-Jun,36047005202,3005202,10493,66111,76604,Brooklyn,1398134.521,Bay Ridge
21-Jun,36047005202,3005202,0,71,71,Brooklyn,1398134.521,Bay Ridge
19-Jul,36047005202,3005202,8061,56780,64841,Brooklyn,1398134.521,Bay Ridge
21-Jul,36047005202,3005202,8694,105880,114574,Brooklyn,1398134.521,Bay Ridge
19-Aug,36047005202,3005202,6652,14821,21473,Brooklyn,1398134.521,Bay Ridge
21-Aug,36047005202,3005202,8497,127972,136469,Brooklyn,1398134.521,Bay Ridge
19-May,36047005301,3005301,9940,74996,84936,Brooklyn,6104697.224,Carroll Gardens-Cobble Hill-Gowanus-Red Hook
21-May,36047005301,3005301,13838,81433,95271,Brooklyn,6104697.224,Carroll Gardens-Cobble Hill-Gowanus-Red Hook
19-Jun,36047005301,3005301,18995,22655,41650,Brooklyn,6104697.224,Carroll Gardens-Cobble Hill-Gowanus-Red Hook
21-Jun,36047005301,3005301,3497,38215,41712,Brooklyn,6104697.224,Carroll Gardens-Cobble Hill-Gowanus-Red Hook
19-Jul,36047005301,3005301,17979,71075,89054,Brooklyn,6104697.224,Carroll Gardens-Cobble Hill-Gowanus-Red Hook
21-Jul,36047005301,3005301,3946,85827,89773,Brooklyn,6104697.224,Carroll Gardens-Cobble Hill-Gowanus-Red Hook
19-Aug,36047005301,3005301,860,81461,82321,Brooklyn,6104697.224,Carroll Gardens-Cobble Hill-Gowanus-Red Hook
21-Aug,36047005301,3005301,16043,124674,140717,Brooklyn,6104697.224,Carroll Gardens-Cobble Hill-Gowanus-Red Hook
19-May,36047005303,3005303,15019,134599,149618,Brooklyn,3311574.24,Carroll Gardens-Cobble Hill-Gowanus-Red Hook
21-May,36047005303,3005303,11057,40545,51602,Brooklyn,3311574.24,Carroll Gardens-Cobble Hill-Gowanus-Red Hook
19-Jun,36047005303,3005303,4068,77819,81887,Brooklyn,3311574.24,Carroll Gardens-Cobble Hill-Gowanus-Red Hook
21-Jun,36047005303,3005303,6653,79031,85684,Brooklyn,3311574.24,Carroll Gardens-Cobble Hill-Gowanus-Red Hook
19-Jul,36047005303,3005303,12496,28976,41472,Brooklyn,3311574.24,Carroll Gardens-Cobble Hill-Gowanus-Red Hook
21-Jul,36047005303,3005303,11637,82323,93960,Brooklyn,3311574.24,Carroll Gardens-Cobble Hill-Gowanus-Red Hook
19-Aug,36047005303,3005303,7436,33726,41162,Brooklyn,3311574.24,Carroll Gardens-Cobble Hill-Gowanus-Red Hook
21-Aug,36047005303,3005303,7394,123103,130497,Brooklyn,3311574.24,Carroll Gardens-Cobble Hill-Gowanus-Red Hook
19-May,36047005400,3005400,11511,134099,145610,Brooklyn,1740560.856,Bay Ridge
21-May,36047005400,3005400,5560,54831,60391,Brooklyn,1740560.856,Bay Ridge
19-Jun,36047005400,3005400,9895,52069,61964,Brooklyn,1740560.856,Bay Ridge
21-Jun,36047005400,3005400,12173,74730,86903,Brooklyn,1740560.856,Bay Ridge
19-Jul,36047005400,3005400,13190,44432,57622,Brooklyn,1740560.856,Bay Ridge
21-Jul,36047005400,3005400,2074,68175,70249,Brooklyn,1740560.856,Bay Ridge
19-Aug,36047005400,3005400,10748,71957,82705,Brooklyn,1740560.856,Bay Ridge
21-Aug,36047005400,3005400,12020,135837,147857,Brooklyn,1740560.856,Bay Ridge
19-May,36047005601,3005601,17318,40669,57987,Brooklyn,1855118.206,Bay Ridge
21-May,36047005601,3005601,4674,71,4745,Brooklyn,1855118.206,Bay Ridge
19-Jun,36047005601,3005601,12273,80769,93042,Brooklyn,1855118.206,Bay Ridge
21-Jun,36047005601,3005601,7882,125056,132938,Brooklyn,1855118.206,Bay Ridge
19-Jul,36047005601,3005601,16525,54726,71251,Brooklyn,1855118.206,Bay Ridge
21-Jul,36047005601,3005601,8606,82255,90861,Brooklyn,1855118.206,Bay Ridge
19-Aug,36047005601,3005601,9112,114680,123792,Brooklyn,1855118.206,Bay Ridge
21-Aug,36047005601,3005601,13823,60692,74515,Brooklyn,1855118.206,Bay Ridge
19-May,36047005602,3005602,11526,98417,109943,Brooklyn,1436854.88,Bay Ridge
21-May,36047005602,3005602,5911,63629,69540,Brooklyn,1436854.88,Bay Ridge
19-Jun,36047005602,3005602,3463,87810,91273,Brooklyn,1436854.88,Bay Ridge
21-Jun,36047005602,3005602,10317,99723,110040,Brooklyn,1436854.88,Bay Ridge
19-Jul,36047005602,3005602,13876,87784,101660,Brooklyn,1436854.88,Bay Ridge
21-Jul,36047005602,3005602,15564,82921,98485,Brooklyn,1436854.88,Bay Ridge
19-Aug,36047005602,3005602,8088,121737,129825,Brooklyn,1436854.88,Bay Ridge
21-Aug,36047005602,3005602,0,30536,30536,Brooklyn,1436854.88,Bay Ridge
19-May,36047005800,3005800,0,43436,43436,Brooklyn,2080303.313,Bay Ridge
21-May,36047005800,3005800,16035,15992,32027,Brooklyn,2080303.313,Bay Ridge
19-Jun,36047005800,3005800,3449,8173,11622,Brooklyn,2080303.313,Bay Ridge
21-Jun,36047005800,3005800,6938,59644,66582,Brooklyn,2080303.313,Bay Ridge
19-Jul,36047005800,3005800,4214,46539,50753,Brooklyn,2080303.313,Bay Ridge
21-Jul,36047005800,3005800,3283,92975,96258,Brooklyn,2080303.313,Bay Ridge
19-Aug,36047005800,3005800,2241,96529,98770,Brooklyn,2080303.313,Bay Ridge
21-Aug,36047005800,3005800,16111,44077,60188,Brooklyn,2080303.313,Bay Ridge
19-May,36047006000,3006000,7731,90051,97782,Brooklyn,1639073.87,Bay Ridge
21-May,36047006000,3006000,5078,49736,54814,Brooklyn,1639073.87,Bay Ridge
19-Jun,36047006000,3006000,19440,27052,46492,Brooklyn,1639073.87,Bay Ridge
21-Jun,36047006000,3006000,9119,190993,200112,Brooklyn,1639073.87,Bay Ridge
19-Jul,36047006000,3006000,295,13551,13846,Brooklyn,1639073.87,Bay Ridge
21-Jul,36047006000,3006000,6229,94054,100283,Brooklyn,1639073.87,Bay Ridge
19-Aug,36047006000,3006000,15551,15519,31070,Brooklyn,1639073.87,Bay Ridge
21-Aug,36047006000,3006000,12568,34885,47453,Brooklyn,1639073.87,Bay Ridge
19-May,36047006200,3006200,3194,80635,83829,Brooklyn,1746843.3,Bay Ridge
21-May,36047006200,3006200,13137,35117,48254,Brooklyn,1746843.3,Bay Ridge
19-Jun,36047006200,3006200,1053,48647,49700,Brooklyn,1746843.3,Bay Ridge
21-Jun,36047006200,3006200,8875,71,8946,Brooklyn,1746843.3,Bay Ridge
19-Jul,36047006200,3006200,3955,100742,104697,Brooklyn,1746843.3,Bay Ridge
21-Jul,36047006200,3006200,3434,71339,74773,Brooklyn,1746843.3,Bay Ridge
19-Aug,36047006200,3006200,12744,125617,138361,Brooklyn,1746843.3,Bay Ridge
21-Aug,36047006200,3006200,11053,87594,98647,Brooklyn,1746843.3,Bay Ridge
19-May,36047006400,3006400,14811,90807,105618,Brooklyn,2186814.856,Bay Ridge
21-May,36047006400,3006400,18126,86839,104965,Brooklyn,2186814.856,Bay Ridge
19-Jun,36047006400,3006400,11115,33388,44503,Brooklyn,2186814.856,Bay Ridge
21-Jun,36047006400,3006400,7888,94122,102010,Brooklyn,2186814.856,Bay Ridge
19-Jul,36047006400,3006400,11499,34801,46300,Brooklyn,2186814.856,Bay Ridge
21-Jul,36047006400,3006400,13137,97755,110892,Brooklyn,2186814.856,Bay Ridge
19-Aug,36047006400,3006400,9523,67522,77045,Brooklyn,2186814.856,Bay Ridge
21-Aug,36047006400,3006400,11216,72333,83549,Brooklyn,2186814.856,Bay Ridge
19-May,36047006500,3006500,6107,37965,44072,Brooklyn,2678036.343,Carroll Gardens-Cobble Hill-Gowanus-Red Hook
21-May,36047006500,3006500,0,61411,61411,Brooklyn,2678036.343,Carroll Gardens-Cobble Hill-Gowanus-Red Hook
19-Jun,36047006500,3006500,9453,42280,51733,Brooklyn,2678036.343,Carroll Gardens-Cobble Hill-Gowanus-Red Hook
21-Jun,36047006500,3006500,4081,57245,61326,Brooklyn,2678036.343,Carroll Gardens-Cobble Hill-Gowanus-Red Hook
19-Jul,36047006500,3006500,11008,118925,129933,Brooklyn,2678036.343,Carroll Gardens-Cobble Hill-Gowanus-Red Hook
21-Jul,36047006500,3006500,6114,89633,95747,Brooklyn,2678036.343,Carroll Gardens-Cobble Hill-Gowanus-Red Hook
19-Aug,36047006500,3006500,13679,117562,131241,Brooklyn,2678036.343,Carroll Gardens-Cobble Hill-Gowanus-Red Hook
21-Aug,36047006500,3006500,4156,56299,60455,Brooklyn,2678036.343,Carroll Gardens-Cobble Hill-Gowanus-Red Hook
19-May,36047006600,3006600,3125,37900,41025,Brooklyn,1653273.183,Bay Ridge
21-May,36047006600,3006600,15,87689,87704,Brooklyn,1653273.183,Bay Ridge
19-Jun,36047006600,3006600,8339,108228,116567,Brooklyn,1653273.183,Bay Ridge
21-Jun,36047006600,3006600,5392,7684,13076,Brooklyn,1653273.183,Bay Ridge
19-Jul,36047006600,3006600,8997,50894,59891,Brooklyn,1653273.183,Bay Ridge
21-Jul,36047006600,3006600,4513,53060,57573,Brooklyn,1653273.183,Bay Ridge
19-Aug,36047006600,3006600,0,28592,28592,Brooklyn,1653273.183,Bay Ridge
21-Aug,36047006600,3006600,14546,85494,100040,Brooklyn,1653273.183,Bay Ridge
19-May,36047006700,3006700,3515,98213,101728,Brooklyn,1680804.25,Carroll Gardens-Cobble Hill-Gowanus-Red Hook
21-May,36047006700,3006700,7813,42801,50614,Brooklyn,1680804.25,Carroll Gardens-Cobble Hill-Gowanus-Red Hook
19-Jun,36047006700,3006700,13497,108184,121681,Brooklyn,1680804.25,Carroll Gardens-Cobble Hill-Gowanus-Red Hook
21-Jun,36047006700,3006700,11469,133742,145211,Brooklyn,1680804.25,Carroll Gardens-Cobble Hill-Gowanus-Red Hook
19-Jul,36047006700,3006700,3874,131123,134997,Brooklyn,1680804.25,Carroll Gardens-Cobble Hill-Gowanus-Red Hook
21-Jul,36047006700,3006700,21334,72483,93817,Brooklyn,1680804.25,Carroll Gardens-Cobble Hill-Gowanus-Red Hook
19-Aug,36047006700,3006700,4750,66598,71348,Brooklyn,1680804.25,Carroll Gardens-Cobble Hill-Gowanus-Red Hook
21-Aug,36047006700,3006700,14115,79483,93598,Brooklyn,1680804.25,Carroll Gardens-Cobble Hill-Gowanus-Red Hook
19-May,36047006800,3006800,1280,27174,28454,Brooklyn,1996655.762,Bay Ridge
21-May,36047006800,3006800,5405,109513,114918,Brooklyn,1996655.762,Bay Ridge
19-Jun,36047006800,3006800,826,81682,82508,Brooklyn,1996655.762,Bay Ridge
21-Jun,36047006800,3006800,5458,63014,68472,Brooklyn,1996655.762,Bay Ridge
19-Jul,36047006800,3006800,5209,25695,30904,Brooklyn,1996655.762,Bay Ridge
21-Jul,36047006800,3006800,4795,37779,42574,Brooklyn,1996655.762,Bay Ridge
19-Aug,36047006800,3006800,2845,125539,128384,Brooklyn,1996655.762,Bay Ridge
21-Aug,36047006800,3006800,2452,193007,195459,Brooklyn,1996655.762,Bay Ridge
19-May,36047006901,3006901,2080,99189,101269,Brooklyn,801476.2768,Downtown Brooklyn-DUMBO-Boerum Hill
21-May,36047006901,3006901,10560,106496,117056,Brooklyn,801476.2768,Downtown Brooklyn-DUMBO-Boerum Hill
19-Jun,36047006901,3006901,10505,66589,77094,Brooklyn,801476.2768,Downtown Brooklyn-DUMBO-Boerum Hill
21-Jun,36047006901,3006901,6954,107389,114343,Brooklyn,801476.2768,Downtown Brooklyn-DUMBO-Boerum Hill
19-Jul,36047006901,3006901,7921,117798,125719,Brooklyn,801476.2768,Downtown Brooklyn-DUMBO-Boerum Hill
21-Jul,36047006901,3006901,14000,86806,100806,Brooklyn,801476.2768,Downtown Brooklyn-DUMBO-Boerum Hill
19-Aug,36047006901,3006901,7811,16540,24351,Brooklyn,801476.2768,Downtown Brooklyn-DUMBO-Boerum Hill
21-Aug,36047006901,3006901,15193,69835,85028,Brooklyn,801476.2768,Downtown Brooklyn-DUMBO-Boerum Hill
19-May,36047006902,3006902,16387,110017,126404,Brooklyn,1126489.707,Carroll Gardens-Cobble Hill-Gowanus-Red Hook
21-May,36047006902,3006902,13955,34632,48587,Brooklyn,1126489.707,Carroll Gardens-Cobble Hill-Gowanus-Red Hook
19-Jun,36047006902,3006902,12085,73853,85938,Brooklyn,1126489.707,Carroll Gardens-Cobble Hill-Gowanus-Red Hook
21-Jun,36047006902,3006902,9172,37706,46878,Brooklyn,1126489.707,Carroll Gardens-Cobble Hill-Gowanus-Red Hook
19-Jul,36047006902,3006902,12210,100950,113160,Brooklyn,1126489.707,Carroll Gardens-Cobble Hill-Gowanus-Red Hook
21-Jul,36047006902,3006902,2881,70418,73299,Brooklyn,1126489.707,Carroll Gardens-Cobble Hill-Gowanus-Red Hook
19-Aug,36047006902,3006902,8358,79281,87639,Brooklyn,1126489.707,Carroll Gardens-Cobble Hill-Gowanus-Red Hook
21-Aug,36047006902,3006902,1695,106784,108479,Brooklyn,1126489.707,Carroll Gardens-Cobble Hill-Gowanus-Red Hook
19-May,36047007000,3007000,0,65361,65361,Brooklyn,1588000.487,Bay Ridge
21-May,36047007000,3007000,11174,33881,45055,Brooklyn,1588000.487,Bay Ridge
19-Jun,36047007000,3007000,4797,56521,61318,Brooklyn,1588000.487,Bay Ridge
21-Jun,36047007000,3007000,13254,107597,120851,Brooklyn,1588000.487,Bay Ridge
19-Jul,36047007000,3007000,7390,75539,82929,Brooklyn,1588000.487,Bay Ridge
21-Jul,36047007000,3007000,4385,115369,119754,Brooklyn,1588000.487,Bay Ridge
19-Aug,36047007000,3007000,10118,49461,59579,Brooklyn,1588000.487,Bay Ridge
21-Aug,36047007000,3007000,5446,31769,37215,Brooklyn,1588000.487,Bay Ridge
19-May,36047007100,3007100,12107,69660,81767,Brooklyn,1840524.262,Carroll Gardens-Cobble Hill-Gowanus-Red Hook
21-May,36047007100,3007100,6668,87075,93743,Brooklyn,1840524.262,Carroll Gardens-Cobble Hill-Gowanus-Red Hook
19-Jun,36047007100,3007100,10231,70537,80768,Brooklyn,1840524.262,Carroll Gardens-Cobble Hill-Gowanus-Red Hook
21-Jun,36047007100,3007100,3963,47297,51260,Brooklyn,1840524.262,Carroll Gardens-Cobble Hill-Gowanus-Red Hook
19-Jul,36047007100,3007100,13506,67581,81087,Brooklyn,1840524.262,Carroll Gardens-Cobble Hill-Gowanus-Red Hook
21-Jul,36047007100,3007100,4619,32655,37274,Brooklyn,1840524.262,Carroll Gardens-Cobble Hill-Gowanus-Red Hook
19-Aug,36047007100,3007100,3862,60930,64792,Brooklyn,1840524.262,Carroll Gardens-Cobble Hill-Gowanus-Red Hook
21-Aug,36047007100,3007100,13912,126332,140244,Brooklyn,1840524.262,Carroll Gardens-Cobble Hill-Gowanus-Red Hook
19-May,36047007200,3007200,4916,3111,8027,Brooklyn,664162.7905,Sunset Park (West)
21-May,36047007200,3007200,4417,30220,34637,Brooklyn,664162.7905,Sunset Park (West)
19-Jun,36047007200,3007200,13103,71,13174,Brooklyn,664162.7905,Sunset Park (West)
21-Jun,36047007200,3007200,8448,55466,63914,Brooklyn,664162.7905,Sunset Park (West)
19-Jul,36047007200,3007200,15511,56245,71756,Brooklyn,664162.7905,Sunset Park (West)
21-Jul,36047007200,3007200,12509,130486,142995,Brooklyn,664162.7905,Sunset Park (West)
19-Aug,36047007200,3007200,6640,98987,105627,Brooklyn,664162.7905,Sunset Park (West)
21-Aug,36047007200,3007200,10131,65994,76125,Brooklyn,664162.7905,Sunset Park (West)
19-May,36047007400,3007400,12049,92934,104983,Brooklyn,1545780.633,Sunset Park (West)
21-May,36047007400,3007400,0,114512,114512,Brooklyn,1545780.633,Sunset Park (West)
19-Jun,36047007400,3007400,10568,41244,51812,Brooklyn,1545780.633,Sunset Park (West)
21-Jun,36047007400,3007400,11687,16614,28301,Brooklyn,1545780.633,Sunset Park (West)
19-Jul,36047007400,3007400,8175,9035,17210,Brooklyn,1545780.633,Sunset Park (West)
21-Jul,36047007400,3007400,12867,154147,167014,Brooklyn,1545780.633,Sunset Park (West)
19-Aug,36047007400,3007400,17095,122204,139299,Brooklyn,1545780.633,Sunset Park (West)
21-Aug,36047007400,3007400,4323,91260,95583,Brooklyn,1545780.633,Sunset Park (West)
19-May,36047007600,3007600,14656,125555,140211,Brooklyn,1510401.71,Sunset Park (West)
21-May,36047007600,3007600,9316,101428,110744,Brooklyn,1510401.71,Sunset Park (West)
19-Jun,36047007600,3007600,10702,63903,74605,Brooklyn,1510401.71,Sunset Park (West)
21-Jun,36047007600,3007600,6150,44604,50754,Brooklyn,1510401.71,Sunset Park (West)
19-Jul,36047007600,3007600,9212,71,9283,Brooklyn,1510401.71,Sunset Park (West)
21-Jul,36047007600,3007600,7190,97940,105130,Brooklyn,1510401.71,Sunset Park (West)
19-Aug,36047007600,3007600,7940,57186,65126,Brooklyn,1510401.71,Sunset Park (West)
21-Aug,36047007600,3007600,5843,74498,80341,Brooklyn,1510401.71,Sunset Park (West)
19-May,36047007800,3007800,0,76096,76096,Brooklyn,1509791.997,Sunset Park (West)
21-May,36047007800,3007800,12669,71,12740,Brooklyn,1509791.997,Sunset Park (West)
19-Jun,36047007800,3007800,8065,36080,44145,Brooklyn,1509791.997,Sunset Park (West)
21-Jun,36047007800,3007800,7980,70719,78699,Brooklyn,1509791.997,Sunset Park (West)
19-Jul,36047007800,3007800,17676,54087,71763,Brooklyn,1509791.997,Sunset Park (West)
21-Jul,36047007800,3007800,2530,109926,112456,Brooklyn,1509791.997,Sunset Park (West)
19-Aug,36047007800,3007800,9131,105823,114954,Brooklyn,1509791.997,Sunset Park (West)
21-Aug,36047007800,3007800,1860,96950,98810,Brooklyn,1509791.997,Sunset Park (West)
19-May,36047008000,3008000,11103,36936,48039,Brooklyn,1506326.404,Sunset Park (West)
21-May,36047008000,3008000,13168,21171,34339,Brooklyn,1506326.404,Sunset Park (West)
19-Jun,36047008000,3008000,2810,31065,33875,Brooklyn,1506326.404,Sunset Park (West)
21-Jun,36047008000,3008000,13151,138746,151897,Brooklyn,1506326.404,Sunset Park (West)
19-Jul,36047008000,3008000,4237,67199,71436,Brooklyn,1506326.404,Sunset Park (West)
21-Jul,36047008000,3008000,11969,49127,61096,Brooklyn,1506326.404,Sunset Park (West)
19-Aug,36047008000,3008000,14780,132452,147232,Brooklyn,1506326.404,Sunset Park (West)
21-Aug,36047008000,3008000,10076,98424,108500,Brooklyn,1506326.404,Sunset Park (West)
19-May,36047008200,3008200,10602,101424,112026,Brooklyn,1517026.151,Sunset Park (West)
21-May,36047008200,3008200,10839,135489,146328,Brooklyn,1517026.151,Sunset Park (West)
19-Jun,36047008200,3008200,6910,95464,102374,Brooklyn,1517026.151,Sunset Park (West)
21-Jun,36047008200,3008200,9239,59469,68708,Brooklyn,1517026.151,Sunset Park (West)
19-Jul,36047008200,3008200,12470,71803,84273,Brooklyn,1517026.151,Sunset Park (West)
21-Jul,36047008200,3008200,11069,36000,47069,Brooklyn,1517026.151,Sunset Park (West)
19-Aug,36047008200,3008200,19316,25877,45193,Brooklyn,1517026.151,Sunset Park (West)
21-Aug,36047008200,3008200,16888,106048,122936,Brooklyn,1517026.151,Sunset Park (West)
19-May,36047008400,3008400,11199,78778,89977,Brooklyn,2650333.411,Sunset Park (West)
21-May,36047008400,3008400,3852,20525,24377,Brooklyn,2650333.411,Sunset Park (West)
19-Jun,36047008400,3008400,4220,57768,61988,Brooklyn,2650333.411,Sunset Park (West)
21-Jun,36047008400,3008400,14036,63052,77088,Brooklyn,2650333.411,Sunset Park (West)
19-Jul,36047008400,3008400,13276,104153,117429,Brooklyn,2650333.411,Sunset Park (West)
21-Jul,36047008400,3008400,16500,71,16571,Brooklyn,2650333.411,Sunset Park (West)
19-Aug,36047008400,3008400,6072,86219,92291,Brooklyn,2650333.411,Sunset Park (West)
21-Aug,36047008400,3008400,22800,118591,141391,Brooklyn,2650333.411,Sunset Park (West)
19-May,36047008500,3008500,0,6704,6704,Brooklyn,2624917.633,Carroll Gardens-Cobble Hill-Gowanus-Red Hook
21-May,36047008500,3008500,1389,126006,127395,Brooklyn,2624917.633,Carroll Gardens-Cobble Hill-Gowanus-Red Hook
19-Jun,36047008500,3008500,21881,71367,93248,Brooklyn,2624917.633,Carroll Gardens-Cobble Hill-Gowanus-Red Hook
21-Jun,36047008500,3008500,4887,10385,15272,Brooklyn,2624917.633,Carroll Gardens-Cobble Hill-Gowanus-Red Hook
19-Jul,36047008500,3008500,12517,41867,54384,Brooklyn,2624917.633,Carroll Gardens-Cobble Hill-Gowanus-Red Hook
21-Jul,36047008500,3008500,7809,45480,53289,Brooklyn,2624917.633,Carroll Gardens-Cobble Hill-Gowanus-Red Hook
19-Aug,36047008500,3008500,17181,74623,91804,Brooklyn,2624917.633,Carroll Gardens-Cobble Hill-Gowanus-Red Hook
21-Aug,36047008500,3008500,10602,97699,108301,Brooklyn,2624917.633,Carroll Gardens-Cobble Hill-Gowanus-Red Hook
19-May,36047008600,3008600,6433,63372,69805,Brooklyn,1221917.024,Sunset Park (Central)
21-May,36047008600,3008600,17222,71665,88887,Brooklyn,1221917.024,Sunset Park (Central)
19-Jun,36047008600,3008600,10703,33868,44571,Brooklyn,1221917.024,Sunset Park (Central)
21-Jun,36047008600,3008600,18827,146217,165044,Brooklyn,1221917.024,Sunset Park (Central)
19-Jul,36047008600,3008600,5163,12199,17362,Brooklyn,1221917.024,Sunset Park (Central)
21-Jul,36047008600,3008600,6679,28642,35321,Brooklyn,1221917.024,Sunset Park (Central)
19-Aug,36047008600,3008600,9108,90469,99577,Brooklyn,1221917.024,Sunset Park (Central)
21-Aug,36047008600,3008600,7771,71,7842,Brooklyn,1221917.024,Sunset Park (Central)
19-May,36047008800,3008800,6305,73037,79342,Brooklyn,2019986.018,Sunset Park (Central)
21-May,36047008800,3008800,2309,138078,140387,Brooklyn,2019986.018,Sunset Park (Central)
19-Jun,36047008800,3008800,1549,74709,76258,Brooklyn,2019986.018,Sunset Park (Central)
21-Jun,36047008800,3008800,9836,42614,52450,Brooklyn,2019986.018,Sunset Park (Central)
19-Jul,36047008800,3008800,5763,20181,25944,Brooklyn,2019986.018,Sunset Park (Central)
21-Jul,36047008800,3008800,9270,33461,42731,Brooklyn,2019986.018,Sunset Park (Central)
19-Aug,36047008800,3008800,6871,81633,88504,Brooklyn,2019986.018,Sunset Park (Central)
21-Aug,36047008800,3008800,10577,76048,86625,Brooklyn,2019986.018,Sunset Park (Central)
19-May,36047009001,3009001,12955,90817,103772,Brooklyn,825062.3651,Sunset Park (Central)
21-May,36047009001,3009001,4120,83831,87951,Brooklyn,825062.3651,Sunset Park (Central)
19-Jun,36047009001,3009001,11087,53935,65022,Brooklyn,825062.3651,Sunset Park (Central)
21-Jun,36047009001,3009001,11550,73884,85434,Brooklyn,825062.3651,Sunset Park (Central)
19-Jul,36047009001,3009001,10186,33867,44053,Brooklyn,825062.3651,Sunset Park (Central)
21-Jul,36047009001,3009001,11679,123724,135403,Brooklyn,825062.3651,Sunset Park (Central)
19-Aug,36047009001,3009001,1992,145102,147094,Brooklyn,825062.3651,Sunset Park (Central)
21-Aug,36047009001,3009001,8347,32492,40839,Brooklyn,825062.3651,Sunset Park (Central)
19-May,36047009002,3009002,6625,43276,49901,Brooklyn,806084.6545,Sunset Park (East)-Borough Park (West)
21-May,36047009002,3009002,4862,32160,37022,Brooklyn,806084.6545,Sunset Park (East)-Borough Park (West)
19-Jun,36047009002,3009002,1037,59688,60725,Brooklyn,806084.6545,Sunset Park (East)-Borough Park (West)
21-Jun,36047009002,3009002,16374,41485,57859,Brooklyn,806084.6545,Sunset Park (East)-Borough Park (West)
19-Jul,36047009002,3009002,12172,58128,70300,Brooklyn,806084.6545,Sunset Park (East)-Borough Park (West)
21-Jul,36047009002,3009002,2435,118756,121191,Brooklyn,806084.6545,Sunset Park (East)-Borough Park (West)
19-Aug,36047009002,3009002,8152,36297,44449,Brooklyn,806084.6545,Sunset Park (East)-Borough Park (West)
21-Aug,36047009002,3009002,9719,100389,110108,Brooklyn,806084.6545,Sunset Park (East)-Borough Park (West)
19-May,36047009201,3009201,1469,68634,70103,Brooklyn,608662.3662,Sunset Park (Central)
21-May,36047009201,3009201,0,21434,21434,Brooklyn,608662.3662,Sunset Park (Central)
19-Jun,36047009201,3009201,9865,73336,83201,Brooklyn,608662.3662,Sunset Park (Central)
21-Jun,36047009201,3009201,5050,28791,33841,Brooklyn,608662.3662,Sunset Park (Central)
19-Jul,36047009201,3009201,7993,26387,34380,Brooklyn,608662.3662,Sunset Park (Central)
21-Jul,36047009201,3009201,12907,109518,122425,Brooklyn,608662.3662,Sunset Park (Central)
19-Aug,36047009201,3009201,1351,132687,134038,Brooklyn,608662.3662,Sunset Park (Central)
21-Aug,36047009201,3009201,4208,100693,104901,Brooklyn,608662.3662,Sunset Park (Central)
19-May,36047009202,3009202,8748,26130,34878,Brooklyn,610211.6216,Sunset Park (East)-Borough Park (West)
21-May,36047009202,3009202,12873,26054,38927,Brooklyn,610211.6216,Sunset Park (East)-Borough Park (West)
19-Jun,36047009202,3009202,15958,49158,65116,Brooklyn,610211.6216,Sunset Park (East)-Borough Park (West)
21-Jun,36047009202,3009202,12123,126092,138215,Brooklyn,610211.6216,Sunset Park (East)-Borough Park (West)
19-Jul,36047009202,3009202,9055,133612,142667,Brooklyn,610211.6216,Sunset Park (East)-Borough Park (West)
21-Jul,36047009202,3009202,13087,71,13158,Brooklyn,610211.6216,Sunset Park (East)-Borough Park (West)
19-Aug,36047009202,3009202,9408,53449,62857,Brooklyn,610211.6216,Sunset Park (East)-Borough Park (West)
21-Aug,36047009202,3009202,10865,52641,63506,Brooklyn,610211.6216,Sunset Park (East)-Borough Park (West)
19-May,36047009401,3009401,2543,47454,49997,Brooklyn,812257.4281,Sunset Park (Central)
21-May,36047009401,3009401,1099,95095,96194,Brooklyn,812257.4281,Sunset Park (Central)
19-Jun,36047009401,3009401,9508,106107,115615,Brooklyn,812257.4281,Sunset Park (Central)
21-Jun,36047009401,3009401,7761,9778,17539,Brooklyn,812257.4281,Sunset Park (Central)
19-Jul,36047009401,3009401,17096,148924,166020,Brooklyn,812257.4281,Sunset Park (Central)
21-Jul,36047009401,3009401,9719,131076,140795,Brooklyn,812257.4281,Sunset Park (Central)
19-Aug,36047009401,3009401,12849,69622,82471,Brooklyn,812257.4281,Sunset Park (Central)
21-Aug,36047009401,3009401,12224,72131,84355,Brooklyn,812257.4281,Sunset Park (Central)
19-May,36047009402,3009402,16287,35121,51408,Brooklyn,813343.4436,Sunset Park (East)-Borough Park (West)
21-May,36047009402,3009402,4155,166250,170405,Brooklyn,813343.4436,Sunset Park (East)-Borough Park (West)
19-Jun,36047009402,3009402,7379,18787,26166,Brooklyn,813343.4436,Sunset Park (East)-Borough Park (West)
21-Jun,36047009402,3009402,8360,71353,79713,Brooklyn,813343.4436,Sunset Park (East)-Borough Park (West)
19-Jul,36047009402,3009402,10607,165824,176431,Brooklyn,813343.4436,Sunset Park (East)-Borough Park (West)
21-Jul,36047009402,3009402,13959,109996,123955,Brooklyn,813343.4436,Sunset Park (East)-Borough Park (West)
19-Aug,36047009402,3009402,13954,45330,59284,Brooklyn,813343.4436,Sunset Park (East)-Borough Park (West)
21-Aug,36047009402,3009402,3832,84818,88650,Brooklyn,813343.4436,Sunset Park (East)-Borough Park (West)
19-May,36047009600,3009600,6116,138159,144275,Brooklyn,1622766.586,Sunset Park (Central)
21-May,36047009600,3009600,4244,41735,45979,Brooklyn,1622766.586,Sunset Park (Central)
19-Jun,36047009600,3009600,13084,11462,24546,Brooklyn,1622766.586,Sunset Park (Central)
21-Jun,36047009600,3009600,10036,29339,39375,Brooklyn,1622766.586,Sunset Park (Central)
19-Jul,36047009600,3009600,9036,132228,141264,Brooklyn,1622766.586,Sunset Park (Central)
21-Jul,36047009600,3009600,12262,37102,49364,Brooklyn,1622766.586,Sunset Park (Central)
19-Aug,36047009600,3009600,8410,97540,105950,Brooklyn,1622766.586,Sunset Park (Central)
21-Aug,36047009600,3009600,4154,64758,68912,Brooklyn,1622766.586,Sunset Park (Central)
19-May,36047009800,3009800,4700,71,4771,Brooklyn,1625498.582,Sunset Park (Central)
21-May,36047009800,3009800,5439,20393,25832,Brooklyn,1625498.582,Sunset Park (Central)
19-Jun,36047009800,3009800,10671,12367,23038,Brooklyn,1625498.582,Sunset Park (Central)
21-Jun,36047009800,3009800,13319,101671,114990,Brooklyn,1625498.582,Sunset Park (Central)
19-Jul,36047009800,3009800,14844,47205,62049,Brooklyn,1625498.582,Sunset Park (Central)
21-Jul,36047009800,3009800,10049,112548,122597,Brooklyn,1625498.582,Sunset Park (Central)
19-Aug,36047009800,3009800,11459,79669,91128,Brooklyn,1625498.582,Sunset Park (Central)
21-Aug,36047009800,3009800,9386,78843,88229,Brooklyn,1625498.582,Sunset Park (Central)
19-May,36047010000,3010000,6901,47162,54063,Brooklyn,1625060.608,Sunset Park (Central)
21-May,36047010000,3010000,5299,73253,78552,Brooklyn,1625060.608,Sunset Park (Central)
19-Jun,36047010000,3010000,5834,97159,102993,Brooklyn,1625060.608,Sunset Park (Central)
21-Jun,36047010000,3010000,7283,125918,133201,Brooklyn,1625060.608,Sunset Park (Central)
19-Jul,36047010000,3010000,11990,27687,39677,Brooklyn,1625060.608,Sunset Park (Central)
21-Jul,36047010000,3010000,4628,62648,67276,Brooklyn,1625060.608,Sunset Park (Central)
19-Aug,36047010000,3010000,6754,60455,67209,Brooklyn,1625060.608,Sunset Park (Central)
21-Aug,36047010000,3010000,7560,101342,108902,Brooklyn,1625060.608,Sunset Park (Central)
19-May,36047010200,3010200,732,71,803,Brooklyn,1640687.828,Sunset Park (Central)
21-May,36047010200,3010200,7901,71,7972,Brooklyn,1640687.828,Sunset Park (Central)
19-Jun,36047010200,3010200,0,138372,138372,Brooklyn,1640687.828,Sunset Park (Central)
21-Jun,36047010200,3010200,7466,56265,63731,Brooklyn,1640687.828,Sunset Park (Central)
19-Jul,36047010200,3010200,10232,72245,82477,Brooklyn,1640687.828,Sunset Park (Central)
21-Jul,36047010200,3010200,13055,102415,115470,Brooklyn,1640687.828,Sunset Park (Central)
19-Aug,36047010200,3010200,17555,106797,124352,Brooklyn,1640687.828,Sunset Park (Central)
21-Aug,36047010200,3010200,6337,86677,93014,Brooklyn,1640687.828,Sunset Park (Central)
19-May,36047010401,3010401,11010,118926,129936,Brooklyn,819191.3112,Sunset Park (Central)
21-May,36047010401,3010401,14474,84084,98558,Brooklyn,819191.3112,Sunset Park (Central)
19-Jun,36047010401,3010401,8898,8202,17100,Brooklyn,819191.3112,Sunset Park (Central)
21-Jun,36047010401,3010401,7413,57649,65062,Brooklyn,819191.3112,Sunset Park (Central)
19-Jul,36047010401,3010401,9780,121549,131329,Brooklyn,819191.3112,Sunset Park (Central)
21-Jul,36047010401,3010401,0,89323,89323,Brooklyn,819191.3112,Sunset Park (Central)
19-Aug,36047010401,3010401,9514,110338,119852,Brooklyn,819191.3112,Sunset Park (Central)
21-Aug,36047010401,3010401,1484,36678,38162,Brooklyn,819191.3112,Sunset Park (Central)
19-May,36047010402,3010402,1323,83564,84887,Brooklyn,820199.588,Sunset Park (East)-Borough Park (West)
21-May,36047010402,3010402,1035,78530,79565,Brooklyn,820199.588,Sunset Park (East)-Borough Park (West)
19-Jun,36047010402,3010402,2958,63956,66914,Brooklyn,820199.588,Sunset Park (East)-Borough Park (West)
21-Jun,36047010402,3010402,13998,123433,137431,Brooklyn,820199.588,Sunset Park (East)-Borough Park (West)
19-Jul,36047010402,3010402,4356,87503,91859,Brooklyn,820199.588,Sunset Park (East)-Borough Park (West)
21-Jul,36047010402,3010402,18099,124094,142193,Brooklyn,820199.588,Sunset Park (East)-Borough Park (West)
19-Aug,36047010402,3010402,0,84613,84613,Brooklyn,820199.588,Sunset Park (East)-Borough Park (West)
21-Aug,36047010402,3010402,3887,36029,39916,Brooklyn,820199.588,Sunset Park (East)-Borough Park (West)
19-May,36047010601,3010601,19788,82472,102260,Brooklyn,811933.3375,Sunset Park (Central)
21-May,36047010601,3010601,0,77979,77979,Brooklyn,811933.3375,Sunset Park (Central)
19-Jun,36047010601,3010601,12031,69344,81375,Brooklyn,811933.3375,Sunset Park (Central)
21-Jun,36047010601,3010601,12918,23651,36569,Brooklyn,811933.3375,Sunset Park (Central)
19-Jul,36047010601,3010601,5770,61908,67678,Brooklyn,811933.3375,Sunset Park (Central)
21-Jul,36047010601,3010601,6463,79305,85768,Brooklyn,811933.3375,Sunset Park (Central)
19-Aug,36047010601,3010601,14769,63084,77853,Brooklyn,811933.3375,Sunset Park (Central)
21-Aug,36047010601,3010601,10788,87099,97887,Brooklyn,811933.3375,Sunset Park (Central)
19-May,36047010602,3010602,0,58650,58650,Brooklyn,812851.2441,Sunset Park (East)-Borough Park (West)
21-May,36047010602,3010602,12597,103610,116207,Brooklyn,812851.2441,Sunset Park (East)-Borough Park (West)
19-Jun,36047010602,3010602,4074,106980,111054,Brooklyn,812851.2441,Sunset Park (East)-Borough Park (West)
21-Jun,36047010602,3010602,14027,40490,54517,Brooklyn,812851.2441,Sunset Park (East)-Borough Park (West)
19-Jul,36047010602,3010602,13357,80115,93472,Brooklyn,812851.2441,Sunset Park (East)-Borough Park (West)
21-Jul,36047010602,3010602,8681,22512,31193,Brooklyn,812851.2441,Sunset Park (East)-Borough Park (West)
19-Aug,36047010602,3010602,8362,67102,75464,Brooklyn,812851.2441,Sunset Park (East)-Borough Park (West)
21-Aug,36047010602,3010602,11558,41892,53450,Brooklyn,812851.2441,Sunset Park (East)-Borough Park (West)
19-May,36047010801,3010801,0,27254,27254,Brooklyn,812575.7081,Sunset Park (Central)
21-May,36047010801,3010801,6651,59020,65671,Brooklyn,812575.7081,Sunset Park (Central)
19-Jun,36047010801,3010801,8538,36919,45457,Brooklyn,812575.7081,Sunset Park (Central)
21-Jun,36047010801,3010801,14848,52832,67680,Brooklyn,812575.7081,Sunset Park (Central)
19-Jul,36047010801,3010801,7830,111199,119029,Brooklyn,812575.7081,Sunset Park (Central)
21-Jul,36047010801,3010801,12850,110011,122861,Brooklyn,812575.7081,Sunset Park (Central)
19-Aug,36047010801,3010801,8555,141915,150470,Brooklyn,812575.7081,Sunset Park (Central)
21-Aug,36047010801,3010801,1400,75585,76985,Brooklyn,812575.7081,Sunset Park (Central)
19-May,36047010802,3010802,4305,51511,55816,Brooklyn,812274.0352,Sunset Park (East)-Borough Park (West)
21-May,36047010802,3010802,3795,67149,70944,Brooklyn,812274.0352,Sunset Park (East)-Borough Park (West)
19-Jun,36047010802,3010802,11063,123505,134568,Brooklyn,812274.0352,Sunset Park (East)-Borough Park (West)
21-Jun,36047010802,3010802,12019,135108,147127,Brooklyn,812274.0352,Sunset Park (East)-Borough Park (West)
19-Jul,36047010802,3010802,10706,83492,94198,Brooklyn,812274.0352,Sunset Park (East)-Borough Park (West)
21-Jul,36047010802,3010802,11604,17538,29142,Brooklyn,812274.0352,Sunset Park (East)-Borough Park (West)
19-Aug,36047010802,3010802,10297,47181,57478,Brooklyn,812274.0352,Sunset Park (East)-Borough Park (West)
21-Aug,36047010802,3010802,7389,56636,64025,Brooklyn,812274.0352,Sunset Park (East)-Borough Park (West)
19-May,36047011000,3011000,12242,87755,99997,Brooklyn,1699056.633,Sunset Park (East)-Borough Park (West)
21-May,36047011000,3011000,3348,71719,75067,Brooklyn,1699056.633,Sunset Park (East)-Borough Park (West)
19-Jun,36047011000,3011000,11478,52787,64265,Brooklyn,1699056.633,Sunset Park (East)-Borough Park (West)
21-Jun,36047011000,3011000,12434,36065,48499,Brooklyn,1699056.633,Sunset Park (East)-Borough Park (West)
19-Jul,36047011000,3011000,12850,46383,59233,Brooklyn,1699056.633,Sunset Park (East)-Borough Park (West)
21-Jul,36047011000,3011000,11823,49125,60948,Brooklyn,1699056.633,Sunset Park (East)-Borough Park (West)
19-Aug,36047011000,3011000,0,59735,59735,Brooklyn,1699056.633,Sunset Park (East)-Borough Park (West)
21-Aug,36047011000,3011000,14275,19563,33838,Brooklyn,1699056.633,Sunset Park (East)-Borough Park (West)
19-May,36047011200,3011200,6207,85117,91324,Brooklyn,1843970.969,Sunset Park (East)-Borough Park (West)
21-May,36047011200,3011200,10023,91099,101122,Brooklyn,1843970.969,Sunset Park (East)-Borough Park (West)
19-Jun,36047011200,3011200,10303,100772,111075,Brooklyn,1843970.969,Sunset Park (East)-Borough Park (West)
21-Jun,36047011200,3011200,8209,102642,110851,Brooklyn,1843970.969,Sunset Park (East)-Borough Park (West)
19-Jul,36047011200,3011200,14216,38509,52725,Brooklyn,1843970.969,Sunset Park (East)-Borough Park (West)
21-Jul,36047011200,3011200,15313,71535,86848,Brooklyn,1843970.969,Sunset Park (East)-Borough Park (West)
19-Aug,36047011200,3011200,17756,116610,134366,Brooklyn,1843970.969,Sunset Park (East)-Borough Park (West)
21-Aug,36047011200,3011200,8622,67166,75788,Brooklyn,1843970.969,Sunset Park (East)-Borough Park (West)
19-May,36047011400,3011400,17784,79463,97247,Brooklyn,1806159.214,Sunset Park (East)-Borough Park (West)
21-May,36047011400,3011400,7338,65198,72536,Brooklyn,1806159.214,Sunset Park (East)-Borough Park (West)
19-Jun,36047011400,3011400,13885,134710,148595,Brooklyn,1806159.214,Sunset Park (East)-Borough Park (West)
21-Jun,36047011400,3011400,9393,78401,87794,Brooklyn,1806159.214,Sunset Park (East)-Borough Park (West)
19-Jul,36047011400,3011400,5188,80255,85443,Brooklyn,1806159.214,Sunset Park (East)-Borough Park (West)
21-Jul,36047011400,3011400,6456,75313,81769,Brooklyn,1806159.214,Sunset Park (East)-Borough Park (West)
19-Aug,36047011400,3011400,4855,113558,118413,Brooklyn,1806159.214,Sunset Park (East)-Borough Park (West)
21-Aug,36047011400,3011400,6303,133453,139756,Brooklyn,1806159.214,Sunset Park (East)-Borough Park (West)
19-May,36047011600,3011600,8525,145938,154463,Brooklyn,1724997.627,Sunset Park (East)-Borough Park (West)
21-May,36047011600,3011600,9750,27149,36899,Brooklyn,1724997.627,Sunset Park (East)-Borough Park (West)
19-Jun,36047011600,3011600,2942,69748,72690,Brooklyn,1724997.627,Sunset Park (East)-Borough Park (West)
21-Jun,36047011600,3011600,7712,85166,92878,Brooklyn,1724997.627,Sunset Park (East)-Borough Park (West)
19-Jul,36047011600,3011600,6248,39201,45449,Brooklyn,1724997.627,Sunset Park (East)-Borough Park (West)
21-Jul,36047011600,3011600,525,82376,82901,Brooklyn,1724997.627,Sunset Park (East)-Borough Park (West)
19-Aug,36047011600,3011600,5553,48271,53824,Brooklyn,1724997.627,Sunset Park (East)-Borough Park (West)
21-Aug,36047011600,3011600,6864,98777,105641,Brooklyn,1724997.627,Sunset Park (East)-Borough Park (West)
19-May,36047011800,3011800,8814,122519,131333,Brooklyn,2357119.59,Sunset Park (Central)
21-May,36047011800,3011800,14213,132152,146365,Brooklyn,2357119.59,Sunset Park (Central)
19-Jun,36047011800,3011800,12361,96539,108900,Brooklyn,2357119.59,Sunset Park (Central)
21-Jun,36047011800,3011800,8592,132737,141329,Brooklyn,2357119.59,Sunset Park (Central)
19-Jul,36047011800,3011800,9043,38517,47560,Brooklyn,2357119.59,Sunset Park (Central)
21-Jul,36047011800,3011800,8100,29496,37596,Brooklyn,2357119.59,Sunset Park (Central)
19-Aug,36047011800,3011800,8084,116933,125017,Brooklyn,2357119.59,Sunset Park (Central)
21-Aug,36047011800,3011800,14594,30188,44782,Brooklyn,2357119.59,Sunset Park (Central)
19-May,36047011901,3011901,7703,75678,83381,Brooklyn,5040710.776,Carroll Gardens-Cobble Hill-Gowanus-Red Hook
21-May,36047011901,3011901,16030,89011,105041,Brooklyn,5040710.776,Carroll Gardens-Cobble Hill-Gowanus-Red Hook
19-Jun,36047011901,3011901,2799,67650,70449,Brooklyn,5040710.776,Carroll Gardens-Cobble Hill-Gowanus-Red Hook
21-Jun,36047011901,3011901,15762,38666,54428,Brooklyn,5040710.776,Carroll Gardens-Cobble Hill-Gowanus-Red Hook
19-Jul,36047011901,3011901,9964,125197,135161,Brooklyn,5040710.776,Carroll Gardens-Cobble Hill-Gowanus-Red Hook
21-Jul,36047011901,3011901,8821,91946,100767,Brooklyn,5040710.776,Carroll Gardens-Cobble Hill-Gowanus-Red Hook
19-Aug,36047011901,3011901,6292,36812,43104,Brooklyn,5040710.776,Carroll Gardens-Cobble Hill-Gowanus-Red Hook
21-Aug,36047011901,3011901,14714,148657,163371,Brooklyn,5040710.776,Carroll Gardens-Cobble Hill-Gowanus-Red Hook
19-May,36047011902,3011902,16154,72023,88177,Brooklyn,2648288.576,Carroll Gardens-Cobble Hill-Gowanus-Red Hook
21-May,36047011902,3011902,16854,7524,24378,Brooklyn,2648288.576,Carroll Gardens-Cobble Hill-Gowanus-Red Hook
19-Jun,36047011902,3011902,4211,53192,57403,Brooklyn,2648288.576,Carroll Gardens-Cobble Hill-Gowanus-Red Hook
21-Jun,36047011902,3011902,4399,66090,70489,Brooklyn,2648288.576,Carroll Gardens-Cobble Hill-Gowanus-Red Hook
19-Jul,36047011902,3011902,5265,47846,53111,Brooklyn,2648288.576,Carroll Gardens-Cobble Hill-Gowanus-Red Hook
21-Jul,36047011902,3011902,2100,73593,75693,Brooklyn,2648288.576,Carroll Gardens-Cobble Hill-Gowanus-Red Hook
19-Aug,36047011902,3011902,10606,32998,43604,Brooklyn,2648288.576,Carroll Gardens-Cobble Hill-Gowanus-Red Hook
21-Aug,36047011902,3011902,10523,50128,60651,Brooklyn,2648288.576,Carroll Gardens-Cobble Hill-Gowanus-Red Hook
19-May,36047012000,3012000,10286,71,10357,Brooklyn,2077497.586,Dyker Heights
21-May,36047012000,3012000,8913,47020,55933,Brooklyn,2077497.586,Dyker Heights
19-Jun,36047012000,3012000,9722,67631,77353,Brooklyn,2077497.586,Dyker Heights
21-Jun,36047012000,3012000,4817,64225,69042,Brooklyn,2077497.586,Dyker Heights
19-Jul,36047012000,3012000,6834,105746,112580,Brooklyn,2077497.586,Dyker Heights
21-Jul,36047012000,3012000,20780,78287,99067,Brooklyn,2077497.586,Dyker Heights
19-Aug,36047012000,3012000,6196,81367,87563,Brooklyn,2077497.586,Dyker Heights
21-Aug,36047012000,3012000,3857,71,3928,Brooklyn,2077497.586,Dyker Heights
19-May,36047012100,3012100,18828,23351,42179,Brooklyn,1593259.294,Carroll Gardens-Cobble Hill-Gowanus-Red Hook
21-May,36047012100,3012100,11577,93976,105553,Brooklyn,1593259.294,Carroll Gardens-Cobble Hill-Gowanus-Red Hook
19-Jun,36047012100,3012100,10841,60050,70891,Brooklyn,1593259.294,Carroll Gardens-Cobble Hill-Gowanus-Red Hook
21-Jun,36047012100,3012100,2075,60835,62910,Brooklyn,1593259.294,Carroll Gardens-Cobble Hill-Gowanus-Red Hook
19-Jul,36047012100,3012100,11855,54956,66811,Brooklyn,1593259.294,Carroll Gardens-Cobble Hill-Gowanus-Red Hook
21-Jul,36047012100,3012100,3951,56636,60587,Brooklyn,1593259.294,Carroll Gardens-Cobble Hill-Gowanus-Red Hook
19-Aug,36047012100,3012100,8410,112170,120580,Brooklyn,1593259.294,Carroll Gardens-Cobble Hill-Gowanus-Red Hook
21-Aug,36047012100,3012100,10400,88249,98649,Brooklyn,1593259.294,Carroll Gardens-Cobble Hill-Gowanus-Red Hook
19-May,36047012200,3012200,13975,62509,76484,Brooklyn,1951564.98,Sunset Park (Central)
21-May,36047012200,3012200,15736,24075,39811,Brooklyn,1951564.98,Sunset Park (Central)
19-Jun,36047012200,3012200,15423,67839,83262,Brooklyn,1951564.98,Sunset Park (Central)
21-Jun,36047012200,3012200,10795,63825,74620,Brooklyn,1951564.98,Sunset Park (Central)
19-Jul,36047012200,3012200,15119,119479,134598,Brooklyn,1951564.98,Sunset Park (Central)
21-Jul,36047012200,3012200,1369,53864,55233,Brooklyn,1951564.98,Sunset Park (Central)
19-Aug,36047012200,3012200,15930,44245,60175,Brooklyn,1951564.98,Sunset Park (Central)
21-Aug,36047012200,3012200,2310,28980,31290,Brooklyn,1951564.98,Sunset Park (Central)
19-May,36047012600,3012600,14334,94889,109223,Brooklyn,2553793.868,Bay Ridge
21-May,36047012600,3012600,10344,9578,19922,Brooklyn,2553793.868,Bay Ridge
19-Jun,36047012600,3012600,3148,153624,156772,Brooklyn,2553793.868,Bay Ridge
21-Jun,36047012600,3012600,11178,76758,87936,Brooklyn,2553793.868,Bay Ridge
19-Jul,36047012600,3012600,16906,70718,87624,Brooklyn,2553793.868,Bay Ridge
21-Jul,36047012600,3012600,5699,119462,125161,Brooklyn,2553793.868,Bay Ridge
19-Aug,36047012600,3012600,10299,112950,123249,Brooklyn,2553793.868,Bay Ridge
21-Aug,36047012600,3012600,5978,83804,89782,Brooklyn,2553793.868,Bay Ridge
19-May,36047012700,3012700,6747,32659,39406,Brooklyn,1759480.862,Carroll Gardens-Cobble Hill-Gowanus-Red Hook
21-May,36047012700,3012700,6526,4820,11346,Brooklyn,1759480.862,Carroll Gardens-Cobble Hill-Gowanus-Red Hook
19-Jun,36047012700,3012700,5919,88178,94097,Brooklyn,1759480.862,Carroll Gardens-Cobble Hill-Gowanus-Red Hook
21-Jun,36047012700,3012700,8147,53618,61765,Brooklyn,1759480.862,Carroll Gardens-Cobble Hill-Gowanus-Red Hook
19-Jul,36047012700,3012700,15826,80430,96256,Brooklyn,1759480.862,Carroll Gardens-Cobble Hill-Gowanus-Red Hook
21-Jul,36047012700,3012700,9759,121115,130874,Brooklyn,1759480.862,Carroll Gardens-Cobble Hill-Gowanus-Red Hook
19-Aug,36047012700,3012700,12922,117223,130145,Brooklyn,1759480.862,Carroll Gardens-Cobble Hill-Gowanus-Red Hook
21-Aug,36047012700,3012700,8392,149071,157463,Brooklyn,1759480.862,Carroll Gardens-Cobble Hill-Gowanus-Red Hook
19-May,36047012801,3012801,8065,70395,78460,Brooklyn,1238338.629,Dyker Heights
21-May,36047012801,3012801,10560,102732,113292,Brooklyn,1238338.629,Dyker Heights
19-Jun,36047012801,3012801,13307,26663,39970,Brooklyn,1238338.629,Dyker Heights
21-Jun,36047012801,3012801,8386,30231,38617,Brooklyn,1238338.629,Dyker Heights
19-Jul,36047012801,3012801,8468,101057,109525,Brooklyn,1238338.629,Dyker Heights
21-Jul,36047012801,3012801,16879,117123,134002,Brooklyn,1238338.629,Dyker Heights
19-Aug,36047012801,3012801,18609,67896,86505,Brooklyn,1238338.629,Dyker Heights
21-Aug,36047012801,3012801,10679,92717,103396,Brooklyn,1238338.629,Dyker Heights
19-May,36047012901,3012901,9900,87547,97447,Brooklyn,1390943.052,Park Slope
21-May,36047012901,3012901,11719,87271,98990,Brooklyn,1390943.052,Park Slope
19-Jun,36047012901,3012901,9978,53515,63493,Brooklyn,1390943.052,Park Slope
21-Jun,36047012901,3012901,0,52496,52496,Brooklyn,1390943.052,Park Slope
19-Jul,36047012901,3012901,5000,37450,42450,Brooklyn,1390943.052,Park Slope
21-Jul,36047012901,3012901,7157,51168,58325,Brooklyn,1390943.052,Park Slope
19-Aug,36047012901,3012901,11432,56193,67625,Brooklyn,1390943.052,Park Slope
21-Aug,36047012901,3012901,17306,71,17377,Brooklyn,1390943.052,Park Slope
19-May,36047012902,3012902,2186,47274,49460,Brooklyn,1461597.024,Park Slope
21-May,36047012902,3012902,4754,113647,118401,Brooklyn,1461597.024,Park Slope
19-Jun,36047012902,3012902,11284,35550,46834,Brooklyn,1461597.024,Park Slope
21-Jun,36047012902,3012902,5116,111026,116142,Brooklyn,1461597.024,Park Slope
19-Jul,36047012902,3012902,7629,80046,87675,Brooklyn,1461597.024,Park Slope
21-Jul,36047012902,3012902,4718,25076,29794,Brooklyn,1461597.024,Park Slope
19-Aug,36047012902,3012902,14545,72588,87133,Brooklyn,1461597.024,Park Slope
21-Aug,36047012902,3012902,6803,80872,87675,Brooklyn,1461597.024,Park Slope
19-May,36047013000,3013000,15090,107645,122735,Brooklyn,1899181.508,Bay Ridge
21-May,36047013000,3013000,0,84016,84016,Brooklyn,1899181.508,Bay Ridge
19-Jun,36047013000,3013000,6134,91442,97576,Brooklyn,1899181.508,Bay Ridge
21-Jun,36047013000,3013000,19940,76036,95976,Brooklyn,1899181.508,Bay Ridge
19-Jul,36047013000,3013000,11105,7674,18779,Brooklyn,1899181.508,Bay Ridge
21-Jul,36047013000,3013000,6564,44853,51417,Brooklyn,1899181.508,Bay Ridge
19-Aug,36047013000,3013000,10360,30593,40953,Brooklyn,1899181.508,Bay Ridge
21-Aug,36047013000,3013000,9437,94672,104109,Brooklyn,1899181.508,Bay Ridge
19-May,36047013100,3013100,7914,95642,103556,Brooklyn,1684555.977,Park Slope
21-May,36047013100,3013100,6564,83260,89824,Brooklyn,1684555.977,Park Slope
19-Jun,36047013100,3013100,8151,111868,120019,Brooklyn,1684555.977,Park Slope
21-Jun,36047013100,3013100,18299,85875,104174,Brooklyn,1684555.977,Park Slope
19-Jul,36047013100,3013100,11029,73759,84788,Brooklyn,1684555.977,Park Slope
21-Jul,36047013100,3013100,9619,86079,95698,Brooklyn,1684555.977,Park Slope
19-Aug,36047013100,3013100,5094,147300,152394,Brooklyn,1684555.977,Park Slope
21-Aug,36047013100,3013100,9342,10637,19979,Brooklyn,1684555.977,Park Slope
19-May,36047013200,3013200,4566,36138,40704,Brooklyn,1676563.692,Dyker Heights
21-May,36047013200,3013200,14840,2240,17080,Brooklyn,1676563.692,Dyker Heights
19-Jun,36047013200,3013200,13596,55662,69258,Brooklyn,1676563.692,Dyker Heights
21-Jun,36047013200,3013200,12578,107606,120184,Brooklyn,1676563.692,Dyker Heights
19-Jul,36047013200,3013200,0,93630,93630,Brooklyn,1676563.692,Dyker Heights
21-Jul,36047013200,3013200,135,49447,49582,Brooklyn,1676563.692,Dyker Heights
19-Aug,36047013200,3013200,7245,71,7316,Brooklyn,1676563.692,Dyker Heights
21-Aug,36047013200,3013200,9025,20791,29816,Brooklyn,1676563.692,Dyker Heights
19-May,36047013300,3013300,3120,36806,39926,Brooklyn,1596011.126,Park Slope
21-May,36047013300,3013300,13957,94069,108026,Brooklyn,1596011.126,Park Slope
19-Jun,36047013300,3013300,8010,110065,118075,Brooklyn,1596011.126,Park Slope
21-Jun,36047013300,3013300,7907,74734,82641,Brooklyn,1596011.126,Park Slope
19-Jul,36047013300,3013300,0,67345,67345,Brooklyn,1596011.126,Park Slope
21-Jul,36047013300,3013300,11031,115750,126781,Brooklyn,1596011.126,Park Slope
19-Aug,36047013300,3013300,15492,71,15563,Brooklyn,1596011.126,Park Slope
21-Aug,36047013300,3013300,10674,79460,90134,Brooklyn,1596011.126,Park Slope
19-May,36047013400,3013400,7532,113748,121280,Brooklyn,2887190.065,Bay Ridge
21-May,36047013400,3013400,8131,56031,64162,Brooklyn,2887190.065,Bay Ridge
19-Jun,36047013400,3013400,764,75466,76230,Brooklyn,2887190.065,Bay Ridge
21-Jun,36047013400,3013400,8317,58545,66862,Brooklyn,2887190.065,Bay Ridge
19-Jul,36047013400,3013400,2836,57667,60503,Brooklyn,2887190.065,Bay Ridge
21-Jul,36047013400,3013400,9556,69134,78690,Brooklyn,2887190.065,Bay Ridge
19-Aug,36047013400,3013400,5479,43743,49222,Brooklyn,2887190.065,Bay Ridge
21-Aug,36047013400,3013400,0,104032,104032,Brooklyn,2887190.065,Bay Ridge
19-May,36047013500,3013500,6580,68850,75430,Brooklyn,1635300.96,Park Slope
21-May,36047013500,3013500,13743,61304,75047,Brooklyn,1635300.96,Park Slope
19-Jun,36047013500,3013500,3500,71,3571,Brooklyn,1635300.96,Park Slope
21-Jun,36047013500,3013500,7613,39014,46627,Brooklyn,1635300.96,Park Slope
19-Jul,36047013500,3013500,10485,46209,56694,Brooklyn,1635300.96,Park Slope
21-Jul,36047013500,3013500,9021,63103,72124,Brooklyn,1635300.96,Park Slope
19-Aug,36047013500,3013500,6157,98542,104699,Brooklyn,1635300.96,Park Slope
21-Aug,36047013500,3013500,12207,32570,44777,Brooklyn,1635300.96,Park Slope
19-May,36047013600,3013600,12545,25169,37714,Brooklyn,2312743.103,Bay Ridge
21-May,36047013600,3013600,11223,30078,41301,Brooklyn,2312743.103,Bay Ridge
19-Jun,36047013600,3013600,4997,55490,60487,Brooklyn,2312743.103,Bay Ridge
21-Jun,36047013600,3013600,5088,38754,43842,Brooklyn,2312743.103,Bay Ridge
19-Jul,36047013600,3013600,12607,151604,164211,Brooklyn,2312743.103,Bay Ridge
21-Jul,36047013600,3013600,7646,127942,135588,Brooklyn,2312743.103,Bay Ridge
19-Aug,36047013600,3013600,4749,95697,100446,Brooklyn,2312743.103,Bay Ridge
21-Aug,36047013600,3013600,12792,63008,75800,Brooklyn,2312743.103,Bay Ridge
19-May,36047013700,3013700,5597,107356,112953,Brooklyn,1638365.956,Park Slope
21-May,36047013700,3013700,5791,67152,72943,Brooklyn,1638365.956,Park Slope
19-Jun,36047013700,3013700,15276,39233,54509,Brooklyn,1638365.956,Park Slope
21-Jun,36047013700,3013700,12741,15517,28258,Brooklyn,1638365.956,Park Slope
19-Jul,36047013700,3013700,10773,24014,34787,Brooklyn,1638365.956,Park Slope
21-Jul,36047013700,3013700,3061,75234,78295,Brooklyn,1638365.956,Park Slope
19-Aug,36047013700,3013700,9010,108024,117034,Brooklyn,1638365.956,Park Slope
21-Aug,36047013700,3013700,1193,119743,120936,Brooklyn,1638365.956,Park Slope
19-May,36047013800,3013800,7619,45043,52662,Brooklyn,1749765.039,Bay Ridge
21-May,36047013800,3013800,9314,66341,75655,Brooklyn,1749765.039,Bay Ridge
19-Jun,36047013800,3013800,4080,96310,100390,Brooklyn,1749765.039,Bay Ridge
21-Jun,36047013800,3013800,12712,71,12783,Brooklyn,1749765.039,Bay Ridge
19-Jul,36047013800,3013800,13613,74752,88365,Brooklyn,1749765.039,Bay Ridge
21-Jul,36047013800,3013800,5322,26479,31801,Brooklyn,1749765.039,Bay Ridge
19-Aug,36047013800,3013800,11419,54134,65553,Brooklyn,1749765.039,Bay Ridge
21-Aug,36047013800,3013800,14908,105270,120178,Brooklyn,1749765.039,Bay Ridge
19-May,36047013900,3013900,0,130459,130459,Brooklyn,1631336.715,Park Slope
21-May,36047013900,3013900,11032,66387,77419,Brooklyn,1631336.715,Park Slope
19-Jun,36047013900,3013900,5625,66182,71807,Brooklyn,1631336.715,Park Slope
21-Jun,36047013900,3013900,8091,104351,112442,Brooklyn,1631336.715,Park Slope
19-Jul,36047013900,3013900,10461,44265,54726,Brooklyn,1631336.715,Park Slope
21-Jul,36047013900,3013900,10547,84997,95544,Brooklyn,1631336.715,Park Slope
19-Aug,36047013900,3013900,9286,54683,63969,Brooklyn,1631336.715,Park Slope
21-Aug,36047013900,3013900,8747,67741,76488,Brooklyn,1631336.715,Park Slope
19-May,36047014000,3014000,13337,91025,104362,Brooklyn,1578343.075,Dyker Heights
21-May,36047014000,3014000,14200,15547,29747,Brooklyn,1578343.075,Dyker Heights
19-Jun,36047014000,3014000,14221,40533,54754,Brooklyn,1578343.075,Dyker Heights
21-Jun,36047014000,3014000,17143,45620,62763,Brooklyn,1578343.075,Dyker Heights
19-Jul,36047014000,3014000,10263,71308,81571,Brooklyn,1578343.075,Dyker Heights
21-Jul,36047014000,3014000,10459,36580,47039,Brooklyn,1578343.075,Dyker Heights
19-Aug,36047014000,3014000,6698,8919,15617,Brooklyn,1578343.075,Dyker Heights
21-Aug,36047014000,3014000,5278,65962,71240,Brooklyn,1578343.075,Dyker Heights
19-May,36047014200,3014200,1882,45223,47105,Brooklyn,2160045.415,Bay Ridge
21-May,36047014200,3014200,2832,55129,57961,Brooklyn,2160045.415,Bay Ridge
19-Jun,36047014200,3014200,12412,68075,80487,Brooklyn,2160045.415,Bay Ridge
21-Jun,36047014200,3014200,17753,47066,64819,Brooklyn,2160045.415,Bay Ridge
19-Jul,36047014200,3014200,6689,48034,54723,Brooklyn,2160045.415,Bay Ridge
21-Jul,36047014200,3014200,0,7647,7647,Brooklyn,2160045.415,Bay Ridge
19-Aug,36047014200,3014200,5927,24599,30526,Brooklyn,2160045.415,Bay Ridge
21-Aug,36047014200,3014200,11174,101485,112659,Brooklyn,2160045.415,Bay Ridge
19-May,36047014700,3014700,4695,54573,59268,Brooklyn,1142138.214,Sunset Park (West)
21-May,36047014700,3014700,8688,67606,76294,Brooklyn,1142138.214,Sunset Park (West)
19-Jun,36047014700,3014700,2460,45669,48129,Brooklyn,1142138.214,Sunset Park (West)
21-Jun,36047014700,3014700,6824,58404,65228,Brooklyn,1142138.214,Sunset Park (West)
19-Jul,36047014700,3014700,12512,104605,117117,Brooklyn,1142138.214,Sunset Park (West)
21-Jul,36047014700,3014700,3805,24207,28012,Brooklyn,1142138.214,Sunset Park (West)
19-Aug,36047014700,3014700,11574,31093,42667,Brooklyn,1142138.214,Sunset Park (West)
21-Aug,36047014700,3014700,10566,122787,133353,Brooklyn,1142138.214,Sunset Park (West)
19-May,36047014800,3014800,5670,17366,23036,Brooklyn,1437563.892,Dyker Heights
21-May,36047014800,3014800,14874,47791,62665,Brooklyn,1437563.892,Dyker Heights
19-Jun,36047014800,3014800,9815,57557,67372,Brooklyn,1437563.892,Dyker Heights
21-Jun,36047014800,3014800,6500,30837,37337,Brooklyn,1437563.892,Dyker Heights
19-Jul,36047014800,3014800,4888,27716,32604,Brooklyn,1437563.892,Dyker Heights
21-Jul,36047014800,3014800,7094,4328,11422,Brooklyn,1437563.892,Dyker Heights
19-Aug,36047014800,3014800,5319,137284,142603,Brooklyn,1437563.892,Dyker Heights
21-Aug,36047014800,3014800,4270,42486,46756,Brooklyn,1437563.892,Dyker Heights
19-May,36047014901,3014901,14943,55267,70210,Brooklyn,807279.6709,Park Slope
21-May,36047014901,3014901,4263,125952,130215,Brooklyn,807279.6709,Park Slope
19-Jun,36047014901,3014901,8700,83945,92645,Brooklyn,807279.6709,Park Slope
21-Jun,36047014901,3014901,7531,100067,107598,Brooklyn,807279.6709,Park Slope
19-Jul,36047014901,3014901,12661,97651,110312,Brooklyn,807279.6709,Park Slope
21-Jul,36047014901,3014901,12767,19766,32533,Brooklyn,807279.6709,Park Slope
19-Aug,36047014901,3014901,6893,73113,80006,Brooklyn,807279.6709,Park Slope
21-Aug,36047014901,3014901,373,77397,77770,Brooklyn,807279.6709,Park Slope
19-May,36047014902,3014902,11528,122364,133892,Brooklyn,1877519.854,Windsor Terrace-South Slope
21-May,36047014902,3014902,0,21505,21505,Brooklyn,1877519.854,Windsor Terrace-South Slope
19-Jun,36047014902,3014902,8072,106944,115016,Brooklyn,1877519.854,Windsor Terrace-South Slope
21-Jun,36047014902,3014902,7309,77718,85027,Brooklyn,1877519.854,Windsor Terrace-South Slope
19-Jul,36047014902,3014902,11796,88672,100468,Brooklyn,1877519.854,Windsor Terrace-South Slope
21-Jul,36047014902,3014902,398,59762,60160,Brooklyn,1877519.854,Windsor Terrace-South Slope
19-Aug,36047014902,3014902,15760,34260,50020,Brooklyn,1877519.854,Windsor Terrace-South Slope
21-Aug,36047014902,3014902,0,61143,61143,Brooklyn,1877519.854,Windsor Terrace-South Slope
19-May,36047015000,3015000,16218,36708,52926,Brooklyn,1436079.966,Dyker Heights
21-May,36047015000,3015000,6518,99174,105692,Brooklyn,1436079.966,Dyker Heights
19-Jun,36047015000,3015000,13933,50898,64831,Brooklyn,1436079.966,Dyker Heights
21-Jun,36047015000,3015000,13092,122764,135856,Brooklyn,1436079.966,Dyker Heights
19-Jul,36047015000,3015000,9727,74742,84469,Brooklyn,1436079.966,Dyker Heights
21-Jul,36047015000,3015000,6049,32040,38089,Brooklyn,1436079.966,Dyker Heights
19-Aug,36047015000,3015000,0,114150,114150,Brooklyn,1436079.966,Dyker Heights
21-Aug,36047015000,3015000,6767,69892,76659,Brooklyn,1436079.966,Dyker Heights
19-May,36047015100,3015100,10306,15426,25732,Brooklyn,1607114.185,Park Slope
21-May,36047015100,3015100,7328,66342,73670,Brooklyn,1607114.185,Park Slope
19-Jun,36047015100,3015100,3026,134228,137254,Brooklyn,1607114.185,Park Slope
21-Jun,36047015100,3015100,6598,41992,48590,Brooklyn,1607114.185,Park Slope
19-Jul,36047015100,3015100,9207,111465,120672,Brooklyn,1607114.185,Park Slope
21-Jul,36047015100,3015100,7507,74431,81938,Brooklyn,1607114.185,Park Slope
19-Aug,36047015100,3015100,9947,114009,123956,Brooklyn,1607114.185,Park Slope
21-Aug,36047015100,3015100,912,25973,26885,Brooklyn,1607114.185,Park Slope
19-May,36047015200,3015200,10019,113452,123471,Brooklyn,2884401.543,Bay Ridge
21-May,36047015200,3015200,1682,106880,108562,Brooklyn,2884401.543,Bay Ridge
19-Jun,36047015200,3015200,11368,88671,100039,Brooklyn,2884401.543,Bay Ridge
21-Jun,36047015200,3015200,8737,14083,22820,Brooklyn,2884401.543,Bay Ridge
19-Jul,36047015200,3015200,7891,105412,113303,Brooklyn,2884401.543,Bay Ridge
21-Jul,36047015200,3015200,10883,106689,117572,Brooklyn,2884401.543,Bay Ridge
19-Aug,36047015200,3015200,9794,91459,101253,Brooklyn,2884401.543,Bay Ridge
21-Aug,36047015200,3015200,12508,88521,101029,Brooklyn,2884401.543,Bay Ridge
19-May,36047015300,3015300,9281,47258,56539,Brooklyn,1619490.172,Park Slope
21-May,36047015300,3015300,0,115483,115483,Brooklyn,1619490.172,Park Slope
19-Jun,36047015300,3015300,18932,100754,119686,Brooklyn,1619490.172,Park Slope
21-Jun,36047015300,3015300,8860,104643,113503,Brooklyn,1619490.172,Park Slope
19-Jul,36047015300,3015300,7566,44252,51818,Brooklyn,1619490.172,Park Slope
21-Jul,36047015300,3015300,7213,82798,90011,Brooklyn,1619490.172,Park Slope
19-Aug,36047015300,3015300,2764,66388,69152,Brooklyn,1619490.172,Park Slope
21-Aug,36047015300,3015300,540,103097,103637,Brooklyn,1619490.172,Park Slope
19-May,36047015400,3015400,5790,109203,114993,Brooklyn,9989377.443,Dyker Beach Park
21-May,36047015400,3015400,2108,18872,20980,Brooklyn,9989377.443,Dyker Beach Park
19-Jun,36047015400,3015400,14873,22916,37789,Brooklyn,9989377.443,Dyker Beach Park
21-Jun,36047015400,3015400,2375,73565,75940,Brooklyn,9989377.443,Dyker Beach Park
19-Jul,36047015400,3015400,119,105484,105603,Brooklyn,9989377.443,Dyker Beach Park
21-Jul,36047015400,3015400,23130,80151,103281,Brooklyn,9989377.443,Dyker Beach Park
19-Aug,36047015400,3015400,297,92868,93165,Brooklyn,9989377.443,Dyker Beach Park
21-Aug,36047015400,3015400,4494,74406,78900,Brooklyn,9989377.443,Dyker Beach Park
19-May,36047015500,3015500,13169,86515,99684,Brooklyn,1610814.621,Park Slope
21-May,36047015500,3015500,2374,48711,51085,Brooklyn,1610814.621,Park Slope
19-Jun,36047015500,3015500,7709,78941,86650,Brooklyn,1610814.621,Park Slope
21-Jun,36047015500,3015500,2627,57498,60125,Brooklyn,1610814.621,Park Slope
19-Jul,36047015500,3015500,11351,7066,18417,Brooklyn,1610814.621,Park Slope
21-Jul,36047015500,3015500,11540,36118,47658,Brooklyn,1610814.621,Park Slope
19-Aug,36047015500,3015500,7911,72529,80440,Brooklyn,1610814.621,Park Slope
21-Aug,36047015500,3015500,2938,86786,89724,Brooklyn,1610814.621,Park Slope
19-May,36047015700,3015700,7897,39057,46954,Brooklyn,1802056.244,Park Slope
21-May,36047015700,3015700,12341,53032,65373,Brooklyn,1802056.244,Park Slope
19-Jun,36047015700,3015700,8192,29857,38049,Brooklyn,1802056.244,Park Slope
21-Jun,36047015700,3015700,10835,71,10906,Brooklyn,1802056.244,Park Slope
19-Jul,36047015700,3015700,4236,100315,104551,Brooklyn,1802056.244,Park Slope
21-Jul,36047015700,3015700,8534,134167,142701,Brooklyn,1802056.244,Park Slope
19-Aug,36047015700,3015700,12424,60191,72615,Brooklyn,1802056.244,Park Slope
21-Aug,36047015700,3015700,5391,35473,40864,Brooklyn,1802056.244,Park Slope
19-May,36047015900,3015900,10021,54547,64568,Brooklyn,2699300.419,Park Slope
21-May,36047015900,3015900,10480,132332,142812,Brooklyn,2699300.419,Park Slope
19-Jun,36047015900,3015900,16659,81580,98239,Brooklyn,2699300.419,Park Slope
21-Jun,36047015900,3015900,10202,97108,107310,Brooklyn,2699300.419,Park Slope
19-Jul,36047015900,3015900,11164,54775,65939,Brooklyn,2699300.419,Park Slope
21-Jul,36047015900,3015900,8674,88979,97653,Brooklyn,2699300.419,Park Slope
19-Aug,36047015900,3015900,8374,29306,37680,Brooklyn,2699300.419,Park Slope
21-Aug,36047015900,3015900,9768,112202,121970,Brooklyn,2699300.419,Park Slope
19-May,36047016000,3016000,0,76510,76510,Brooklyn,2785263.975,Bay Ridge
21-May,36047016000,3016000,13551,21137,34688,Brooklyn,2785263.975,Bay Ridge
19-Jun,36047016000,3016000,10821,109399,120220,Brooklyn,2785263.975,Bay Ridge
21-Jun,36047016000,3016000,5584,38225,43809,Brooklyn,2785263.975,Bay Ridge
19-Jul,36047016000,3016000,4506,38374,42880,Brooklyn,2785263.975,Bay Ridge
21-Jul,36047016000,3016000,0,117102,117102,Brooklyn,2785263.975,Bay Ridge
19-Aug,36047016000,3016000,5211,79865,85076,Brooklyn,2785263.975,Bay Ridge
21-Aug,36047016000,3016000,0,68038,68038,Brooklyn,2785263.975,Bay Ridge
19-May,36047016100,3016100,17620,109693,127313,Brooklyn,1964156.72,Prospect Heights
21-May,36047016100,3016100,5151,31713,36864,Brooklyn,1964156.72,Prospect Heights
19-Jun,36047016100,3016100,9468,69816,79284,Brooklyn,1964156.72,Prospect Heights
21-Jun,36047016100,3016100,7611,91264,98875,Brooklyn,1964156.72,Prospect Heights
19-Jul,36047016100,3016100,0,101503,101503,Brooklyn,1964156.72,Prospect Heights
21-Jul,36047016100,3016100,9013,47959,56972,Brooklyn,1964156.72,Prospect Heights
19-Aug,36047016100,3016100,15646,117093,132739,Brooklyn,1964156.72,Prospect Heights
21-Aug,36047016100,3016100,6983,93308,100291,Brooklyn,1964156.72,Prospect Heights
19-May,36047016300,3016300,4489,9571,14060,Brooklyn,1980070.646,Prospect Heights
21-May,36047016300,3016300,5638,83174,88812,Brooklyn,1980070.646,Prospect Heights
19-Jun,36047016300,3016300,7836,59668,67504,Brooklyn,1980070.646,Prospect Heights
21-Jun,36047016300,3016300,10192,34427,44619,Brooklyn,1980070.646,Prospect Heights
19-Jul,36047016300,3016300,5026,37642,42668,Brooklyn,1980070.646,Prospect Heights
21-Jul,36047016300,3016300,18169,105514,123683,Brooklyn,1980070.646,Prospect Heights
19-Aug,36047016300,3016300,348,84945,85293,Brooklyn,1980070.646,Prospect Heights
21-Aug,36047016300,3016300,10976,64384,75360,Brooklyn,1980070.646,Prospect Heights
19-May,36047016500,3016500,4468,2585,7053,Brooklyn,2010390.765,Park Slope
21-May,36047016500,3016500,12632,52926,65558,Brooklyn,2010390.765,Park Slope
19-Jun,36047016500,3016500,3741,134397,138138,Brooklyn,2010390.765,Park Slope
21-Jun,36047016500,3016500,3632,70869,74501,Brooklyn,2010390.765,Park Slope
19-Jul,36047016500,3016500,14025,43275,57300,Brooklyn,2010390.765,Park Slope
21-Jul,36047016500,3016500,9485,61942,71427,Brooklyn,2010390.765,Park Slope
19-Aug,36047016500,3016500,8625,113663,122288,Brooklyn,2010390.765,Park Slope
21-Aug,36047016500,3016500,12837,52476,65313,Brooklyn,2010390.765,Park Slope
19-May,36047016600,3016600,6502,75540,82042,Brooklyn,2873519.887,Dyker Heights
21-May,36047016600,3016600,12097,79062,91159,Brooklyn,2873519.887,Dyker Heights
19-Jun,36047016600,3016600,12106,26710,38816,Brooklyn,2873519.887,Dyker Heights
21-Jun,36047016600,3016600,5511,39409,44920,Brooklyn,2873519.887,Dyker Heights
19-Jul,36047016600,3016600,9676,32626,42302,Brooklyn,2873519.887,Dyker Heights
21-Jul,36047016600,3016600,4708,71,4779,Brooklyn,2873519.887,Dyker Heights
19-Aug,36047016600,3016600,5701,9941,15642,Brooklyn,2873519.887,Dyker Heights
21-Aug,36047016600,3016600,6786,52338,59124,Brooklyn,2873519.887,Dyker Heights
19-May,36047016700,3016700,1718,74193,75911,Brooklyn,1818135.602,Park Slope
21-May,36047016700,3016700,8690,162478,171168,Brooklyn,1818135.602,Park Slope
19-Jun,36047016700,3016700,2631,109632,112263,Brooklyn,1818135.602,Park Slope
21-Jun,36047016700,3016700,6049,95664,101713,Brooklyn,1818135.602,Park Slope
19-Jul,36047016700,3016700,9671,83793,93464,Brooklyn,1818135.602,Park Slope
21-Jul,36047016700,3016700,14558,81324,95882,Brooklyn,1818135.602,Park Slope
19-Aug,36047016700,3016700,2874,82099,84973,Brooklyn,1818135.602,Park Slope
21-Aug,36047016700,3016700,10366,63137,73503,Brooklyn,1818135.602,Park Slope
19-May,36047016800,3016800,10740,54722,65462,Brooklyn,1792404.541,Bath Beach
21-May,36047016800,3016800,0,98612,98612,Brooklyn,1792404.541,Bath Beach
19-Jun,36047016800,3016800,9380,109153,118533,Brooklyn,1792404.541,Bath Beach
21-Jun,36047016800,3016800,5589,59356,64945,Brooklyn,1792404.541,Bath Beach
19-Jul,36047016800,3016800,11461,96094,107555,Brooklyn,1792404.541,Bath Beach
21-Jul,36047016800,3016800,7299,64563,71862,Brooklyn,1792404.541,Bath Beach
19-Aug,36047016800,3016800,1251,28346,29597,Brooklyn,1792404.541,Bath Beach
21-Aug,36047016800,3016800,9840,19990,29830,Brooklyn,1792404.541,Bath Beach
19-May,36047016900,3016900,5577,130304,135881,Brooklyn,2257354.425,Windsor Terrace-South Slope
21-May,36047016900,3016900,9157,33970,43127,Brooklyn,2257354.425,Windsor Terrace-South Slope
19-Jun,36047016900,3016900,12395,141559,153954,Brooklyn,2257354.425,Windsor Terrace-South Slope
21-Jun,36047016900,3016900,5137,38925,44062,Brooklyn,2257354.425,Windsor Terrace-South Slope
19-Jul,36047016900,3016900,4984,130667,135651,Brooklyn,2257354.425,Windsor Terrace-South Slope
21-Jul,36047016900,3016900,23755,116792,140547,Brooklyn,2257354.425,Windsor Terrace-South Slope
19-Aug,36047016900,3016900,8916,44223,53139,Brooklyn,2257354.425,Windsor Terrace-South Slope
21-Aug,36047016900,3016900,6065,85010,91075,Brooklyn,2257354.425,Windsor Terrace-South Slope
19-May,36047017000,3017000,5376,50382,55758,Brooklyn,2249706.664,Bath Beach
21-May,36047017000,3017000,16678,53639,70317,Brooklyn,2249706.664,Bath Beach
19-Jun,36047017000,3017000,0,103144,103144,Brooklyn,2249706.664,Bath Beach
21-Jun,36047017000,3017000,14486,32518,47004,Brooklyn,2249706.664,Bath Beach
19-Jul,36047017000,3017000,15912,63061,78973,Brooklyn,2249706.664,Bath Beach
21-Jul,36047017000,3017000,2737,71,2808,Brooklyn,2249706.664,Bath Beach
19-Aug,36047017000,3017000,1417,95938,97355,Brooklyn,2249706.664,Bath Beach
21-Aug,36047017000,3017000,5523,31211,36734,Brooklyn,2249706.664,Bath Beach
19-May,36047017200,3017200,3645,104372,108017,Brooklyn,2216345.854,Bath Beach
21-May,36047017200,3017200,11769,80163,91932,Brooklyn,2216345.854,Bath Beach
19-Jun,36047017200,3017200,6192,70807,76999,Brooklyn,2216345.854,Bath Beach
21-Jun,36047017200,3017200,5080,105735,110815,Brooklyn,2216345.854,Bath Beach
19-Jul,36047017200,3017200,16089,43151,59240,Brooklyn,2216345.854,Bath Beach
21-Jul,36047017200,3017200,18485,93388,111873,Brooklyn,2216345.854,Bath Beach
19-Aug,36047017200,3017200,6187,56588,62775,Brooklyn,2216345.854,Bath Beach
21-Aug,36047017200,3017200,4110,64625,68735,Brooklyn,2216345.854,Bath Beach
19-May,36047017400,3017400,10549,67535,78084,Brooklyn,1773747.672,Bath Beach
21-May,36047017400,3017400,11309,81045,92354,Brooklyn,1773747.672,Bath Beach
19-Jun,36047017400,3017400,9199,76337,85536,Brooklyn,1773747.672,Bath Beach
21-Jun,36047017400,3017400,12358,57164,69522,Brooklyn,1773747.672,Bath Beach
19-Jul,36047017400,3017400,18174,65762,83936,Brooklyn,1773747.672,Bath Beach
21-Jul,36047017400,3017400,11927,78087,90014,Brooklyn,1773747.672,Bath Beach
19-Aug,36047017400,3017400,7912,26806,34718,Brooklyn,1773747.672,Bath Beach
21-Aug,36047017400,3017400,13703,32335,46038,Brooklyn,1773747.672,Bath Beach
19-May,36047017500,3017500,8765,31366,40131,Brooklyn,21101598.4,Green-Wood Cemetery
21-May,36047017500,3017500,6920,61517,68437,Brooklyn,21101598.4,Green-Wood Cemetery
19-Jun,36047017500,3017500,5496,158728,164224,Brooklyn,21101598.4,Green-Wood Cemetery
21-Jun,36047017500,3017500,7506,82132,89638,Brooklyn,21101598.4,Green-Wood Cemetery
19-Jul,36047017500,3017500,12525,64430,76955,Brooklyn,21101598.4,Green-Wood Cemetery
21-Jul,36047017500,3017500,14797,31206,46003,Brooklyn,21101598.4,Green-Wood Cemetery
19-Aug,36047017500,3017500,9173,48305,57478,Brooklyn,21101598.4,Green-Wood Cemetery
21-Aug,36047017500,3017500,673,27993,28666,Brooklyn,21101598.4,Green-Wood Cemetery
19-May,36047017600,3017600,4907,29343,34250,Brooklyn,1436936.87,Bath Beach
21-May,36047017600,3017600,6346,77436,83782,Brooklyn,1436936.87,Bath Beach
19-Jun,36047017600,3017600,8018,139384,147402,Brooklyn,1436936.87,Bath Beach
21-Jun,36047017600,3017600,5411,66062,71473,Brooklyn,1436936.87,Bath Beach
19-Jul,36047017600,3017600,9264,91761,101025,Brooklyn,1436936.87,Bath Beach
21-Jul,36047017600,3017600,12622,30121,42743,Brooklyn,1436936.87,Bath Beach
19-Aug,36047017600,3017600,4351,67103,71454,Brooklyn,1436936.87,Bath Beach
21-Aug,36047017600,3017600,26799,34877,61676,Brooklyn,1436936.87,Bath Beach
19-May,36047017800,3017800,8152,138779,146931,Brooklyn,1765215.174,Bath Beach
21-May,36047017800,3017800,18917,91275,110192,Brooklyn,1765215.174,Bath Beach
19-Jun,36047017800,3017800,6439,98161,104600,Brooklyn,1765215.174,Bath Beach
21-Jun,36047017800,3017800,18679,71,18750,Brooklyn,1765215.174,Bath Beach
19-Jul,36047017800,3017800,7450,71,7521,Brooklyn,1765215.174,Bath Beach
21-Jul,36047017800,3017800,12935,121448,134383,Brooklyn,1765215.174,Bath Beach
19-Aug,36047017800,3017800,9054,84763,93817,Brooklyn,1765215.174,Bath Beach
21-Aug,36047017800,3017800,15986,41835,57821,Brooklyn,1765215.174,Bath Beach
19-May,36047017900,3017900,0,284,284,Brooklyn,1705006.947,Fort Greene
21-May,36047017900,3017900,11414,6808,18222,Brooklyn,1705006.947,Fort Greene
19-Jun,36047017900,3017900,14501,68176,82677,Brooklyn,1705006.947,Fort Greene
21-Jun,36047017900,3017900,8895,79885,88780,Brooklyn,1705006.947,Fort Greene
19-Jul,36047017900,3017900,12375,88712,101087,Brooklyn,1705006.947,Fort Greene
21-Jul,36047017900,3017900,14361,56599,70960,Brooklyn,1705006.947,Fort Greene
19-Aug,36047017900,3017900,5000,64124,69124,Brooklyn,1705006.947,Fort Greene
21-Aug,36047017900,3017900,8656,71,8727,Brooklyn,1705006.947,Fort Greene
19-May,36047018000,3018000,2825,83417,86242,Brooklyn,1896108.686,Bath Beach
21-May,36047018000,3018000,4735,64350,69085,Brooklyn,1896108.686,Bath Beach
19-Jun,36047018000,3018000,6820,71,6891,Brooklyn,1896108.686,Bath Beach
21-Jun,36047018000,3018000,3944,114162,118106,Brooklyn,1896108.686,Bath Beach
19-Jul,36047018000,3018000,7696,79708,87404,Brooklyn,1896108.686,Bath Beach
21-Jul,36047018000,3018000,6942,38103,45045,Brooklyn,1896108.686,Bath Beach
19-Aug,36047018000,3018000,4754,50855,55609,Brooklyn,1896108.686,Bath Beach
21-Aug,36047018000,3018000,0,175994,175994,Brooklyn,1896108.686,Bath Beach
19-May,36047018100,3018100,9740,80640,90380,Brooklyn,1823380.154,Fort Greene
21-May,36047018100,3018100,17296,17403,34699,Brooklyn,1823380.154,Fort Greene
19-Jun,36047018100,3018100,6528,76277,82805,Brooklyn,1823380.154,Fort Greene
21-Jun,36047018100,3018100,8216,49611,57827,Brooklyn,1823380.154,Fort Greene
19-Jul,36047018100,3018100,6327,142104,148431,Brooklyn,1823380.154,Fort Greene
21-Jul,36047018100,3018100,1341,41648,42989,Brooklyn,1823380.154,Fort Greene
19-Aug,36047018100,3018100,3649,46519,50168,Brooklyn,1823380.154,Fort Greene
21-Aug,36047018100,3018100,10129,71777,81906,Brooklyn,1823380.154,Fort Greene
19-May,36047018200,3018200,0,148891,148891,Brooklyn,1781148.735,Bensonhurst
21-May,36047018200,3018200,9510,71,9581,Brooklyn,1781148.735,Bensonhurst
19-Jun,36047018200,3018200,3625,58740,62365,Brooklyn,1781148.735,Bensonhurst
21-Jun,36047018200,3018200,9360,55888,65248,Brooklyn,1781148.735,Bensonhurst
19-Jul,36047018200,3018200,7154,30211,37365,Brooklyn,1781148.735,Bensonhurst
21-Jul,36047018200,3018200,13949,7942,21891,Brooklyn,1781148.735,Bensonhurst
19-Aug,36047018200,3018200,15505,71,15576,Brooklyn,1781148.735,Bensonhurst
21-Aug,36047018200,3018200,13274,72574,85848,Brooklyn,1781148.735,Bensonhurst
19-May,36047018300,3018300,8029,24668,32697,Brooklyn,1477789.703,Fort Greene
21-May,36047018300,3018300,14234,145953,160187,Brooklyn,1477789.703,Fort Greene
19-Jun,36047018300,3018300,13625,16619,30244,Brooklyn,1477789.703,Fort Greene
21-Jun,36047018300,3018300,8291,90425,98716,Brooklyn,1477789.703,Fort Greene
19-Jul,36047018300,3018300,5497,54775,60272,Brooklyn,1477789.703,Fort Greene
21-Jul,36047018300,3018300,0,55503,55503,Brooklyn,1477789.703,Fort Greene
19-Aug,36047018300,3018300,7618,71,7689,Brooklyn,1477789.703,Fort Greene
21-Aug,36047018300,3018300,14892,59626,74518,Brooklyn,1477789.703,Fort Greene
19-May,36047018400,3018400,5042,94335,99377,Brooklyn,1609239.658,Bensonhurst
21-May,36047018400,3018400,7923,73951,81874,Brooklyn,1609239.658,Bensonhurst
19-Jun,36047018400,3018400,10923,122710,133633,Brooklyn,1609239.658,Bensonhurst
21-Jun,36047018400,3018400,5834,78112,83946,Brooklyn,1609239.658,Bensonhurst
19-Jul,36047018400,3018400,8446,56811,65257,Brooklyn,1609239.658,Bensonhurst
21-Jul,36047018400,3018400,12093,69509,81602,Brooklyn,1609239.658,Bensonhurst
19-Aug,36047018400,3018400,7711,100859,108570,Brooklyn,1609239.658,Bensonhurst
21-Aug,36047018400,3018400,15432,71,15503,Brooklyn,1609239.658,Bensonhurst
19-May,36047018501,3018501,11968,62350,74318,Brooklyn,1189362.197,Fort Greene
21-May,36047018501,3018501,4726,45475,50201,Brooklyn,1189362.197,Fort Greene
19-Jun,36047018501,3018501,14788,38731,53519,Brooklyn,1189362.197,Fort Greene
21-Jun,36047018501,3018501,17683,53667,71350,Brooklyn,1189362.197,Fort Greene
19-Jul,36047018501,3018501,6027,55601,61628,Brooklyn,1189362.197,Fort Greene
21-Jul,36047018501,3018501,13114,3986,17100,Brooklyn,1189362.197,Fort Greene
19-Aug,36047018501,3018501,7504,85854,93358,Brooklyn,1189362.197,Fort Greene
21-Aug,36047018501,3018501,3728,19129,22857,Brooklyn,1189362.197,Fort Greene
19-May,36047018600,3018600,8420,39322,47742,Brooklyn,1216850.48,Bensonhurst
21-May,36047018600,3018600,18278,102724,121002,Brooklyn,1216850.48,Bensonhurst
19-Jun,36047018600,3018600,8810,53094,61904,Brooklyn,1216850.48,Bensonhurst
21-Jun,36047018600,3018600,8287,29597,37884,Brooklyn,1216850.48,Bensonhurst
19-Jul,36047018600,3018600,10090,139977,150067,Brooklyn,1216850.48,Bensonhurst
21-Jul,36047018600,3018600,5618,71,5689,Brooklyn,1216850.48,Bensonhurst
19-Aug,36047018600,3018600,10966,30178,41144,Brooklyn,1216850.48,Bensonhurst
21-Aug,36047018600,3018600,10929,22291,33220,Brooklyn,1216850.48,Bensonhurst
19-May,36047018700,3018700,8961,41993,50954,Brooklyn,917703.1284,Fort Greene
21-May,36047018700,3018700,11116,158057,169173,Brooklyn,917703.1284,Fort Greene
19-Jun,36047018700,3018700,8479,93071,101550,Brooklyn,917703.1284,Fort Greene
21-Jun,36047018700,3018700,16721,96442,113163,Brooklyn,917703.1284,Fort Greene
19-Jul,36047018700,3018700,10147,46891,57038,Brooklyn,917703.1284,Fort Greene
21-Jul,36047018700,3018700,11486,63154,74640,Brooklyn,917703.1284,Fort Greene
19-Aug,36047018700,3018700,8604,14926,23530,Brooklyn,917703.1284,Fort Greene
21-Aug,36047018700,3018700,17934,28891,46825,Brooklyn,917703.1284,Fort Greene
19-May,36047018800,3018800,14062,38387,52449,Brooklyn,1885932.454,Bensonhurst
21-May,36047018800,3018800,4572,45012,49584,Brooklyn,1885932.454,Bensonhurst
19-Jun,36047018800,3018800,0,74513,74513,Brooklyn,1885932.454,Bensonhurst
21-Jun,36047018800,3018800,15405,84168,99573,Brooklyn,1885932.454,Bensonhurst
19-Jul,36047018800,3018800,23370,68786,92156,Brooklyn,1885932.454,Bensonhurst
21-Jul,36047018800,3018800,7010,44345,51355,Brooklyn,1885932.454,Bensonhurst
19-Aug,36047018800,3018800,7911,44836,52747,Brooklyn,1885932.454,Bensonhurst
21-Aug,36047018800,3018800,9574,107581,117155,Brooklyn,1885932.454,Bensonhurst
19-May,36047019000,3019000,2421,136194,138615,Brooklyn,2291793.831,Bensonhurst
21-May,36047019000,3019000,10349,97600,107949,Brooklyn,2291793.831,Bensonhurst
19-Jun,36047019000,3019000,0,167891,167891,Brooklyn,2291793.831,Bensonhurst
21-Jun,36047019000,3019000,236,47228,47464,Brooklyn,2291793.831,Bensonhurst
19-Jul,36047019000,3019000,0,155754,155754,Brooklyn,2291793.831,Bensonhurst
21-Jul,36047019000,3019000,12530,64085,76615,Brooklyn,2291793.831,Bensonhurst
19-Aug,36047019000,3019000,10268,76711,86979,Brooklyn,2291793.831,Bensonhurst
21-Aug,36047019000,3019000,3252,117386,120638,Brooklyn,2291793.831,Bensonhurst
19-May,36047019100,3019100,11108,168239,179347,Brooklyn,2721477.615,Clinton Hill
21-May,36047019100,3019100,17860,143826,161686,Brooklyn,2721477.615,Clinton Hill
19-Jun,36047019100,3019100,7030,92977,100007,Brooklyn,2721477.615,Clinton Hill
21-Jun,36047019100,3019100,12735,135691,148426,Brooklyn,2721477.615,Clinton Hill
19-Jul,36047019100,3019100,6174,46137,52311,Brooklyn,2721477.615,Clinton Hill
21-Jul,36047019100,3019100,2390,53403,55793,Brooklyn,2721477.615,Clinton Hill
19-Aug,36047019100,3019100,9655,49518,59173,Brooklyn,2721477.615,Clinton Hill
21-Aug,36047019100,3019100,0,59219,59219,Brooklyn,2721477.615,Clinton Hill
19-May,36047019200,3019200,7762,52364,60126,Brooklyn,2042874.539,Borough Park
21-May,36047019200,3019200,6227,24716,30943,Brooklyn,2042874.539,Borough Park
19-Jun,36047019200,3019200,10560,73667,84227,Brooklyn,2042874.539,Borough Park
21-Jun,36047019200,3019200,12653,36695,49348,Brooklyn,2042874.539,Borough Park
19-Jul,36047019200,3019200,9205,86026,95231,Brooklyn,2042874.539,Borough Park
21-Jul,36047019200,3019200,12112,94198,106310,Brooklyn,2042874.539,Borough Park
19-Aug,36047019200,3019200,7615,96837,104452,Brooklyn,2042874.539,Borough Park
21-Aug,36047019200,3019200,10941,92029,102970,Brooklyn,2042874.539,Borough Park
19-May,36047019300,3019300,6967,85628,92595,Brooklyn,2903179.025,Clinton Hill
21-May,36047019300,3019300,18219,67768,85987,Brooklyn,2903179.025,Clinton Hill
19-Jun,36047019300,3019300,6402,77028,83430,Brooklyn,2903179.025,Clinton Hill
21-Jun,36047019300,3019300,4145,54640,58785,Brooklyn,2903179.025,Clinton Hill
19-Jul,36047019300,3019300,5274,147422,152696,Brooklyn,2903179.025,Clinton Hill
21-Jul,36047019300,3019300,7619,81580,89199,Brooklyn,2903179.025,Clinton Hill
19-Aug,36047019300,3019300,14336,70896,85232,Brooklyn,2903179.025,Clinton Hill
21-Aug,36047019300,3019300,5441,59118,64559,Brooklyn,2903179.025,Clinton Hill
19-May,36047019400,3019400,8050,29719,37769,Brooklyn,1920211.756,Dyker Heights
21-May,36047019400,3019400,6826,25564,32390,Brooklyn,1920211.756,Dyker Heights
19-Jun,36047019400,3019400,4935,105705,110640,Brooklyn,1920211.756,Dyker Heights
21-Jun,36047019400,3019400,8836,108622,117458,Brooklyn,1920211.756,Dyker Heights
19-Jul,36047019400,3019400,10610,95425,106035,Brooklyn,1920211.756,Dyker Heights
21-Jul,36047019400,3019400,5150,86555,91705,Brooklyn,1920211.756,Dyker Heights
19-Aug,36047019400,3019400,0,106894,106894,Brooklyn,1920211.756,Dyker Heights
21-Aug,36047019400,3019400,17657,125469,143126,Brooklyn,1920211.756,Dyker Heights
19-May,36047019500,3019500,15558,17811,33369,Brooklyn,1475082.672,Clinton Hill
21-May,36047019500,3019500,7249,117259,124508,Brooklyn,1475082.672,Clinton Hill
19-Jun,36047019500,3019500,5341,63000,68341,Brooklyn,1475082.672,Clinton Hill
21-Jun,36047019500,3019500,5779,82419,88198,Brooklyn,1475082.672,Clinton Hill
19-Jul,36047019500,3019500,0,8819,8819,Brooklyn,1475082.672,Clinton Hill
21-Jul,36047019500,3019500,7359,77484,84843,Brooklyn,1475082.672,Clinton Hill
19-Aug,36047019500,3019500,708,18813,19521,Brooklyn,1475082.672,Clinton Hill
21-Aug,36047019500,3019500,14426,98659,113085,Brooklyn,1475082.672,Clinton Hill
19-May,36047019600,3019600,13051,35874,48925,Brooklyn,2027285.951,Dyker Heights
21-May,36047019600,3019600,13865,98417,112282,Brooklyn,2027285.951,Dyker Heights
19-Jun,36047019600,3019600,1866,46029,47895,Brooklyn,2027285.951,Dyker Heights
21-Jun,36047019600,3019600,6198,41675,47873,Brooklyn,2027285.951,Dyker Heights
19-Jul,36047019600,3019600,3161,68472,71633,Brooklyn,2027285.951,Dyker Heights
21-Jul,36047019600,3019600,6766,36381,43147,Brooklyn,2027285.951,Dyker Heights
19-Aug,36047019600,3019600,8727,71,8798,Brooklyn,2027285.951,Dyker Heights
21-Aug,36047019600,3019600,6664,20657,27321,Brooklyn,2027285.951,Dyker Heights
19-May,36047019700,3019700,8380,74020,82400,Brooklyn,1828072.275,Clinton Hill
21-May,36047019700,3019700,9661,58223,67884,Brooklyn,1828072.275,Clinton Hill
19-Jun,36047019700,3019700,6250,93061,99311,Brooklyn,1828072.275,Clinton Hill
21-Jun,36047019700,3019700,5969,62475,68444,Brooklyn,1828072.275,Clinton Hill
19-Jul,36047019700,3019700,5893,176649,182542,Brooklyn,1828072.275,Clinton Hill
21-Jul,36047019700,3019700,1049,126714,127763,Brooklyn,1828072.275,Clinton Hill
19-Aug,36047019700,3019700,17875,121077,138952,Brooklyn,1828072.275,Clinton Hill
21-Aug,36047019700,3019700,8110,88864,96974,Brooklyn,1828072.275,Clinton Hill
19-May,36047019800,3019800,14003,91192,105195,Brooklyn,1450201.565,Dyker Heights
21-May,36047019800,3019800,3824,78311,82135,Brooklyn,1450201.565,Dyker Heights
19-Jun,36047019800,3019800,6523,38111,44634,Brooklyn,1450201.565,Dyker Heights
21-Jun,36047019800,3019800,12914,62233,75147,Brooklyn,1450201.565,Dyker Heights
19-Jul,36047019800,3019800,6572,116524,123096,Brooklyn,1450201.565,Dyker Heights
21-Jul,36047019800,3019800,9742,114293,124035,Brooklyn,1450201.565,Dyker Heights
19-Aug,36047019800,3019800,2108,75386,77494,Brooklyn,1450201.565,Dyker Heights
21-Aug,36047019800,3019800,3016,67444,70460,Brooklyn,1450201.565,Dyker Heights
19-May,36047019900,3019900,5148,43195,48343,Brooklyn,2037876.588,Clinton Hill
21-May,36047019900,3019900,4870,83121,87991,Brooklyn,2037876.588,Clinton Hill
19-Jun,36047019900,3019900,255,46056,46311,Brooklyn,2037876.588,Clinton Hill
21-Jun,36047019900,3019900,10167,71,10238,Brooklyn,2037876.588,Clinton Hill
19-Jul,36047019900,3019900,0,71,71,Brooklyn,2037876.588,Clinton Hill
21-Jul,36047019900,3019900,10421,64267,74688,Brooklyn,2037876.588,Clinton Hill
19-Aug,36047019900,3019900,9176,101435,110611,Brooklyn,2037876.588,Clinton Hill
21-Aug,36047019900,3019900,10773,74413,85186,Brooklyn,2037876.588,Clinton Hill
19-May,36047020000,3020000,7755,17373,25128,Brooklyn,1451580.161,Dyker Heights
21-May,36047020000,3020000,11968,178354,190322,Brooklyn,1451580.161,Dyker Heights
19-Jun,36047020000,3020000,13576,60182,73758,Brooklyn,1451580.161,Dyker Heights
21-Jun,36047020000,3020000,7682,114009,121691,Brooklyn,1451580.161,Dyker Heights
19-Jul,36047020000,3020000,13725,162346,176071,Brooklyn,1451580.161,Dyker Heights
21-Jul,36047020000,3020000,9496,90845,100341,Brooklyn,1451580.161,Dyker Heights
19-Aug,36047020000,3020000,2384,66177,68561,Brooklyn,1451580.161,Dyker Heights
21-Aug,36047020000,3020000,12309,41143,53452,Brooklyn,1451580.161,Dyker Heights
19-May,36047020100,3020100,9754,67572,77326,Brooklyn,1884866.874,Clinton Hill
21-May,36047020100,3020100,6000,27960,33960,Brooklyn,1884866.874,Clinton Hill
19-Jun,36047020100,3020100,7464,133031,140495,Brooklyn,1884866.874,Clinton Hill
21-Jun,36047020100,3020100,0,19104,19104,Brooklyn,1884866.874,Clinton Hill
19-Jul,36047020100,3020100,9197,110939,120136,Brooklyn,1884866.874,Clinton Hill
21-Jul,36047020100,3020100,18892,66288,85180,Brooklyn,1884866.874,Clinton Hill
19-Aug,36047020100,3020100,5374,42841,48215,Brooklyn,1884866.874,Clinton Hill
21-Aug,36047020100,3020100,11814,95511,107325,Brooklyn,1884866.874,Clinton Hill
19-May,36047020200,3020200,4157,19118,23275,Brooklyn,1451352.617,Dyker Heights
21-May,36047020200,3020200,10847,20992,31839,Brooklyn,1451352.617,Dyker Heights
19-Jun,36047020200,3020200,10361,41717,52078,Brooklyn,1451352.617,Dyker Heights
21-Jun,36047020200,3020200,3606,71,3677,Brooklyn,1451352.617,Dyker Heights
19-Jul,36047020200,3020200,2401,67999,70400,Brooklyn,1451352.617,Dyker Heights
21-Jul,36047020200,3020200,14067,71,14138,Brooklyn,1451352.617,Dyker Heights
19-Aug,36047020200,3020200,6926,62332,69258,Brooklyn,1451352.617,Dyker Heights
21-Aug,36047020200,3020200,14778,92862,107640,Brooklyn,1451352.617,Dyker Heights
19-May,36047020300,3020300,10293,24479,34772,Brooklyn,1512111.183,Prospect Heights
21-May,36047020300,3020300,8714,120393,129107,Brooklyn,1512111.183,Prospect Heights
19-Jun,36047020300,3020300,7643,37729,45372,Brooklyn,1512111.183,Prospect Heights
21-Jun,36047020300,3020300,2838,100881,103719,Brooklyn,1512111.183,Prospect Heights
19-Jul,36047020300,3020300,9390,56029,65419,Brooklyn,1512111.183,Prospect Heights
21-Jul,36047020300,3020300,6788,117673,124461,Brooklyn,1512111.183,Prospect Heights
19-Aug,36047020300,3020300,5257,83564,88821,Brooklyn,1512111.183,Prospect Heights
21-Aug,36047020300,3020300,9152,93659,102811,Brooklyn,1512111.183,Prospect Heights
19-May,36047020400,3020400,1855,69018,70873,Brooklyn,1450945.639,Dyker Heights
21-May,36047020400,3020400,4503,72125,76628,Brooklyn,1450945.639,Dyker Heights
19-Jun,36047020400,3020400,12147,100440,112587,Brooklyn,1450945.639,Dyker Heights
21-Jun,36047020400,3020400,7308,40634,47942,Brooklyn,1450945.639,Dyker Heights
19-Jul,36047020400,3020400,4655,61780,66435,Brooklyn,1450945.639,Dyker Heights
21-Jul,36047020400,3020400,13595,71,13666,Brooklyn,1450945.639,Dyker Heights
19-Aug,36047020400,3020400,5939,58519,64458,Brooklyn,1450945.639,Dyker Heights
21-Aug,36047020400,3020400,9466,122503,131969,Brooklyn,1450945.639,Dyker Heights
19-May,36047020500,3020500,7170,51997,59167,Brooklyn,1718969.953,Prospect Heights
21-May,36047020500,3020500,8796,19125,27921,Brooklyn,1718969.953,Prospect Heights
19-Jun,36047020500,3020500,7133,137501,144634,Brooklyn,1718969.953,Prospect Heights
21-Jun,36047020500,3020500,9831,17658,27489,Brooklyn,1718969.953,Prospect Heights
19-Jul,36047020500,3020500,9259,99458,108717,Brooklyn,1718969.953,Prospect Heights
21-Jul,36047020500,3020500,12007,63313,75320,Brooklyn,1718969.953,Prospect Heights
19-Aug,36047020500,3020500,20785,62532,83317,Brooklyn,1718969.953,Prospect Heights
21-Aug,36047020500,3020500,14342,114081,128423,Brooklyn,1718969.953,Prospect Heights
19-May,36047020600,3020600,15292,59262,74554,Brooklyn,1838035.233,Dyker Heights
21-May,36047020600,3020600,12481,139157,151638,Brooklyn,1838035.233,Dyker Heights
19-Jun,36047020600,3020600,4371,106300,110671,Brooklyn,1838035.233,Dyker Heights
21-Jun,36047020600,3020600,7457,62104,69561,Brooklyn,1838035.233,Dyker Heights
19-Jul,36047020600,3020600,11726,119931,131657,Brooklyn,1838035.233,Dyker Heights
21-Jul,36047020600,3020600,14394,120219,134613,Brooklyn,1838035.233,Dyker Heights
19-Aug,36047020600,3020600,7673,71,7744,Brooklyn,1838035.233,Dyker Heights
21-Aug,36047020600,3020600,4017,11812,15829,Brooklyn,1838035.233,Dyker Heights
19-May,36047020700,3020700,18879,40010,58889,Brooklyn,1480427.216,Prospect Heights
21-May,36047020700,3020700,2811,73152,75963,Brooklyn,1480427.216,Prospect Heights
19-Jun,36047020700,3020700,7451,67306,74757,Brooklyn,1480427.216,Prospect Heights
21-Jun,36047020700,3020700,7544,69786,77330,Brooklyn,1480427.216,Prospect Heights
19-Jul,36047020700,3020700,7290,120653,127943,Brooklyn,1480427.216,Prospect Heights
21-Jul,36047020700,3020700,8934,71420,80354,Brooklyn,1480427.216,Prospect Heights
19-Aug,36047020700,3020700,13451,135133,148584,Brooklyn,1480427.216,Prospect Heights
21-Aug,36047020700,3020700,12317,77664,89981,Brooklyn,1480427.216,Prospect Heights
19-May,36047020800,3020800,7437,34730,42167,Brooklyn,1542689.016,Dyker Heights
21-May,36047020800,3020800,16558,79260,95818,Brooklyn,1542689.016,Dyker Heights
19-Jun,36047020800,3020800,8884,60272,69156,Brooklyn,1542689.016,Dyker Heights
21-Jun,36047020800,3020800,13585,71,13656,Brooklyn,1542689.016,Dyker Heights
19-Jul,36047020800,3020800,12999,63078,76077,Brooklyn,1542689.016,Dyker Heights
21-Jul,36047020800,3020800,8471,81711,90182,Brooklyn,1542689.016,Dyker Heights
19-Aug,36047020800,3020800,6928,116661,123589,Brooklyn,1542689.016,Dyker Heights
21-Aug,36047020800,3020800,8328,82966,91294,Brooklyn,1542689.016,Dyker Heights
19-May,36047021000,3021000,9075,99474,108549,Brooklyn,1614539.662,Dyker Heights
21-May,36047021000,3021000,11222,46446,57668,Brooklyn,1614539.662,Dyker Heights
19-Jun,36047021000,3021000,9061,47356,56417,Brooklyn,1614539.662,Dyker Heights
21-Jun,36047021000,3021000,21483,115272,136755,Brooklyn,1614539.662,Dyker Heights
19-Jul,36047021000,3021000,8155,122908,131063,Brooklyn,1614539.662,Dyker Heights
21-Jul,36047021000,3021000,11451,126651,138102,Brooklyn,1614539.662,Dyker Heights
19-Aug,36047021000,3021000,14371,143484,157855,Brooklyn,1614539.662,Dyker Heights
21-Aug,36047021000,3021000,16885,99454,116339,Brooklyn,1614539.662,Dyker Heights
19-May,36047021100,3021100,8115,71571,79686,Brooklyn,2959763.137,Fort Greene
21-May,36047021100,3021100,5296,91515,96811,Brooklyn,2959763.137,Fort Greene
19-Jun,36047021100,3021100,12511,62548,75059,Brooklyn,2959763.137,Fort Greene
21-Jun,36047021100,3021100,0,87562,87562,Brooklyn,2959763.137,Fort Greene
19-Jul,36047021100,3021100,17672,40754,58426,Brooklyn,2959763.137,Fort Greene
21-Jul,36047021100,3021100,14537,39143,53680,Brooklyn,2959763.137,Fort Greene
19-Aug,36047021100,3021100,17054,84847,101901,Brooklyn,2959763.137,Fort Greene
21-Aug,36047021100,3021100,7958,33743,41701,Brooklyn,2959763.137,Fort Greene
19-May,36047021200,3021200,6048,109809,115857,Brooklyn,2054324.605,Dyker Heights
21-May,36047021200,3021200,5288,60397,65685,Brooklyn,2054324.605,Dyker Heights
19-Jun,36047021200,3021200,14691,66667,81358,Brooklyn,2054324.605,Dyker Heights
21-Jun,36047021200,3021200,7507,79664,87171,Brooklyn,2054324.605,Dyker Heights
19-Jul,36047021200,3021200,9038,59991,69029,Brooklyn,2054324.605,Dyker Heights
21-Jul,36047021200,3021200,1990,43321,45311,Brooklyn,2054324.605,Dyker Heights
19-Aug,36047021200,3021200,4436,120640,125076,Brooklyn,2054324.605,Dyker Heights
21-Aug,36047021200,3021200,7827,89270,97097,Brooklyn,2054324.605,Dyker Heights
19-May,36047021300,3021300,4513,90087,94600,Brooklyn,1978483.706,Crown Heights (South)
21-May,36047021300,3021300,4189,52106,56295,Brooklyn,1978483.706,Crown Heights (South)
19-Jun,36047021300,3021300,7712,29747,37459,Brooklyn,1978483.706,Crown Heights (South)
21-Jun,36047021300,3021300,1370,193412,194782,Brooklyn,1978483.706,Crown Heights (South)
19-Jul,36047021300,3021300,9404,50224,59628,Brooklyn,1978483.706,Crown Heights (South)
21-Jul,36047021300,3021300,7614,70430,78044,Brooklyn,1978483.706,Crown Heights (South)
19-Aug,36047021300,3021300,14218,84240,98458,Brooklyn,1978483.706,Crown Heights (South)
21-Aug,36047021300,3021300,15759,114275,130034,Brooklyn,1978483.706,Crown Heights (South)
19-May,36047021400,3021400,0,70783,70783,Brooklyn,1808036.303,Borough Park
21-May,36047021400,3021400,9185,121661,130846,Brooklyn,1808036.303,Borough Park
19-Jun,36047021400,3021400,5723,97810,103533,Brooklyn,1808036.303,Borough Park
21-Jun,36047021400,3021400,7316,84954,92270,Brooklyn,1808036.303,Borough Park
19-Jul,36047021400,3021400,5477,82937,88414,Brooklyn,1808036.303,Borough Park
21-Jul,36047021400,3021400,14918,33651,48569,Brooklyn,1808036.303,Borough Park
19-Aug,36047021400,3021400,7858,131894,139752,Brooklyn,1808036.303,Borough Park
21-Aug,36047021400,3021400,8344,86902,95246,Brooklyn,1808036.303,Borough Park
19-May,36047021500,3021500,168,87149,87317,Brooklyn,1657679.579,Prospect Heights
21-May,36047021500,3021500,11644,80998,92642,Brooklyn,1657679.579,Prospect Heights
19-Jun,36047021500,3021500,8457,56395,64852,Brooklyn,1657679.579,Prospect Heights
21-Jun,36047021500,3021500,17801,175890,193691,Brooklyn,1657679.579,Prospect Heights
19-Jul,36047021500,3021500,8568,74959,83527,Brooklyn,1657679.579,Prospect Heights
21-Jul,36047021500,3021500,2690,28110,30800,Brooklyn,1657679.579,Prospect Heights
19-Aug,36047021500,3021500,10605,134545,145150,Brooklyn,1657679.579,Prospect Heights
21-Aug,36047021500,3021500,15050,82706,97756,Brooklyn,1657679.579,Prospect Heights
19-May,36047021600,3021600,3425,59349,62774,Brooklyn,1810243.96,Borough Park
21-May,36047021600,3021600,0,91275,91275,Brooklyn,1810243.96,Borough Park
19-Jun,36047021600,3021600,11579,129487,141066,Brooklyn,1810243.96,Borough Park
21-Jun,36047021600,3021600,8194,1442,9636,Brooklyn,1810243.96,Borough Park
19-Jul,36047021600,3021600,17684,113779,131463,Brooklyn,1810243.96,Borough Park
21-Jul,36047021600,3021600,11109,33492,44601,Brooklyn,1810243.96,Borough Park
19-Aug,36047021600,3021600,15500,65354,80854,Brooklyn,1810243.96,Borough Park
21-Aug,36047021600,3021600,13152,45591,58743,Brooklyn,1810243.96,Borough Park
19-May,36047021700,3021700,13422,102062,115484,Brooklyn,1285839.31,Crown Heights (North)
21-May,36047021700,3021700,12801,104265,117066,Brooklyn,1285839.31,Crown Heights (North)
19-Jun,36047021700,3021700,11496,40514,52010,Brooklyn,1285839.31,Crown Heights (North)
21-Jun,36047021700,3021700,0,170830,170830,Brooklyn,1285839.31,Crown Heights (North)
19-Jul,36047021700,3021700,8447,81939,90386,Brooklyn,1285839.31,Crown Heights (North)
21-Jul,36047021700,3021700,12943,132575,145518,Brooklyn,1285839.31,Crown Heights (North)
19-Aug,36047021700,3021700,2900,69605,72505,Brooklyn,1285839.31,Crown Heights (North)
21-Aug,36047021700,3021700,9050,56931,65981,Brooklyn,1285839.31,Crown Heights (North)
19-May,36047021800,3021800,12094,56087,68181,Brooklyn,1698857.118,Borough Park
21-May,36047021800,3021800,11017,97477,108494,Brooklyn,1698857.118,Borough Park
19-Jun,36047021800,3021800,10162,39090,49252,Brooklyn,1698857.118,Borough Park
21-Jun,36047021800,3021800,10336,53525,63861,Brooklyn,1698857.118,Borough Park
19-Jul,36047021800,3021800,6310,80350,86660,Brooklyn,1698857.118,Borough Park
21-Jul,36047021800,3021800,4029,73922,77951,Brooklyn,1698857.118,Borough Park
19-Aug,36047021800,3021800,8448,124075,132523,Brooklyn,1698857.118,Borough Park
21-Aug,36047021800,3021800,8634,93795,102429,Brooklyn,1698857.118,Borough Park
19-May,36047021900,3021900,7273,125160,132433,Brooklyn,1582742.178,Crown Heights (North)
21-May,36047021900,3021900,14606,101569,116175,Brooklyn,1582742.178,Crown Heights (North)
19-Jun,36047021900,3021900,0,54934,54934,Brooklyn,1582742.178,Crown Heights (North)
21-Jun,36047021900,3021900,14006,79745,93751,Brooklyn,1582742.178,Crown Heights (North)
19-Jul,36047021900,3021900,4249,19663,23912,Brooklyn,1582742.178,Crown Heights (North)
21-Jul,36047021900,3021900,4407,34651,39058,Brooklyn,1582742.178,Crown Heights (North)
19-Aug,36047021900,3021900,2907,19906,22813,Brooklyn,1582742.178,Crown Heights (North)
21-Aug,36047021900,3021900,5206,51682,56888,Brooklyn,1582742.178,Crown Heights (North)
19-May,36047022000,3022000,7490,71,7561,Brooklyn,2091173.051,Borough Park
21-May,36047022000,3022000,5039,31721,36760,Brooklyn,2091173.051,Borough Park
19-Jun,36047022000,3022000,9483,49194,58677,Brooklyn,2091173.051,Borough Park
21-Jun,36047022000,3022000,15223,52263,67486,Brooklyn,2091173.051,Borough Park
19-Jul,36047022000,3022000,15193,32089,47282,Brooklyn,2091173.051,Borough Park
21-Jul,36047022000,3022000,5563,51958,57521,Brooklyn,2091173.051,Borough Park
19-Aug,36047022000,3022000,12649,83600,96249,Brooklyn,2091173.051,Borough Park
21-Aug,36047022000,3022000,5902,96006,101908,Brooklyn,2091173.051,Borough Park
19-May,36047022100,3022100,14740,89370,104110,Brooklyn,1635894.765,Crown Heights (North)
21-May,36047022100,3022100,8406,11089,19495,Brooklyn,1635894.765,Crown Heights (North)
19-Jun,36047022100,3022100,10808,107280,118088,Brooklyn,1635894.765,Crown Heights (North)
21-Jun,36047022100,3022100,8403,71907,80310,Brooklyn,1635894.765,Crown Heights (North)
19-Jul,36047022100,3022100,5126,98988,104114,Brooklyn,1635894.765,Crown Heights (North)
21-Jul,36047022100,3022100,13981,145069,159050,Brooklyn,1635894.765,Crown Heights (North)
19-Aug,36047022100,3022100,3522,71,3593,Brooklyn,1635894.765,Crown Heights (North)
21-Aug,36047022100,3022100,8782,8857,17639,Brooklyn,1635894.765,Crown Heights (North)
19-May,36047022200,3022200,6327,42118,48445,Brooklyn,1896474.105,Borough Park
21-May,36047022200,3022200,4,80938,80942,Brooklyn,1896474.105,Borough Park
19-Jun,36047022200,3022200,2164,41404,43568,Brooklyn,1896474.105,Borough Park
21-Jun,36047022200,3022200,8577,108482,117059,Brooklyn,1896474.105,Borough Park
19-Jul,36047022200,3022200,14065,71218,85283,Brooklyn,1896474.105,Borough Park
21-Jul,36047022200,3022200,9918,27770,37688,Brooklyn,1896474.105,Borough Park
19-Aug,36047022200,3022200,11381,13700,25081,Brooklyn,1896474.105,Borough Park
21-Aug,36047022200,3022200,10687,77771,88458,Brooklyn,1896474.105,Borough Park
19-May,36047022400,3022400,5874,60797,66671,Brooklyn,1890190.809,Borough Park
21-May,36047022400,3022400,9767,57936,67703,Brooklyn,1890190.809,Borough Park
19-Jun,36047022400,3022400,9459,132465,141924,Brooklyn,1890190.809,Borough Park
21-Jun,36047022400,3022400,8280,67406,75686,Brooklyn,1890190.809,Borough Park
19-Jul,36047022400,3022400,4806,136344,141150,Brooklyn,1890190.809,Borough Park
21-Jul,36047022400,3022400,4339,18546,22885,Brooklyn,1890190.809,Borough Park
19-Aug,36047022400,3022400,4040,75120,79160,Brooklyn,1890190.809,Borough Park
21-Aug,36047022400,3022400,5540,20191,25731,Brooklyn,1890190.809,Borough Park
19-May,36047022600,3022600,9519,74526,84045,Brooklyn,1680920.332,Borough Park
21-May,36047022600,3022600,11480,51156,62636,Brooklyn,1680920.332,Borough Park
19-Jun,36047022600,3022600,12928,71,12999,Brooklyn,1680920.332,Borough Park
21-Jun,36047022600,3022600,3666,78541,82207,Brooklyn,1680920.332,Borough Park
19-Jul,36047022600,3022600,4535,105700,110235,Brooklyn,1680920.332,Borough Park
21-Jul,36047022600,3022600,15402,27969,43371,Brooklyn,1680920.332,Borough Park
19-Aug,36047022600,3022600,9722,38556,48278,Brooklyn,1680920.332,Borough Park
21-Aug,36047022600,3022600,11386,68410,79796,Brooklyn,1680920.332,Borough Park
19-May,36047022700,3022700,7815,101036,108851,Brooklyn,2588318.213,Bedford-Stuyvesant (West)
21-May,36047022700,3022700,1158,44745,45903,Brooklyn,2588318.213,Bedford-Stuyvesant (West)
19-Jun,36047022700,3022700,4362,87361,91723,Brooklyn,2588318.213,Bedford-Stuyvesant (West)
21-Jun,36047022700,3022700,6106,73237,79343,Brooklyn,2588318.213,Bedford-Stuyvesant (West)
19-Jul,36047022700,3022700,10899,39243,50142,Brooklyn,2588318.213,Bedford-Stuyvesant (West)
21-Jul,36047022700,3022700,0,54515,54515,Brooklyn,2588318.213,Bedford-Stuyvesant (West)
19-Aug,36047022700,3022700,0,71,71,Brooklyn,2588318.213,Bedford-Stuyvesant (West)
21-Aug,36047022700,3022700,8843,17946,26789,Brooklyn,2588318.213,Bedford-Stuyvesant (West)
19-May,36047022800,3022800,9872,44867,54739,Brooklyn,1801521.34,Borough Park
21-May,36047022800,3022800,12540,30161,42701,Brooklyn,1801521.34,Borough Park
19-Jun,36047022800,3022800,6288,71274,77562,Brooklyn,1801521.34,Borough Park
21-Jun,36047022800,3022800,5654,84208,89862,Brooklyn,1801521.34,Borough Park
19-Jul,36047022800,3022800,11929,55152,67081,Brooklyn,1801521.34,Borough Park
21-Jul,36047022800,3022800,6221,137772,143993,Brooklyn,1801521.34,Borough Park
19-Aug,36047022800,3022800,12459,51033,63492,Brooklyn,1801521.34,Borough Park
21-Aug,36047022800,3022800,11589,135526,147115,Brooklyn,1801521.34,Borough Park
19-May,36047022900,3022900,15097,49850,64947,Brooklyn,1849568.348,Bedford-Stuyvesant (West)
21-May,36047022900,3022900,9006,67594,76600,Brooklyn,1849568.348,Bedford-Stuyvesant (West)
19-Jun,36047022900,3022900,11968,148586,160554,Brooklyn,1849568.348,Bedford-Stuyvesant (West)
21-Jun,36047022900,3022900,9229,97617,106846,Brooklyn,1849568.348,Bedford-Stuyvesant (West)
19-Jul,36047022900,3022900,8012,34368,42380,Brooklyn,1849568.348,Bedford-Stuyvesant (West)
21-Jul,36047022900,3022900,0,94684,94684,Brooklyn,1849568.348,Bedford-Stuyvesant (West)
19-Aug,36047022900,3022900,11204,20908,32112,Brooklyn,1849568.348,Bedford-Stuyvesant (West)
21-Aug,36047022900,3022900,12780,89498,102278,Brooklyn,1849568.348,Bedford-Stuyvesant (West)
19-May,36047023000,3023000,5046,151492,156538,Brooklyn,1624924.608,Borough Park
21-May,36047023000,3023000,12521,131912,144433,Brooklyn,1624924.608,Borough Park
19-Jun,36047023000,3023000,6724,110784,117508,Brooklyn,1624924.608,Borough Park
21-Jun,36047023000,3023000,3021,73456,76477,Brooklyn,1624924.608,Borough Park
19-Jul,36047023000,3023000,11308,36697,48005,Brooklyn,1624924.608,Borough Park
21-Jul,36047023000,3023000,12626,90247,102873,Brooklyn,1624924.608,Borough Park
19-Aug,36047023000,3023000,12569,63716,76285,Brooklyn,1624924.608,Borough Park
21-Aug,36047023000,3023000,12624,21853,34477,Brooklyn,1624924.608,Borough Park
19-May,36047023100,3023100,6942,84276,91218,Brooklyn,1716029.922,Clinton Hill
21-May,36047023100,3023100,4444,108127,112571,Brooklyn,1716029.922,Clinton Hill
19-Jun,36047023100,3023100,6539,90457,96996,Brooklyn,1716029.922,Clinton Hill
21-Jun,36047023100,3023100,3403,100501,103904,Brooklyn,1716029.922,Clinton Hill
19-Jul,36047023100,3023100,9543,55250,64793,Brooklyn,1716029.922,Clinton Hill
21-Jul,36047023100,3023100,8518,72781,81299,Brooklyn,1716029.922,Clinton Hill
19-Aug,36047023100,3023100,13125,60091,73216,Brooklyn,1716029.922,Clinton Hill
21-Aug,36047023100,3023100,8197,64648,72845,Brooklyn,1716029.922,Clinton Hill
19-May,36047023200,3023200,6992,64836,71828,Brooklyn,2436821.275,Borough Park
21-May,36047023200,3023200,7522,101303,108825,Brooklyn,2436821.275,Borough Park
19-Jun,36047023200,3023200,15085,2782,17867,Brooklyn,2436821.275,Borough Park
21-Jun,36047023200,3023200,10100,100441,110541,Brooklyn,2436821.275,Borough Park
19-Jul,36047023200,3023200,1579,37179,38758,Brooklyn,2436821.275,Borough Park
21-Jul,36047023200,3023200,6528,85427,91955,Brooklyn,2436821.275,Borough Park
19-Aug,36047023200,3023200,20560,50408,70968,Brooklyn,2436821.275,Borough Park
21-Aug,36047023200,3023200,3986,81768,85754,Brooklyn,2436821.275,Borough Park
19-May,36047023300,3023300,0,41780,41780,Brooklyn,1849442.005,Bedford-Stuyvesant (West)
21-May,36047023300,3023300,5962,56071,62033,Brooklyn,1849442.005,Bedford-Stuyvesant (West)
19-Jun,36047023300,3023300,7498,8082,15580,Brooklyn,1849442.005,Bedford-Stuyvesant (West)
21-Jun,36047023300,3023300,5499,114024,119523,Brooklyn,1849442.005,Bedford-Stuyvesant (West)
19-Jul,36047023300,3023300,4902,78295,83197,Brooklyn,1849442.005,Bedford-Stuyvesant (West)
21-Jul,36047023300,3023300,1116,34910,36026,Brooklyn,1849442.005,Bedford-Stuyvesant (West)
19-Aug,36047023300,3023300,13016,39759,52775,Brooklyn,1849442.005,Bedford-Stuyvesant (West)
21-Aug,36047023300,3023300,11855,102692,114547,Brooklyn,1849442.005,Bedford-Stuyvesant (West)
19-May,36047023400,3023400,0,41905,41905,Brooklyn,1827230.614,Borough Park
21-May,36047023400,3023400,939,104966,105905,Brooklyn,1827230.614,Borough Park
19-Jun,36047023400,3023400,4854,66268,71122,Brooklyn,1827230.614,Borough Park
21-Jun,36047023400,3023400,13058,31992,45050,Brooklyn,1827230.614,Borough Park
19-Jul,36047023400,3023400,10451,76878,87329,Brooklyn,1827230.614,Borough Park
21-Jul,36047023400,3023400,10901,63638,74539,Brooklyn,1827230.614,Borough Park
19-Aug,36047023400,3023400,8471,125222,133693,Brooklyn,1827230.614,Borough Park
21-Aug,36047023400,3023400,7030,126454,133484,Brooklyn,1827230.614,Borough Park
19-May,36047023500,3023500,4827,61231,66058,Brooklyn,1523725.918,Bedford-Stuyvesant (West)
21-May,36047023500,3023500,6374,87689,94063,Brooklyn,1523725.918,Bedford-Stuyvesant (West)
19-Jun,36047023500,3023500,12667,61448,74115,Brooklyn,1523725.918,Bedford-Stuyvesant (West)
21-Jun,36047023500,3023500,10626,62528,73154,Brooklyn,1523725.918,Bedford-Stuyvesant (West)
19-Jul,36047023500,3023500,1421,68841,70262,Brooklyn,1523725.918,Bedford-Stuyvesant (West)
21-Jul,36047023500,3023500,15110,62843,77953,Brooklyn,1523725.918,Bedford-Stuyvesant (West)
19-Aug,36047023500,3023500,3620,61020,64640,Brooklyn,1523725.918,Bedford-Stuyvesant (West)
21-Aug,36047023500,3023500,2021,35713,37734,Brooklyn,1523725.918,Bedford-Stuyvesant (West)
19-May,36047023600,3023600,7639,60596,68235,Brooklyn,1828207.747,Borough Park
21-May,36047023600,3023600,6727,39869,46596,Brooklyn,1828207.747,Borough Park
19-Jun,36047023600,3023600,10129,36161,46290,Brooklyn,1828207.747,Borough Park
21-Jun,36047023600,3023600,10576,53550,64126,Brooklyn,1828207.747,Borough Park
19-Jul,36047023600,3023600,9825,50388,60213,Brooklyn,1828207.747,Borough Park
21-Jul,36047023600,3023600,16864,116925,133789,Brooklyn,1828207.747,Borough Park
19-Aug,36047023600,3023600,8430,89529,97959,Brooklyn,1828207.747,Borough Park
21-Aug,36047023600,3023600,233,87602,87835,Brooklyn,1828207.747,Borough Park
19-May,36047023800,3023800,6853,75861,82714,Brooklyn,1828765.841,Borough Park
21-May,36047023800,3023800,6214,63485,69699,Brooklyn,1828765.841,Borough Park
19-Jun,36047023800,3023800,4577,61514,66091,Brooklyn,1828765.841,Borough Park
21-Jun,36047023800,3023800,6020,72527,78547,Brooklyn,1828765.841,Borough Park
19-Jul,36047023800,3023800,7966,36745,44711,Brooklyn,1828765.841,Borough Park
21-Jul,36047023800,3023800,14721,125054,139775,Brooklyn,1828765.841,Borough Park
19-Aug,36047023800,3023800,9978,109361,119339,Brooklyn,1828765.841,Borough Park
21-Aug,36047023800,3023800,9466,97253,106719,Brooklyn,1828765.841,Borough Park
19-May,36047024000,3024000,3697,37113,40810,Brooklyn,1827206.318,Borough Park
21-May,36047024000,3024000,12976,51133,64109,Brooklyn,1827206.318,Borough Park
19-Jun,36047024000,3024000,11979,36858,48837,Brooklyn,1827206.318,Borough Park
21-Jun,36047024000,3024000,12302,111323,123625,Brooklyn,1827206.318,Borough Park
19-Jul,36047024000,3024000,7659,144358,152017,Brooklyn,1827206.318,Borough Park
21-Jul,36047024000,3024000,5819,65203,71022,Brooklyn,1827206.318,Borough Park
19-Aug,36047024000,3024000,9658,136755,146413,Brooklyn,1827206.318,Borough Park
21-Aug,36047024000,3024000,11095,12539,23634,Brooklyn,1827206.318,Borough Park
19-May,36047024100,3024100,11166,100566,111732,Brooklyn,1939949.757,Bedford-Stuyvesant (West)
21-May,36047024100,3024100,11831,52234,64065,Brooklyn,1939949.757,Bedford-Stuyvesant (West)
19-Jun,36047024100,3024100,92,90566,90658,Brooklyn,1939949.757,Bedford-Stuyvesant (West)
21-Jun,36047024100,3024100,12808,64332,77140,Brooklyn,1939949.757,Bedford-Stuyvesant (West)
19-Jul,36047024100,3024100,7958,48886,56844,Brooklyn,1939949.757,Bedford-Stuyvesant (West)
21-Jul,36047024100,3024100,7621,46176,53797,Brooklyn,1939949.757,Bedford-Stuyvesant (West)
19-Aug,36047024100,3024100,13059,66477,79536,Brooklyn,1939949.757,Bedford-Stuyvesant (West)
21-Aug,36047024100,3024100,12345,26525,38870,Brooklyn,1939949.757,Bedford-Stuyvesant (West)
19-May,36047024200,3024200,3306,88170,91476,Brooklyn,2061125.143,Borough Park
21-May,36047024200,3024200,11588,100118,111706,Brooklyn,2061125.143,Borough Park
19-Jun,36047024200,3024200,5235,50886,56121,Brooklyn,2061125.143,Borough Park
21-Jun,36047024200,3024200,9451,112927,122378,Brooklyn,2061125.143,Borough Park
19-Jul,36047024200,3024200,27692,96103,123795,Brooklyn,2061125.143,Borough Park
21-Jul,36047024200,3024200,3464,71455,74919,Brooklyn,2061125.143,Borough Park
19-Aug,36047024200,3024200,12102,85887,97989,Brooklyn,2061125.143,Borough Park
21-Aug,36047024200,3024200,13745,71,13816,Brooklyn,2061125.143,Borough Park
19-May,36047024300,3024300,6159,66426,72585,Brooklyn,1661539.498,Bedford-Stuyvesant (West)
21-May,36047024300,3024300,8158,57733,65891,Brooklyn,1661539.498,Bedford-Stuyvesant (West)
19-Jun,36047024300,3024300,7744,48137,55881,Brooklyn,1661539.498,Bedford-Stuyvesant (West)
21-Jun,36047024300,3024300,12230,64177,76407,Brooklyn,1661539.498,Bedford-Stuyvesant (West)
19-Jul,36047024300,3024300,11043,56933,67976,Brooklyn,1661539.498,Bedford-Stuyvesant (West)
21-Jul,36047024300,3024300,5354,70727,76081,Brooklyn,1661539.498,Bedford-Stuyvesant (West)
19-Aug,36047024300,3024300,9409,95613,105022,Brooklyn,1661539.498,Bedford-Stuyvesant (West)
21-Aug,36047024300,3024300,4046,36646,40692,Brooklyn,1661539.498,Bedford-Stuyvesant (West)
19-May,36047024400,3024400,4673,73714,78387,Brooklyn,1670948.437,Mapleton-Midwood (West)
21-May,36047024400,3024400,6884,123470,130354,Brooklyn,1670948.437,Mapleton-Midwood (West)
19-Jun,36047024400,3024400,15427,85610,101037,Brooklyn,1670948.437,Mapleton-Midwood (West)
21-Jun,36047024400,3024400,14767,137700,152467,Brooklyn,1670948.437,Mapleton-Midwood (West)
19-Jul,36047024400,3024400,6671,1691,8362,Brooklyn,1670948.437,Mapleton-Midwood (West)
21-Jul,36047024400,3024400,7629,58405,66034,Brooklyn,1670948.437,Mapleton-Midwood (West)
19-Aug,36047024400,3024400,11454,79857,91311,Brooklyn,1670948.437,Mapleton-Midwood (West)
21-Aug,36047024400,3024400,3682,65278,68960,Brooklyn,1670948.437,Mapleton-Midwood (West)
19-May,36047024500,3024500,8581,83774,92355,Brooklyn,1795931.741,Bedford-Stuyvesant (West)
21-May,36047024500,3024500,9179,88548,97727,Brooklyn,1795931.741,Bedford-Stuyvesant (West)
19-Jun,36047024500,3024500,9973,65854,75827,Brooklyn,1795931.741,Bedford-Stuyvesant (West)
21-Jun,36047024500,3024500,8995,51023,60018,Brooklyn,1795931.741,Bedford-Stuyvesant (West)
19-Jul,36047024500,3024500,11777,45088,56865,Brooklyn,1795931.741,Bedford-Stuyvesant (West)
21-Jul,36047024500,3024500,8625,71,8696,Brooklyn,1795931.741,Bedford-Stuyvesant (West)
19-Aug,36047024500,3024500,13461,71,13532,Brooklyn,1795931.741,Bedford-Stuyvesant (West)
21-Aug,36047024500,3024500,7169,26777,33946,Brooklyn,1795931.741,Bedford-Stuyvesant (West)
19-May,36047024600,3024600,7671,81436,89107,Brooklyn,1845582.725,Mapleton-Midwood (West)
21-May,36047024600,3024600,11825,26799,38624,Brooklyn,1845582.725,Mapleton-Midwood (West)
19-Jun,36047024600,3024600,22892,152425,175317,Brooklyn,1845582.725,Mapleton-Midwood (West)
21-Jun,36047024600,3024600,3801,79748,83549,Brooklyn,1845582.725,Mapleton-Midwood (West)
19-Jul,36047024600,3024600,14283,84508,98791,Brooklyn,1845582.725,Mapleton-Midwood (West)
21-Jul,36047024600,3024600,8480,80931,89411,Brooklyn,1845582.725,Mapleton-Midwood (West)
19-Aug,36047024600,3024600,9069,130131,139200,Brooklyn,1845582.725,Mapleton-Midwood (West)
21-Aug,36047024600,3024600,8056,26927,34983,Brooklyn,1845582.725,Mapleton-Midwood (West)
19-May,36047024700,3024700,0,46279,46279,Brooklyn,1934649.874,Bedford-Stuyvesant (West)
21-May,36047024700,3024700,18133,80157,98290,Brooklyn,1934649.874,Bedford-Stuyvesant (West)
19-Jun,36047024700,3024700,0,56179,56179,Brooklyn,1934649.874,Bedford-Stuyvesant (West)
21-Jun,36047024700,3024700,8715,105875,114590,Brooklyn,1934649.874,Bedford-Stuyvesant (West)
19-Jul,36047024700,3024700,6247,149768,156015,Brooklyn,1934649.874,Bedford-Stuyvesant (West)
21-Jul,36047024700,3024700,12714,93092,105806,Brooklyn,1934649.874,Bedford-Stuyvesant (West)
19-Aug,36047024700,3024700,11019,102345,113364,Brooklyn,1934649.874,Bedford-Stuyvesant (West)
21-Aug,36047024700,3024700,8527,94050,102577,Brooklyn,1934649.874,Bedford-Stuyvesant (West)
19-May,36047024800,3024800,7921,36664,44585,Brooklyn,1895137.29,Bensonhurst
21-May,36047024800,3024800,10241,97369,107610,Brooklyn,1895137.29,Bensonhurst
19-Jun,36047024800,3024800,11325,35148,46473,Brooklyn,1895137.29,Bensonhurst
21-Jun,36047024800,3024800,1895,79309,81204,Brooklyn,1895137.29,Bensonhurst
19-Jul,36047024800,3024800,2751,40653,43404,Brooklyn,1895137.29,Bensonhurst
21-Jul,36047024800,3024800,9745,65915,75660,Brooklyn,1895137.29,Bensonhurst
19-Aug,36047024800,3024800,13480,76195,89675,Brooklyn,1895137.29,Bensonhurst
21-Aug,36047024800,3024800,7454,71424,78878,Brooklyn,1895137.29,Bensonhurst
19-May,36047024900,3024900,7615,120657,128272,Brooklyn,1813352.575,Bedford-Stuyvesant (West)
21-May,36047024900,3024900,4868,54400,59268,Brooklyn,1813352.575,Bedford-Stuyvesant (West)
19-Jun,36047024900,3024900,19197,115834,135031,Brooklyn,1813352.575,Bedford-Stuyvesant (West)
21-Jun,36047024900,3024900,5695,52642,58337,Brooklyn,1813352.575,Bedford-Stuyvesant (West)
19-Jul,36047024900,3024900,3432,44285,47717,Brooklyn,1813352.575,Bedford-Stuyvesant (West)
21-Jul,36047024900,3024900,13575,71,13646,Brooklyn,1813352.575,Bedford-Stuyvesant (West)
19-Aug,36047024900,3024900,6561,91097,97658,Brooklyn,1813352.575,Bedford-Stuyvesant (West)
21-Aug,36047024900,3024900,12554,68971,81525,Brooklyn,1813352.575,Bedford-Stuyvesant (West)
19-May,36047025000,3025000,9624,50621,60245,Brooklyn,1867361.685,Bensonhurst
21-May,36047025000,3025000,17660,161054,178714,Brooklyn,1867361.685,Bensonhurst
19-Jun,36047025000,3025000,7266,102168,109434,Brooklyn,1867361.685,Bensonhurst
21-Jun,36047025000,3025000,8701,55993,64694,Brooklyn,1867361.685,Bensonhurst
19-Jul,36047025000,3025000,0,121034,121034,Brooklyn,1867361.685,Bensonhurst
21-Jul,36047025000,3025000,12350,89437,101787,Brooklyn,1867361.685,Bensonhurst
19-Aug,36047025000,3025000,1428,16723,18151,Brooklyn,1867361.685,Bensonhurst
21-Aug,36047025000,3025000,0,68974,68974,Brooklyn,1867361.685,Bensonhurst
19-May,36047025100,3025100,7961,15275,23236,Brooklyn,1490422.896,Bedford-Stuyvesant (West)
21-May,36047025100,3025100,6039,18691,24730,Brooklyn,1490422.896,Bedford-Stuyvesant (West)
19-Jun,36047025100,3025100,6946,74954,81900,Brooklyn,1490422.896,Bedford-Stuyvesant (West)
21-Jun,36047025100,3025100,9949,66869,76818,Brooklyn,1490422.896,Bedford-Stuyvesant (West)
19-Jul,36047025100,3025100,19112,105243,124355,Brooklyn,1490422.896,Bedford-Stuyvesant (West)
21-Jul,36047025100,3025100,4982,64898,69880,Brooklyn,1490422.896,Bedford-Stuyvesant (West)
19-Aug,36047025100,3025100,11961,65515,77476,Brooklyn,1490422.896,Bedford-Stuyvesant (West)
21-Aug,36047025100,3025100,339,122006,122345,Brooklyn,1490422.896,Bedford-Stuyvesant (West)
19-May,36047025200,3025200,13088,61305,74393,Brooklyn,1950979.162,Bensonhurst
21-May,36047025200,3025200,13808,67968,81776,Brooklyn,1950979.162,Bensonhurst
19-Jun,36047025200,3025200,4592,81953,86545,Brooklyn,1950979.162,Bensonhurst
21-Jun,36047025200,3025200,9163,106641,115804,Brooklyn,1950979.162,Bensonhurst
19-Jul,36047025200,3025200,9162,43264,52426,Brooklyn,1950979.162,Bensonhurst
21-Jul,36047025200,3025200,4492,89052,93544,Brooklyn,1950979.162,Bensonhurst
19-Aug,36047025200,3025200,5697,81729,87426,Brooklyn,1950979.162,Bensonhurst
21-Aug,36047025200,3025200,941,79911,80852,Brooklyn,1950979.162,Bensonhurst
19-May,36047025300,3025300,1821,99426,101247,Brooklyn,1741979.536,Bedford-Stuyvesant (West)
21-May,36047025300,3025300,6595,123080,129675,Brooklyn,1741979.536,Bedford-Stuyvesant (West)
19-Jun,36047025300,3025300,10372,98595,108967,Brooklyn,1741979.536,Bedford-Stuyvesant (West)
21-Jun,36047025300,3025300,7700,21224,28924,Brooklyn,1741979.536,Bedford-Stuyvesant (West)
19-Jul,36047025300,3025300,10182,66283,76465,Brooklyn,1741979.536,Bedford-Stuyvesant (West)
21-Jul,36047025300,3025300,1245,75451,76696,Brooklyn,1741979.536,Bedford-Stuyvesant (West)
19-Aug,36047025300,3025300,11366,9563,20929,Brooklyn,1741979.536,Bedford-Stuyvesant (West)
21-Aug,36047025300,3025300,11634,15640,27274,Brooklyn,1741979.536,Bedford-Stuyvesant (West)
19-May,36047025400,3025400,18842,63410,82252,Brooklyn,1888611.695,Bensonhurst
21-May,36047025400,3025400,5475,88236,93711,Brooklyn,1888611.695,Bensonhurst
19-Jun,36047025400,3025400,13806,50693,64499,Brooklyn,1888611.695,Bensonhurst
21-Jun,36047025400,3025400,12314,64405,76719,Brooklyn,1888611.695,Bensonhurst
19-Jul,36047025400,3025400,0,50689,50689,Brooklyn,1888611.695,Bensonhurst
21-Jul,36047025400,3025400,8046,28573,36619,Brooklyn,1888611.695,Bensonhurst
19-Aug,36047025400,3025400,6111,46567,52678,Brooklyn,1888611.695,Bensonhurst
21-Aug,36047025400,3025400,1433,85089,86522,Brooklyn,1888611.695,Bensonhurst
19-May,36047025500,3025500,14305,52980,67285,Brooklyn,1492220.441,Bedford-Stuyvesant (West)
21-May,36047025500,3025500,9641,140196,149837,Brooklyn,1492220.441,Bedford-Stuyvesant (West)
19-Jun,36047025500,3025500,12811,1949,14760,Brooklyn,1492220.441,Bedford-Stuyvesant (West)
21-Jun,36047025500,3025500,7058,63573,70631,Brooklyn,1492220.441,Bedford-Stuyvesant (West)
19-Jul,36047025500,3025500,4073,81767,85840,Brooklyn,1492220.441,Bedford-Stuyvesant (West)
21-Jul,36047025500,3025500,8175,112426,120601,Brooklyn,1492220.441,Bedford-Stuyvesant (West)
19-Aug,36047025500,3025500,6576,58988,65564,Brooklyn,1492220.441,Bedford-Stuyvesant (West)
21-Aug,36047025500,3025500,15973,88186,104159,Brooklyn,1492220.441,Bedford-Stuyvesant (West)
19-May,36047025600,3025600,769,96391,97160,Brooklyn,1868287.048,Bensonhurst
21-May,36047025600,3025600,9412,89159,98571,Brooklyn,1868287.048,Bensonhurst
19-Jun,36047025600,3025600,11879,77753,89632,Brooklyn,1868287.048,Bensonhurst
21-Jun,36047025600,3025600,13369,98377,111746,Brooklyn,1868287.048,Bensonhurst
19-Jul,36047025600,3025600,12164,39394,51558,Brooklyn,1868287.048,Bensonhurst
21-Jul,36047025600,3025600,15555,99062,114617,Brooklyn,1868287.048,Bensonhurst
19-Aug,36047025600,3025600,5683,46366,52049,Brooklyn,1868287.048,Bensonhurst
21-Aug,36047025600,3025600,7288,104808,112096,Brooklyn,1868287.048,Bensonhurst
19-May,36047025700,3025700,6694,50073,56767,Brooklyn,1949087.115,Bedford-Stuyvesant (West)
21-May,36047025700,3025700,8230,60763,68993,Brooklyn,1949087.115,Bedford-Stuyvesant (West)
19-Jun,36047025700,3025700,5500,70482,75982,Brooklyn,1949087.115,Bedford-Stuyvesant (West)
21-Jun,36047025700,3025700,12804,88210,101014,Brooklyn,1949087.115,Bedford-Stuyvesant (West)
19-Jul,36047025700,3025700,3620,104699,108319,Brooklyn,1949087.115,Bedford-Stuyvesant (West)
21-Jul,36047025700,3025700,112,68807,68919,Brooklyn,1949087.115,Bedford-Stuyvesant (West)
19-Aug,36047025700,3025700,7753,67710,75463,Brooklyn,1949087.115,Bedford-Stuyvesant (West)
21-Aug,36047025700,3025700,10982,103719,114701,Brooklyn,1949087.115,Bedford-Stuyvesant (West)
19-May,36047025800,3025800,216,47109,47325,Brooklyn,1832115.441,Bensonhurst
21-May,36047025800,3025800,0,33768,33768,Brooklyn,1832115.441,Bensonhurst
19-Jun,36047025800,3025800,10253,98715,108968,Brooklyn,1832115.441,Bensonhurst
21-Jun,36047025800,3025800,1300,87321,88621,Brooklyn,1832115.441,Bensonhurst
19-Jul,36047025800,3025800,7706,44247,51953,Brooklyn,1832115.441,Bensonhurst
21-Jul,36047025800,3025800,5035,65389,70424,Brooklyn,1832115.441,Bensonhurst
19-Aug,36047025800,3025800,11554,50141,61695,Brooklyn,1832115.441,Bensonhurst
21-Aug,36047025800,3025800,7896,50225,58121,Brooklyn,1832115.441,Bensonhurst
19-May,36047025901,3025901,10599,71,10670,Brooklyn,863635.5934,Bedford-Stuyvesant (West)
21-May,36047025901,3025901,15836,120141,135977,Brooklyn,863635.5934,Bedford-Stuyvesant (West)
19-Jun,36047025901,3025901,16180,68789,84969,Brooklyn,863635.5934,Bedford-Stuyvesant (West)
21-Jun,36047025901,3025901,7344,87823,95167,Brooklyn,863635.5934,Bedford-Stuyvesant (West)
19-Jul,36047025901,3025901,0,88568,88568,Brooklyn,863635.5934,Bedford-Stuyvesant (West)
21-Jul,36047025901,3025901,8539,45170,53709,Brooklyn,863635.5934,Bedford-Stuyvesant (West)
19-Aug,36047025901,3025901,3105,89341,92446,Brooklyn,863635.5934,Bedford-Stuyvesant (West)
21-Aug,36047025901,3025901,2085,130380,132465,Brooklyn,863635.5934,Bedford-Stuyvesant (West)
19-May,36047025902,3025902,14370,343,14713,Brooklyn,642013.9859,Bedford-Stuyvesant (West)
21-May,36047025902,3025902,12943,30407,43350,Brooklyn,642013.9859,Bedford-Stuyvesant (West)
19-Jun,36047025902,3025902,10133,95451,105584,Brooklyn,642013.9859,Bedford-Stuyvesant (West)
21-Jun,36047025902,3025902,227,70718,70945,Brooklyn,642013.9859,Bedford-Stuyvesant (West)
19-Jul,36047025902,3025902,10410,123861,134271,Brooklyn,642013.9859,Bedford-Stuyvesant (West)
21-Jul,36047025902,3025902,3906,65930,69836,Brooklyn,642013.9859,Bedford-Stuyvesant (West)
19-Aug,36047025902,3025902,7271,18427,25698,Brooklyn,642013.9859,Bedford-Stuyvesant (West)
21-Aug,36047025902,3025902,12530,54942,67472,Brooklyn,642013.9859,Bedford-Stuyvesant (West)
19-May,36047026000,3026000,11724,49194,60918,Brooklyn,1753286.064,Bensonhurst
21-May,36047026000,3026000,8908,70795,79703,Brooklyn,1753286.064,Bensonhurst
19-Jun,36047026000,3026000,3927,37095,41022,Brooklyn,1753286.064,Bensonhurst
21-Jun,36047026000,3026000,1296,127759,129055,Brooklyn,1753286.064,Bensonhurst
19-Jul,36047026000,3026000,9230,4762,13992,Brooklyn,1753286.064,Bensonhurst
21-Jul,36047026000,3026000,3648,46248,49896,Brooklyn,1753286.064,Bensonhurst
19-Aug,36047026000,3026000,9352,117807,127159,Brooklyn,1753286.064,Bensonhurst
21-Aug,36047026000,3026000,10133,97657,107790,Brooklyn,1753286.064,Bensonhurst
19-May,36047026100,3026100,12113,61256,73369,Brooklyn,2146491.995,Bedford-Stuyvesant (West)
21-May,36047026100,3026100,11953,92220,104173,Brooklyn,2146491.995,Bedford-Stuyvesant (West)
19-Jun,36047026100,3026100,11353,58217,69570,Brooklyn,2146491.995,Bedford-Stuyvesant (West)
21-Jun,36047026100,3026100,16402,108582,124984,Brooklyn,2146491.995,Bedford-Stuyvesant (West)
19-Jul,36047026100,3026100,7925,55400,63325,Brooklyn,2146491.995,Bedford-Stuyvesant (West)
21-Jul,36047026100,3026100,10904,33997,44901,Brooklyn,2146491.995,Bedford-Stuyvesant (West)
19-Aug,36047026100,3026100,6898,78147,85045,Brooklyn,2146491.995,Bedford-Stuyvesant (West)
21-Aug,36047026100,3026100,7583,106597,114180,Brooklyn,2146491.995,Bedford-Stuyvesant (West)
19-May,36047026200,3026200,11849,38072,49921,Brooklyn,1699502.948,Bensonhurst
21-May,36047026200,3026200,6963,106815,113778,Brooklyn,1699502.948,Bensonhurst
19-Jun,36047026200,3026200,9985,43141,53126,Brooklyn,1699502.948,Bensonhurst
21-Jun,36047026200,3026200,10933,71,11004,Brooklyn,1699502.948,Bensonhurst
19-Jul,36047026200,3026200,9976,41474,51450,Brooklyn,1699502.948,Bensonhurst
21-Jul,36047026200,3026200,5270,61544,66814,Brooklyn,1699502.948,Bensonhurst
19-Aug,36047026200,3026200,10342,83055,93397,Brooklyn,1699502.948,Bensonhurst
21-Aug,36047026200,3026200,5967,96774,102741,Brooklyn,1699502.948,Bensonhurst
19-May,36047026300,3026300,10443,1832,12275,Brooklyn,1287405.885,Bedford-Stuyvesant (West)
21-May,36047026300,3026300,7243,51735,58978,Brooklyn,1287405.885,Bedford-Stuyvesant (West)
19-Jun,36047026300,3026300,0,72700,72700,Brooklyn,1287405.885,Bedford-Stuyvesant (West)
21-Jun,36047026300,3026300,6143,113216,119359,Brooklyn,1287405.885,Bedford-Stuyvesant (West)
19-Jul,36047026300,3026300,6701,57227,63928,Brooklyn,1287405.885,Bedford-Stuyvesant (West)
21-Jul,36047026300,3026300,8366,116102,124468,Brooklyn,1287405.885,Bedford-Stuyvesant (West)
19-Aug,36047026300,3026300,4166,105000,109166,Brooklyn,1287405.885,Bedford-Stuyvesant (West)
21-Aug,36047026300,3026300,13043,95628,108671,Brooklyn,1287405.885,Bedford-Stuyvesant (West)
19-May,36047026400,3026400,16627,106137,122764,Brooklyn,2038976.4,Bensonhurst
21-May,36047026400,3026400,1525,75990,77515,Brooklyn,2038976.4,Bensonhurst
19-Jun,36047026400,3026400,0,18715,18715,Brooklyn,2038976.4,Bensonhurst
21-Jun,36047026400,3026400,0,73050,73050,Brooklyn,2038976.4,Bensonhurst
19-Jul,36047026400,3026400,2774,13088,15862,Brooklyn,2038976.4,Bensonhurst
21-Jul,36047026400,3026400,3874,68210,72084,Brooklyn,2038976.4,Bensonhurst
19-Aug,36047026400,3026400,3269,82194,85463,Brooklyn,2038976.4,Bensonhurst
21-Aug,36047026400,3026400,10384,69626,80010,Brooklyn,2038976.4,Bensonhurst
19-May,36047026500,3026500,9533,110154,119687,Brooklyn,1718284.07,Bedford-Stuyvesant (West)
21-May,36047026500,3026500,1021,86090,87111,Brooklyn,1718284.07,Bedford-Stuyvesant (West)
19-Jun,36047026500,3026500,15477,108715,124192,Brooklyn,1718284.07,Bedford-Stuyvesant (West)
21-Jun,36047026500,3026500,3595,85664,89259,Brooklyn,1718284.07,Bedford-Stuyvesant (West)
19-Jul,36047026500,3026500,13718,53988,67706,Brooklyn,1718284.07,Bedford-Stuyvesant (West)
21-Jul,36047026500,3026500,0,71,71,Brooklyn,1718284.07,Bedford-Stuyvesant (West)
19-Aug,36047026500,3026500,16948,74057,91005,Brooklyn,1718284.07,Bedford-Stuyvesant (West)
21-Aug,36047026500,3026500,14077,79981,94058,Brooklyn,1718284.07,Bedford-Stuyvesant (West)
19-May,36047026600,3026600,0,74369,74369,Brooklyn,1785503.085,Bensonhurst
21-May,36047026600,3026600,7009,52401,59410,Brooklyn,1785503.085,Bensonhurst
19-Jun,36047026600,3026600,3023,113551,116574,Brooklyn,1785503.085,Bensonhurst
21-Jun,36047026600,3026600,17007,63149,80156,Brooklyn,1785503.085,Bensonhurst
19-Jul,36047026600,3026600,8239,56675,64914,Brooklyn,1785503.085,Bensonhurst
21-Jul,36047026600,3026600,6056,155105,161161,Brooklyn,1785503.085,Bensonhurst
19-Aug,36047026600,3026600,2453,76697,79150,Brooklyn,1785503.085,Bensonhurst
21-Aug,36047026600,3026600,4234,42749,46983,Brooklyn,1785503.085,Bensonhurst
19-May,36047026700,3026700,14518,114884,129402,Brooklyn,1717368.237,Bedford-Stuyvesant (West)
21-May,36047026700,3026700,5845,83562,89407,Brooklyn,1717368.237,Bedford-Stuyvesant (West)
19-Jun,36047026700,3026700,2843,49974,52817,Brooklyn,1717368.237,Bedford-Stuyvesant (West)
21-Jun,36047026700,3026700,6750,99002,105752,Brooklyn,1717368.237,Bedford-Stuyvesant (West)
19-Jul,36047026700,3026700,19385,75746,95131,Brooklyn,1717368.237,Bedford-Stuyvesant (West)
21-Jul,36047026700,3026700,15404,4317,19721,Brooklyn,1717368.237,Bedford-Stuyvesant (West)
19-Aug,36047026700,3026700,4370,94751,99121,Brooklyn,1717368.237,Bedford-Stuyvesant (West)
21-Aug,36047026700,3026700,10664,44747,55411,Brooklyn,1717368.237,Bedford-Stuyvesant (West)
19-May,36047026800,3026800,5385,30102,35487,Brooklyn,1926489.429,Bensonhurst
21-May,36047026800,3026800,8469,84151,92620,Brooklyn,1926489.429,Bensonhurst
19-Jun,36047026800,3026800,7105,69740,76845,Brooklyn,1926489.429,Bensonhurst
21-Jun,36047026800,3026800,1401,61942,63343,Brooklyn,1926489.429,Bensonhurst
19-Jul,36047026800,3026800,11923,52013,63936,Brooklyn,1926489.429,Bensonhurst
21-Jul,36047026800,3026800,5907,72957,78864,Brooklyn,1926489.429,Bensonhurst
19-Aug,36047026800,3026800,11315,57013,68328,Brooklyn,1926489.429,Bensonhurst
21-Aug,36047026800,3026800,12677,75357,88034,Brooklyn,1926489.429,Bensonhurst
19-May,36047026900,3026900,14384,159622,174006,Brooklyn,1441848.666,Bedford-Stuyvesant (West)
21-May,36047026900,3026900,12344,89201,101545,Brooklyn,1441848.666,Bedford-Stuyvesant (West)
19-Jun,36047026900,3026900,7412,68871,76283,Brooklyn,1441848.666,Bedford-Stuyvesant (West)
21-Jun,36047026900,3026900,3511,75269,78780,Brooklyn,1441848.666,Bedford-Stuyvesant (West)
19-Jul,36047026900,3026900,11861,71,11932,Brooklyn,1441848.666,Bedford-Stuyvesant (West)
21-Jul,36047026900,3026900,3705,82364,86069,Brooklyn,1441848.666,Bedford-Stuyvesant (West)
19-Aug,36047026900,3026900,1070,71,1141,Brooklyn,1441848.666,Bedford-Stuyvesant (West)
21-Aug,36047026900,3026900,7772,88370,96142,Brooklyn,1441848.666,Bedford-Stuyvesant (West)
19-May,36047027000,3027000,5969,86970,92939,Brooklyn,1444005.625,Bensonhurst
21-May,36047027000,3027000,8661,121561,130222,Brooklyn,1444005.625,Bensonhurst
19-Jun,36047027000,3027000,1842,71,1913,Brooklyn,1444005.625,Bensonhurst
21-Jun,36047027000,3027000,10064,104568,114632,Brooklyn,1444005.625,Bensonhurst
19-Jul,36047027000,3027000,18620,120923,139543,Brooklyn,1444005.625,Bensonhurst
21-Jul,36047027000,3027000,1949,117892,119841,Brooklyn,1444005.625,Bensonhurst
19-Aug,36047027000,3027000,4842,71144,75986,Brooklyn,1444005.625,Bensonhurst
21-Aug,36047027000,3027000,8702,85463,94165,Brooklyn,1444005.625,Bensonhurst
19-May,36047027100,3027100,3780,71,3851,Brooklyn,2660204.622,Bedford-Stuyvesant (East)
21-May,36047027100,3027100,7305,51827,59132,Brooklyn,2660204.622,Bedford-Stuyvesant (East)
19-Jun,36047027100,3027100,13488,30165,43653,Brooklyn,2660204.622,Bedford-Stuyvesant (East)
21-Jun,36047027100,3027100,7145,123565,130710,Brooklyn,2660204.622,Bedford-Stuyvesant (East)
19-Jul,36047027100,3027100,10736,150233,160969,Brooklyn,2660204.622,Bedford-Stuyvesant (East)
21-Jul,36047027100,3027100,13040,80901,93941,Brooklyn,2660204.622,Bedford-Stuyvesant (East)
19-Aug,36047027100,3027100,12151,23952,36103,Brooklyn,2660204.622,Bedford-Stuyvesant (East)
21-Aug,36047027100,3027100,3723,31116,34839,Brooklyn,2660204.622,Bedford-Stuyvesant (East)
19-May,36047027200,3027200,13148,119819,132967,Brooklyn,1422363.35,Bensonhurst
21-May,36047027200,3027200,1750,94812,96562,Brooklyn,1422363.35,Bensonhurst
19-Jun,36047027200,3027200,410,77918,78328,Brooklyn,1422363.35,Bensonhurst
21-Jun,36047027200,3027200,15413,87593,103006,Brooklyn,1422363.35,Bensonhurst
19-Jul,36047027200,3027200,1108,71,1179,Brooklyn,1422363.35,Bensonhurst
21-Jul,36047027200,3027200,14359,29156,43515,Brooklyn,1422363.35,Bensonhurst
19-Aug,36047027200,3027200,8483,97626,106109,Brooklyn,1422363.35,Bensonhurst
21-Aug,36047027200,3027200,8654,46531,55185,Brooklyn,1422363.35,Bensonhurst
19-May,36047027300,3027300,4830,151650,156480,Brooklyn,1611451.02,Bedford-Stuyvesant (East)
21-May,36047027300,3027300,7739,46954,54693,Brooklyn,1611451.02,Bedford-Stuyvesant (East)
19-Jun,36047027300,3027300,6479,79085,85564,Brooklyn,1611451.02,Bedford-Stuyvesant (East)
21-Jun,36047027300,3027300,7708,93495,101203,Brooklyn,1611451.02,Bedford-Stuyvesant (East)
19-Jul,36047027300,3027300,12969,127494,140463,Brooklyn,1611451.02,Bedford-Stuyvesant (East)
21-Jul,36047027300,3027300,7255,117150,124405,Brooklyn,1611451.02,Bedford-Stuyvesant (East)
19-Aug,36047027300,3027300,16632,74942,91574,Brooklyn,1611451.02,Bedford-Stuyvesant (East)
21-Aug,36047027300,3027300,23553,41600,65153,Brooklyn,1611451.02,Bedford-Stuyvesant (East)
19-May,36047027400,3027400,11499,52928,64427,Brooklyn,1758627.161,Bensonhurst
21-May,36047027400,3027400,15272,115562,130834,Brooklyn,1758627.161,Bensonhurst
19-Jun,36047027400,3027400,6202,55467,61669,Brooklyn,1758627.161,Bensonhurst
21-Jun,36047027400,3027400,11632,44198,55830,Brooklyn,1758627.161,Bensonhurst
19-Jul,36047027400,3027400,7184,62433,69617,Brooklyn,1758627.161,Bensonhurst
21-Jul,36047027400,3027400,12200,71,12271,Brooklyn,1758627.161,Bensonhurst
19-Aug,36047027400,3027400,11008,41114,52122,Brooklyn,1758627.161,Bensonhurst
21-Aug,36047027400,3027400,4255,59280,63535,Brooklyn,1758627.161,Bensonhurst
19-May,36047027500,3027500,4147,79414,83561,Brooklyn,1743574.463,Bedford-Stuyvesant (East)
21-May,36047027500,3027500,12314,71,12385,Brooklyn,1743574.463,Bedford-Stuyvesant (East)
19-Jun,36047027500,3027500,3392,133531,136923,Brooklyn,1743574.463,Bedford-Stuyvesant (East)
21-Jun,36047027500,3027500,3956,71,4027,Brooklyn,1743574.463,Bedford-Stuyvesant (East)
19-Jul,36047027500,3027500,1669,63919,65588,Brooklyn,1743574.463,Bedford-Stuyvesant (East)
21-Jul,36047027500,3027500,10814,24256,35070,Brooklyn,1743574.463,Bedford-Stuyvesant (East)
19-Aug,36047027500,3027500,2840,46823,49663,Brooklyn,1743574.463,Bedford-Stuyvesant (East)
21-Aug,36047027500,3027500,5980,108926,114906,Brooklyn,1743574.463,Bedford-Stuyvesant (East)
19-May,36047027600,3027600,0,68694,68694,Brooklyn,1607864.544,Bensonhurst
21-May,36047027600,3027600,10827,45530,56357,Brooklyn,1607864.544,Bensonhurst
19-Jun,36047027600,3027600,13757,133275,147032,Brooklyn,1607864.544,Bensonhurst
21-Jun,36047027600,3027600,4868,69819,74687,Brooklyn,1607864.544,Bensonhurst
19-Jul,36047027600,3027600,3545,70634,74179,Brooklyn,1607864.544,Bensonhurst
21-Jul,36047027600,3027600,10655,99209,109864,Brooklyn,1607864.544,Bensonhurst
19-Aug,36047027600,3027600,13175,87607,100782,Brooklyn,1607864.544,Bensonhurst
21-Aug,36047027600,3027600,2228,47700,49928,Brooklyn,1607864.544,Bensonhurst
19-May,36047027700,3027700,5438,9322,14760,Brooklyn,1745688.016,Bedford-Stuyvesant (East)
21-May,36047027700,3027700,6364,65407,71771,Brooklyn,1745688.016,Bedford-Stuyvesant (East)
19-Jun,36047027700,3027700,3956,36544,40500,Brooklyn,1745688.016,Bedford-Stuyvesant (East)
21-Jun,36047027700,3027700,3407,166690,170097,Brooklyn,1745688.016,Bedford-Stuyvesant (East)
19-Jul,36047027700,3027700,6215,54198,60413,Brooklyn,1745688.016,Bedford-Stuyvesant (East)
21-Jul,36047027700,3027700,14413,73832,88245,Brooklyn,1745688.016,Bedford-Stuyvesant (East)
19-Aug,36047027700,3027700,0,59523,59523,Brooklyn,1745688.016,Bedford-Stuyvesant (East)
21-Aug,36047027700,3027700,3232,68911,72143,Brooklyn,1745688.016,Bedford-Stuyvesant (East)
19-May,36047027800,3027800,6490,123362,129852,Brooklyn,1727742.168,Bensonhurst
21-May,36047027800,3027800,8860,131730,140590,Brooklyn,1727742.168,Bensonhurst
19-Jun,36047027800,3027800,5895,33045,38940,Brooklyn,1727742.168,Bensonhurst
21-Jun,36047027800,3027800,9372,33412,42784,Brooklyn,1727742.168,Bensonhurst
19-Jul,36047027800,3027800,13547,145357,158904,Brooklyn,1727742.168,Bensonhurst
21-Jul,36047027800,3027800,7231,38275,45506,Brooklyn,1727742.168,Bensonhurst
19-Aug,36047027800,3027800,8802,92623,101425,Brooklyn,1727742.168,Bensonhurst
21-Aug,36047027800,3027800,7638,35317,42955,Brooklyn,1727742.168,Bensonhurst
19-May,36047027900,3027900,0,79209,79209,Brooklyn,1743088.089,Bedford-Stuyvesant (East)
21-May,36047027900,3027900,8399,75754,84153,Brooklyn,1743088.089,Bedford-Stuyvesant (East)
19-Jun,36047027900,3027900,11421,71786,83207,Brooklyn,1743088.089,Bedford-Stuyvesant (East)
21-Jun,36047027900,3027900,6062,22912,28974,Brooklyn,1743088.089,Bedford-Stuyvesant (East)
19-Jul,36047027900,3027900,12493,99363,111856,Brooklyn,1743088.089,Bedford-Stuyvesant (East)
21-Jul,36047027900,3027900,2704,74847,77551,Brooklyn,1743088.089,Bedford-Stuyvesant (East)
19-Aug,36047027900,3027900,5744,103939,109683,Brooklyn,1743088.089,Bedford-Stuyvesant (East)
21-Aug,36047027900,3027900,11195,67637,78832,Brooklyn,1743088.089,Bedford-Stuyvesant (East)
19-May,36047028000,3028000,10316,71931,82247,Brooklyn,1494252.239,Bath Beach
21-May,36047028000,3028000,1444,52355,53799,Brooklyn,1494252.239,Bath Beach
19-Jun,36047028000,3028000,3465,73600,77065,Brooklyn,1494252.239,Bath Beach
21-Jun,36047028000,3028000,7775,95037,102812,Brooklyn,1494252.239,Bath Beach
19-Jul,36047028000,3028000,0,114951,114951,Brooklyn,1494252.239,Bath Beach
21-Jul,36047028000,3028000,6511,29866,36377,Brooklyn,1494252.239,Bath Beach
19-Aug,36047028000,3028000,9190,92769,101959,Brooklyn,1494252.239,Bath Beach
21-Aug,36047028000,3028000,12663,59147,71810,Brooklyn,1494252.239,Bath Beach
19-May,36047028100,3028100,9283,137261,146544,Brooklyn,1743468.243,Bedford-Stuyvesant (East)
21-May,36047028100,3028100,14002,32382,46384,Brooklyn,1743468.243,Bedford-Stuyvesant (East)
19-Jun,36047028100,3028100,0,19370,19370,Brooklyn,1743468.243,Bedford-Stuyvesant (East)
21-Jun,36047028100,3028100,123,109515,109638,Brooklyn,1743468.243,Bedford-Stuyvesant (East)
19-Jul,36047028100,3028100,8544,69695,78239,Brooklyn,1743468.243,Bedford-Stuyvesant (East)
21-Jul,36047028100,3028100,5824,71,5895,Brooklyn,1743468.243,Bedford-Stuyvesant (East)
19-Aug,36047028100,3028100,6786,71,6857,Brooklyn,1743468.243,Bedford-Stuyvesant (East)
21-Aug,36047028100,3028100,5686,66315,72001,Brooklyn,1743468.243,Bedford-Stuyvesant (East)
19-May,36047028200,3028200,3821,46912,50733,Brooklyn,1811479.73,Bath Beach
21-May,36047028200,3028200,6580,80307,86887,Brooklyn,1811479.73,Bath Beach
19-Jun,36047028200,3028200,8408,135394,143802,Brooklyn,1811479.73,Bath Beach
21-Jun,36047028200,3028200,11515,112760,124275,Brooklyn,1811479.73,Bath Beach
19-Jul,36047028200,3028200,13717,162563,176280,Brooklyn,1811479.73,Bath Beach
21-Jul,36047028200,3028200,11355,65890,77245,Brooklyn,1811479.73,Bath Beach
19-Aug,36047028200,3028200,4435,91315,95750,Brooklyn,1811479.73,Bath Beach
21-Aug,36047028200,3028200,21124,149066,170190,Brooklyn,1811479.73,Bath Beach
19-May,36047028300,3028300,2775,65869,68644,Brooklyn,1311680.667,Bedford-Stuyvesant (East)
21-May,36047028300,3028300,1942,81097,83039,Brooklyn,1311680.667,Bedford-Stuyvesant (East)
19-Jun,36047028300,3028300,6893,98302,105195,Brooklyn,1311680.667,Bedford-Stuyvesant (East)
21-Jun,36047028300,3028300,10883,23900,34783,Brooklyn,1311680.667,Bedford-Stuyvesant (East)
19-Jul,36047028300,3028300,11977,41303,53280,Brooklyn,1311680.667,Bedford-Stuyvesant (East)
21-Jul,36047028300,3028300,14758,57678,72436,Brooklyn,1311680.667,Bedford-Stuyvesant (East)
19-Aug,36047028300,3028300,3058,142473,145531,Brooklyn,1311680.667,Bedford-Stuyvesant (East)
21-Aug,36047028300,3028300,0,10968,10968,Brooklyn,1311680.667,Bedford-Stuyvesant (East)
19-May,36047028400,3028400,18420,36376,54796,Brooklyn,1768012.155,Bensonhurst
21-May,36047028400,3028400,12318,97260,109578,Brooklyn,1768012.155,Bensonhurst
19-Jun,36047028400,3028400,12888,134855,147743,Brooklyn,1768012.155,Bensonhurst
21-Jun,36047028400,3028400,18552,122387,140939,Brooklyn,1768012.155,Bensonhurst
19-Jul,36047028400,3028400,1132,12562,13694,Brooklyn,1768012.155,Bensonhurst
21-Jul,36047028400,3028400,2240,16169,18409,Brooklyn,1768012.155,Bensonhurst
19-Aug,36047028400,3028400,2628,56205,58833,Brooklyn,1768012.155,Bensonhurst
21-Aug,36047028400,3028400,2942,96944,99886,Brooklyn,1768012.155,Bensonhurst
19-May,36047028501,3028501,11532,68033,79565,Brooklyn,895739.6493,Bedford-Stuyvesant (East)
21-May,36047028501,3028501,8858,2850,11708,Brooklyn,895739.6493,Bedford-Stuyvesant (East)
19-Jun,36047028501,3028501,3697,5994,9691,Brooklyn,895739.6493,Bedford-Stuyvesant (East)
21-Jun,36047028501,3028501,7941,71,8012,Brooklyn,895739.6493,Bedford-Stuyvesant (East)
19-Jul,36047028501,3028501,13264,128791,142055,Brooklyn,895739.6493,Bedford-Stuyvesant (East)
21-Jul,36047028501,3028501,13556,22850,36406,Brooklyn,895739.6493,Bedford-Stuyvesant (East)
19-Aug,36047028501,3028501,13024,114987,128011,Brooklyn,895739.6493,Bedford-Stuyvesant (East)
21-Aug,36047028501,3028501,5374,63383,68757,Brooklyn,895739.6493,Bedford-Stuyvesant (East)
19-May,36047028502,3028502,8830,113672,122502,Brooklyn,1290359.476,Bedford-Stuyvesant (East)
21-May,36047028502,3028502,15857,56437,72294,Brooklyn,1290359.476,Bedford-Stuyvesant (East)
19-Jun,36047028502,3028502,2217,81351,83568,Brooklyn,1290359.476,Bedford-Stuyvesant (East)
21-Jun,36047028502,3028502,5146,64768,69914,Brooklyn,1290359.476,Bedford-Stuyvesant (East)
19-Jul,36047028502,3028502,6468,98745,105213,Brooklyn,1290359.476,Bedford-Stuyvesant (East)
21-Jul,36047028502,3028502,6541,85849,92390,Brooklyn,1290359.476,Bedford-Stuyvesant (East)
19-Aug,36047028502,3028502,12760,108309,121069,Brooklyn,1290359.476,Bedford-Stuyvesant (East)
21-Aug,36047028502,3028502,10299,69058,79357,Brooklyn,1290359.476,Bedford-Stuyvesant (East)
19-May,36047028600,3028600,7125,12454,19579,Brooklyn,1904932.723,Bath Beach
21-May,36047028600,3028600,1867,114697,116564,Brooklyn,1904932.723,Bath Beach
19-Jun,36047028600,3028600,7915,59322,67237,Brooklyn,1904932.723,Bath Beach
21-Jun,36047028600,3028600,13888,55987,69875,Brooklyn,1904932.723,Bath Beach
19-Jul,36047028600,3028600,5254,80758,86012,Brooklyn,1904932.723,Bath Beach
21-Jul,36047028600,3028600,14769,105251,120020,Brooklyn,1904932.723,Bath Beach
19-Aug,36047028600,3028600,10386,29210,39596,Brooklyn,1904932.723,Bath Beach
21-Aug,36047028600,3028600,17519,79063,96582,Brooklyn,1904932.723,Bath Beach
19-May,36047028700,3028700,2283,55707,57990,Brooklyn,1601115.387,Bedford-Stuyvesant (East)
21-May,36047028700,3028700,5260,52948,58208,Brooklyn,1601115.387,Bedford-Stuyvesant (East)
19-Jun,36047028700,3028700,3614,135949,139563,Brooklyn,1601115.387,Bedford-Stuyvesant (East)
21-Jun,36047028700,3028700,13772,38376,52148,Brooklyn,1601115.387,Bedford-Stuyvesant (East)
19-Jul,36047028700,3028700,15640,100552,116192,Brooklyn,1601115.387,Bedford-Stuyvesant (East)
21-Jul,36047028700,3028700,10597,95423,106020,Brooklyn,1601115.387,Bedford-Stuyvesant (East)
19-Aug,36047028700,3028700,6662,87956,94618,Brooklyn,1601115.387,Bedford-Stuyvesant (East)
21-Aug,36047028700,3028700,9629,131541,141170,Brooklyn,1601115.387,Bedford-Stuyvesant (East)
19-May,36047028800,3028800,15709,43010,58719,Brooklyn,1644934.142,Bensonhurst
21-May,36047028800,3028800,8441,74168,82609,Brooklyn,1644934.142,Bensonhurst
19-Jun,36047028800,3028800,1534,68469,70003,Brooklyn,1644934.142,Bensonhurst
21-Jun,36047028800,3028800,4612,30239,34851,Brooklyn,1644934.142,Bensonhurst
19-Jul,36047028800,3028800,5030,105292,110322,Brooklyn,1644934.142,Bensonhurst
21-Jul,36047028800,3028800,14056,53782,67838,Brooklyn,1644934.142,Bensonhurst
19-Aug,36047028800,3028800,12566,44214,56780,Brooklyn,1644934.142,Bensonhurst
21-Aug,36047028800,3028800,9633,101546,111179,Brooklyn,1644934.142,Bensonhurst
19-May,36047029000,3029000,0,67406,67406,Brooklyn,1665073.38,Bensonhurst
21-May,36047029000,3029000,3776,58165,61941,Brooklyn,1665073.38,Bensonhurst
19-Jun,36047029000,3029000,4184,93239,97423,Brooklyn,1665073.38,Bensonhurst
21-Jun,36047029000,3029000,10762,84048,94810,Brooklyn,1665073.38,Bensonhurst
19-Jul,36047029000,3029000,6973,89570,96543,Brooklyn,1665073.38,Bensonhurst
21-Jul,36047029000,3029000,4019,47928,51947,Brooklyn,1665073.38,Bensonhurst
19-Aug,36047029000,3029000,11623,120362,131985,Brooklyn,1665073.38,Bensonhurst
21-Aug,36047029000,3029000,11228,45895,57123,Brooklyn,1665073.38,Bensonhurst
19-May,36047029100,3029100,14597,60947,75544,Brooklyn,1772059.569,Bedford-Stuyvesant (East)
21-May,36047029100,3029100,3073,33501,36574,Brooklyn,1772059.569,Bedford-Stuyvesant (East)
19-Jun,36047029100,3029100,8828,55208,64036,Brooklyn,1772059.569,Bedford-Stuyvesant (East)
21-Jun,36047029100,3029100,13942,60522,74464,Brooklyn,1772059.569,Bedford-Stuyvesant (East)
19-Jul,36047029100,3029100,1715,56011,57726,Brooklyn,1772059.569,Bedford-Stuyvesant (East)
21-Jul,36047029100,3029100,6230,106648,112878,Brooklyn,1772059.569,Bedford-Stuyvesant (East)
19-Aug,36047029100,3029100,14075,76223,90298,Brooklyn,1772059.569,Bedford-Stuyvesant (East)
21-Aug,36047029100,3029100,7618,119658,127276,Brooklyn,1772059.569,Bedford-Stuyvesant (East)
19-May,36047029200,3029200,0,83501,83501,Brooklyn,2215329.955,Bath Beach
21-May,36047029200,3029200,11051,104229,115280,Brooklyn,2215329.955,Bath Beach
19-Jun,36047029200,3029200,11010,106722,117732,Brooklyn,2215329.955,Bath Beach
21-Jun,36047029200,3029200,5866,71,5937,Brooklyn,2215329.955,Bath Beach
19-Jul,36047029200,3029200,12038,50578,62616,Brooklyn,2215329.955,Bath Beach
21-Jul,36047029200,3029200,992,51306,52298,Brooklyn,2215329.955,Bath Beach
19-Aug,36047029200,3029200,5890,55048,60938,Brooklyn,2215329.955,Bath Beach
21-Aug,36047029200,3029200,8175,77596,85771,Brooklyn,2215329.955,Bath Beach
19-May,36047029300,3029300,9377,59324,68701,Brooklyn,1770060.693,Bedford-Stuyvesant (East)
21-May,36047029300,3029300,10034,58363,68397,Brooklyn,1770060.693,Bedford-Stuyvesant (East)
19-Jun,36047029300,3029300,8217,71,8288,Brooklyn,1770060.693,Bedford-Stuyvesant (East)
21-Jun,36047029300,3029300,8252,102350,110602,Brooklyn,1770060.693,Bedford-Stuyvesant (East)
19-Jul,36047029300,3029300,11998,56166,68164,Brooklyn,1770060.693,Bedford-Stuyvesant (East)
21-Jul,36047029300,3029300,13217,56455,69672,Brooklyn,1770060.693,Bedford-Stuyvesant (East)
19-Aug,36047029300,3029300,2987,57685,60672,Brooklyn,1770060.693,Bedford-Stuyvesant (East)
21-Aug,36047029300,3029300,10779,131454,142233,Brooklyn,1770060.693,Bedford-Stuyvesant (East)
19-May,36047029400,3029400,4168,56677,60845,Brooklyn,2032099.544,Gravesend (West)
21-May,36047029400,3029400,8433,123511,131944,Brooklyn,2032099.544,Gravesend (West)
19-Jun,36047029400,3029400,11709,61459,73168,Brooklyn,2032099.544,Gravesend (West)
21-Jun,36047029400,3029400,7404,96614,104018,Brooklyn,2032099.544,Gravesend (West)
19-Jul,36047029400,3029400,9617,116332,125949,Brooklyn,2032099.544,Gravesend (West)
21-Jul,36047029400,3029400,11971,61889,73860,Brooklyn,2032099.544,Gravesend (West)
19-Aug,36047029400,3029400,14044,49848,63892,Brooklyn,2032099.544,Gravesend (West)
21-Aug,36047029400,3029400,2867,94919,97786,Brooklyn,2032099.544,Gravesend (West)
19-May,36047029500,3029500,10774,72387,83161,Brooklyn,1771507.829,Bedford-Stuyvesant (East)
21-May,36047029500,3029500,3384,206639,210023,Brooklyn,1771507.829,Bedford-Stuyvesant (East)
19-Jun,36047029500,3029500,0,56222,56222,Brooklyn,1771507.829,Bedford-Stuyvesant (East)
21-Jun,36047029500,3029500,10403,112841,123244,Brooklyn,1771507.829,Bedford-Stuyvesant (East)
19-Jul,36047029500,3029500,9211,91723,100934,Brooklyn,1771507.829,Bedford-Stuyvesant (East)
21-Jul,36047029500,3029500,12903,94159,107062,Brooklyn,1771507.829,Bedford-Stuyvesant (East)
19-Aug,36047029500,3029500,11483,110701,122184,Brooklyn,1771507.829,Bedford-Stuyvesant (East)
21-Aug,36047029500,3029500,6779,104179,110958,Brooklyn,1771507.829,Bedford-Stuyvesant (East)
19-May,36047029600,3029600,10826,50750,61576,Brooklyn,2300496.788,Gravesend (West)
21-May,36047029600,3029600,4012,137795,141807,Brooklyn,2300496.788,Gravesend (West)
19-Jun,36047029600,3029600,10307,62505,72812,Brooklyn,2300496.788,Gravesend (West)
21-Jun,36047029600,3029600,15707,135680,151387,Brooklyn,2300496.788,Gravesend (West)
19-Jul,36047029600,3029600,20145,79876,100021,Brooklyn,2300496.788,Gravesend (West)
21-Jul,36047029600,3029600,10604,60931,71535,Brooklyn,2300496.788,Gravesend (West)
19-Aug,36047029600,3029600,13495,16192,29687,Brooklyn,2300496.788,Gravesend (West)
21-Aug,36047029600,3029600,2865,56198,59063,Brooklyn,2300496.788,Gravesend (West)
19-May,36047029700,3029700,5688,85235,90923,Brooklyn,2211871.34,Bedford-Stuyvesant (East)
21-May,36047029700,3029700,7043,25930,32973,Brooklyn,2211871.34,Bedford-Stuyvesant (East)
19-Jun,36047029700,3029700,4797,33840,38637,Brooklyn,2211871.34,Bedford-Stuyvesant (East)
21-Jun,36047029700,3029700,13437,107579,121016,Brooklyn,2211871.34,Bedford-Stuyvesant (East)
19-Jul,36047029700,3029700,11245,90550,101795,Brooklyn,2211871.34,Bedford-Stuyvesant (East)
21-Jul,36047029700,3029700,13500,70576,84076,Brooklyn,2211871.34,Bedford-Stuyvesant (East)
19-Aug,36047029700,3029700,9007,18187,27194,Brooklyn,2211871.34,Bedford-Stuyvesant (East)
21-Aug,36047029700,3029700,10739,114255,124994,Brooklyn,2211871.34,Bedford-Stuyvesant (East)
19-May,36047029800,3029800,13673,7012,20685,Brooklyn,2379873.96,Gravesend (West)
21-May,36047029800,3029800,4860,133225,138085,Brooklyn,2379873.96,Gravesend (West)
19-Jun,36047029800,3029800,4093,45233,49326,Brooklyn,2379873.96,Gravesend (West)
21-Jun,36047029800,3029800,593,88554,89147,Brooklyn,2379873.96,Gravesend (West)
19-Jul,36047029800,3029800,12731,81042,93773,Brooklyn,2379873.96,Gravesend (West)
21-Jul,36047029800,3029800,6103,26639,32742,Brooklyn,2379873.96,Gravesend (West)
19-Aug,36047029800,3029800,5693,147904,153597,Brooklyn,2379873.96,Gravesend (West)
21-Aug,36047029800,3029800,17098,107173,124271,Brooklyn,2379873.96,Gravesend (West)
19-May,36047029900,3029900,2758,114039,116797,Brooklyn,1535625.105,Bedford-Stuyvesant (East)
21-May,36047029900,3029900,6552,108617,115169,Brooklyn,1535625.105,Bedford-Stuyvesant (East)
19-Jun,36047029900,3029900,8581,151967,160548,Brooklyn,1535625.105,Bedford-Stuyvesant (East)
21-Jun,36047029900,3029900,13923,110533,124456,Brooklyn,1535625.105,Bedford-Stuyvesant (East)
19-Jul,36047029900,3029900,13294,56341,69635,Brooklyn,1535625.105,Bedford-Stuyvesant (East)
21-Jul,36047029900,3029900,0,87831,87831,Brooklyn,1535625.105,Bedford-Stuyvesant (East)
19-Aug,36047029900,3029900,4125,87457,91582,Brooklyn,1535625.105,Bedford-Stuyvesant (East)
21-Aug,36047029900,3029900,4596,36396,40992,Brooklyn,1535625.105,Bedford-Stuyvesant (East)
19-May,36047030000,3030000,3189,37695,40884,Brooklyn,2099451.011,Gravesend (West)
21-May,36047030000,3030000,11927,53595,65522,Brooklyn,2099451.011,Gravesend (West)
19-Jun,36047030000,3030000,10825,31167,41992,Brooklyn,2099451.011,Gravesend (West)
21-Jun,36047030000,3030000,4987,79245,84232,Brooklyn,2099451.011,Gravesend (West)
19-Jul,36047030000,3030000,1397,16682,18079,Brooklyn,2099451.011,Gravesend (West)
21-Jul,36047030000,3030000,7306,86795,94101,Brooklyn,2099451.011,Gravesend (West)
19-Aug,36047030000,3030000,3920,110169,114089,Brooklyn,2099451.011,Gravesend (West)
21-Aug,36047030000,3030000,6950,35061,42011,Brooklyn,2099451.011,Gravesend (West)
19-May,36047030100,3030100,12389,64650,77039,Brooklyn,2097829.097,Ocean Hill
21-May,36047030100,3030100,7121,83074,90195,Brooklyn,2097829.097,Ocean Hill
19-Jun,36047030100,3030100,11719,53098,64817,Brooklyn,2097829.097,Ocean Hill
21-Jun,36047030100,3030100,14835,52291,67126,Brooklyn,2097829.097,Ocean Hill
19-Jul,36047030100,3030100,14070,36243,50313,Brooklyn,2097829.097,Ocean Hill
21-Jul,36047030100,3030100,4951,38901,43852,Brooklyn,2097829.097,Ocean Hill
19-Aug,36047030100,3030100,3792,20755,24547,Brooklyn,2097829.097,Ocean Hill
21-Aug,36047030100,3030100,580,93747,94327,Brooklyn,2097829.097,Ocean Hill
19-May,36047030200,3030200,0,51882,51882,Brooklyn,2273119.845,Gravesend (West)
21-May,36047030200,3030200,5487,88049,93536,Brooklyn,2273119.845,Gravesend (West)
19-Jun,36047030200,3030200,0,90928,90928,Brooklyn,2273119.845,Gravesend (West)
21-Jun,36047030200,3030200,0,74708,74708,Brooklyn,2273119.845,Gravesend (West)
19-Jul,36047030200,3030200,15899,43642,59541,Brooklyn,2273119.845,Gravesend (West)
21-Jul,36047030200,3030200,3561,88491,92052,Brooklyn,2273119.845,Gravesend (West)
19-Aug,36047030200,3030200,1870,90078,91948,Brooklyn,2273119.845,Gravesend (West)
21-Aug,36047030200,3030200,7722,134306,142028,Brooklyn,2273119.845,Gravesend (West)
19-May,36047030300,3030300,3898,118604,122502,Brooklyn,2726302.166,Ocean Hill
21-May,36047030300,3030300,7056,40977,48033,Brooklyn,2726302.166,Ocean Hill
19-Jun,36047030300,3030300,7349,117149,124498,Brooklyn,2726302.166,Ocean Hill
21-Jun,36047030300,3030300,2604,116203,118807,Brooklyn,2726302.166,Ocean Hill
19-Jul,36047030300,3030300,12589,43664,56253,Brooklyn,2726302.166,Ocean Hill
21-Jul,36047030300,3030300,13335,84157,97492,Brooklyn,2726302.166,Ocean Hill
19-Aug,36047030300,3030300,13656,78606,92262,Brooklyn,2726302.166,Ocean Hill
21-Aug,36047030300,3030300,14771,38448,53219,Brooklyn,2726302.166,Ocean Hill
19-May,36047030400,3030400,13023,79177,92200,Brooklyn,5021019.792,Gravesend (West)
21-May,36047030400,3030400,1908,111658,113566,Brooklyn,5021019.792,Gravesend (West)
19-Jun,36047030400,3030400,0,142327,142327,Brooklyn,5021019.792,Gravesend (West)
21-Jun,36047030400,3030400,0,71,71,Brooklyn,5021019.792,Gravesend (West)
19-Jul,36047030400,3030400,3414,83137,86551,Brooklyn,5021019.792,Gravesend (West)
21-Jul,36047030400,3030400,8633,85083,93716,Brooklyn,5021019.792,Gravesend (West)
19-Aug,36047030400,3030400,14527,10780,25307,Brooklyn,5021019.792,Gravesend (West)
21-Aug,36047030400,3030400,3836,20980,24816,Brooklyn,5021019.792,Gravesend (West)
19-May,36047030500,3030500,10787,125107,135894,Brooklyn,3478044.436,Crown Heights (North)
21-May,36047030500,3030500,11319,79563,90882,Brooklyn,3478044.436,Crown Heights (North)
19-Jun,36047030500,3030500,2669,37116,39785,Brooklyn,3478044.436,Crown Heights (North)
21-Jun,36047030500,3030500,4808,85919,90727,Brooklyn,3478044.436,Crown Heights (North)
19-Jul,36047030500,3030500,9007,71914,80921,Brooklyn,3478044.436,Crown Heights (North)
21-Jul,36047030500,3030500,13787,41454,55241,Brooklyn,3478044.436,Crown Heights (North)
19-Aug,36047030500,3030500,4829,59096,63925,Brooklyn,3478044.436,Crown Heights (North)
21-Aug,36047030500,3030500,19169,18509,37678,Brooklyn,3478044.436,Crown Heights (North)
19-May,36047030600,3030600,12983,69530,82513,Brooklyn,2084709.653,Gravesend (South)
21-May,36047030600,3030600,6798,55258,62056,Brooklyn,2084709.653,Gravesend (South)
19-Jun,36047030600,3030600,4812,31853,36665,Brooklyn,2084709.653,Gravesend (South)
21-Jun,36047030600,3030600,16590,82039,98629,Brooklyn,2084709.653,Gravesend (South)
19-Jul,36047030600,3030600,1362,96928,98290,Brooklyn,2084709.653,Gravesend (South)
21-Jul,36047030600,3030600,10856,111017,121873,Brooklyn,2084709.653,Gravesend (South)
19-Aug,36047030600,3030600,7154,56692,63846,Brooklyn,2084709.653,Gravesend (South)
21-Aug,36047030600,3030600,8697,105128,113825,Brooklyn,2084709.653,Gravesend (South)
19-May,36047030700,3030700,7527,118121,125648,Brooklyn,2868056.479,Crown Heights (North)
21-May,36047030700,3030700,13906,109627,123533,Brooklyn,2868056.479,Crown Heights (North)
19-Jun,36047030700,3030700,14308,24768,39076,Brooklyn,2868056.479,Crown Heights (North)
21-Jun,36047030700,3030700,12389,114610,126999,Brooklyn,2868056.479,Crown Heights (North)
19-Jul,36047030700,3030700,11012,11890,22902,Brooklyn,2868056.479,Crown Heights (North)
21-Jul,36047030700,3030700,7290,61839,69129,Brooklyn,2868056.479,Crown Heights (North)
19-Aug,36047030700,3030700,11336,89093,100429,Brooklyn,2868056.479,Crown Heights (North)
21-Aug,36047030700,3030700,4062,89544,93606,Brooklyn,2868056.479,Crown Heights (North)
19-May,36047030800,3030800,9785,19667,29452,Brooklyn,7196385.34,Gravesend (South)
21-May,36047030800,3030800,10098,109030,119128,Brooklyn,7196385.34,Gravesend (South)
19-Jun,36047030800,3030800,7707,73576,81283,Brooklyn,7196385.34,Gravesend (South)
21-Jun,36047030800,3030800,8455,14104,22559,Brooklyn,7196385.34,Gravesend (South)
19-Jul,36047030800,3030800,19132,60787,79919,Brooklyn,7196385.34,Gravesend (South)
21-Jul,36047030800,3030800,10910,123822,134732,Brooklyn,7196385.34,Gravesend (South)
19-Aug,36047030800,3030800,11679,49590,61269,Brooklyn,7196385.34,Gravesend (South)
21-Aug,36047030800,3030800,6287,92459,98746,Brooklyn,7196385.34,Gravesend (South)
19-May,36047030900,3030900,8806,83584,92390,Brooklyn,1627454.737,Crown Heights (North)
21-May,36047030900,3030900,7972,52951,60923,Brooklyn,1627454.737,Crown Heights (North)
19-Jun,36047030900,3030900,12811,152642,165453,Brooklyn,1627454.737,Crown Heights (North)
21-Jun,36047030900,3030900,11275,10914,22189,Brooklyn,1627454.737,Crown Heights (North)
19-Jul,36047030900,3030900,2700,96651,99351,Brooklyn,1627454.737,Crown Heights (North)
21-Jul,36047030900,3030900,6813,88681,95494,Brooklyn,1627454.737,Crown Heights (North)
19-Aug,36047030900,3030900,8768,43088,51856,Brooklyn,1627454.737,Crown Heights (North)
21-Aug,36047030900,3030900,6306,73523,79829,Brooklyn,1627454.737,Crown Heights (North)
19-May,36047031100,3031100,10190,31075,41265,Brooklyn,1632165.338,Crown Heights (North)
21-May,36047031100,3031100,14934,70991,85925,Brooklyn,1632165.338,Crown Heights (North)
19-Jun,36047031100,3031100,12202,113988,126190,Brooklyn,1632165.338,Crown Heights (North)
21-Jun,36047031100,3031100,5340,112950,118290,Brooklyn,1632165.338,Crown Heights (North)
19-Jul,36047031100,3031100,11849,51731,63580,Brooklyn,1632165.338,Crown Heights (North)
21-Jul,36047031100,3031100,13556,47930,61486,Brooklyn,1632165.338,Crown Heights (North)
19-Aug,36047031100,3031100,15219,12942,28161,Brooklyn,1632165.338,Crown Heights (North)
21-Aug,36047031100,3031100,19018,94888,113906,Brooklyn,1632165.338,Crown Heights (North)
19-May,36047031300,3031300,3529,104202,107731,Brooklyn,1876205.473,Crown Heights (North)
21-May,36047031300,3031300,19824,9247,29071,Brooklyn,1876205.473,Crown Heights (North)
19-Jun,36047031300,3031300,5602,148599,154201,Brooklyn,1876205.473,Crown Heights (North)
21-Jun,36047031300,3031300,15112,29292,44404,Brooklyn,1876205.473,Crown Heights (North)
19-Jul,36047031300,3031300,5888,77171,83059,Brooklyn,1876205.473,Crown Heights (North)
21-Jul,36047031300,3031300,9121,28214,37335,Brooklyn,1876205.473,Crown Heights (North)
19-Aug,36047031300,3031300,10174,9322,19496,Brooklyn,1876205.473,Crown Heights (North)
21-Aug,36047031300,3031300,8585,95400,103985,Brooklyn,1876205.473,Crown Heights (North)
19-May,36047031401,3031401,5848,96466,102314,Brooklyn,4719371.294,Gravesend (South)
21-May,36047031401,3031401,8517,49313,57830,Brooklyn,4719371.294,Gravesend (South)
19-Jun,36047031401,3031401,9127,92271,101398,Brooklyn,4719371.294,Gravesend (South)
21-Jun,36047031401,3031401,4225,83949,88174,Brooklyn,4719371.294,Gravesend (South)
19-Jul,36047031401,3031401,7827,104515,112342,Brooklyn,4719371.294,Gravesend (South)
21-Jul,36047031401,3031401,4213,47527,51740,Brooklyn,4719371.294,Gravesend (South)
19-Aug,36047031401,3031401,8269,80331,88600,Brooklyn,4719371.294,Gravesend (South)
21-Aug,36047031401,3031401,14478,124317,138795,Brooklyn,4719371.294,Gravesend (South)
19-May,36047031402,3031402,11729,51990,63719,Brooklyn,4222370.833,Calvert Vaux Park
21-May,36047031402,3031402,5344,52526,57870,Brooklyn,4222370.833,Calvert Vaux Park
19-Jun,36047031402,3031402,0,117516,117516,Brooklyn,4222370.833,Calvert Vaux Park
21-Jun,36047031402,3031402,14712,106058,120770,Brooklyn,4222370.833,Calvert Vaux Park
19-Jul,36047031402,3031402,12287,71,12358,Brooklyn,4222370.833,Calvert Vaux Park
21-Jul,36047031402,3031402,7344,45291,52635,Brooklyn,4222370.833,Calvert Vaux Park
19-Aug,36047031402,3031402,1608,108186,109794,Brooklyn,4222370.833,Calvert Vaux Park
21-Aug,36047031402,3031402,4607,22982,27589,Brooklyn,4222370.833,Calvert Vaux Park
19-May,36047031500,3031500,7064,71,7135,Brooklyn,1940364.932,Crown Heights (North)
21-May,36047031500,3031500,7735,74442,82177,Brooklyn,1940364.932,Crown Heights (North)
19-Jun,36047031500,3031500,2459,109630,112089,Brooklyn,1940364.932,Crown Heights (North)
21-Jun,36047031500,3031500,14045,39445,53490,Brooklyn,1940364.932,Crown Heights (North)
19-Jul,36047031500,3031500,12998,95423,108421,Brooklyn,1940364.932,Crown Heights (North)
21-Jul,36047031500,3031500,2615,76481,79096,Brooklyn,1940364.932,Crown Heights (North)
19-Aug,36047031500,3031500,7913,60510,68423,Brooklyn,1940364.932,Crown Heights (North)
21-Aug,36047031500,3031500,3738,97953,101691,Brooklyn,1940364.932,Crown Heights (North)
19-May,36047031701,3031701,16059,89265,105324,Brooklyn,1504294.033,Crown Heights (North)
21-May,36047031701,3031701,7018,57202,64220,Brooklyn,1504294.033,Crown Heights (North)
19-Jun,36047031701,3031701,16358,57919,74277,Brooklyn,1504294.033,Crown Heights (North)
21-Jun,36047031701,3031701,11806,67554,79360,Brooklyn,1504294.033,Crown Heights (North)
19-Jul,36047031701,3031701,6569,30582,37151,Brooklyn,1504294.033,Crown Heights (North)
21-Jul,36047031701,3031701,0,151387,151387,Brooklyn,1504294.033,Crown Heights (North)
19-Aug,36047031701,3031701,7504,72735,80239,Brooklyn,1504294.033,Crown Heights (North)
21-Aug,36047031701,3031701,10875,67333,78208,Brooklyn,1504294.033,Crown Heights (North)
19-May,36047031702,3031702,8828,82427,91255,Brooklyn,1500336.7,Crown Heights (North)
21-May,36047031702,3031702,12836,34106,46942,Brooklyn,1500336.7,Crown Heights (North)
19-Jun,36047031702,3031702,17968,88290,106258,Brooklyn,1500336.7,Crown Heights (North)
21-Jun,36047031702,3031702,2530,98473,101003,Brooklyn,1500336.7,Crown Heights (North)
19-Jul,36047031702,3031702,10651,11860,22511,Brooklyn,1500336.7,Crown Heights (North)
21-Jul,36047031702,3031702,230,113676,113906,Brooklyn,1500336.7,Crown Heights (North)
19-Aug,36047031702,3031702,4100,20112,24212,Brooklyn,1500336.7,Crown Heights (North)
21-Aug,36047031702,3031702,9358,55905,65263,Brooklyn,1500336.7,Crown Heights (North)
19-May,36047031900,3031900,7699,87976,95675,Brooklyn,1631610.709,Crown Heights (South)
21-May,36047031900,3031900,12615,93062,105677,Brooklyn,1631610.709,Crown Heights (South)
19-Jun,36047031900,3031900,7796,33841,41637,Brooklyn,1631610.709,Crown Heights (South)
21-Jun,36047031900,3031900,1779,53519,55298,Brooklyn,1631610.709,Crown Heights (South)
19-Jul,36047031900,3031900,9120,97299,106419,Brooklyn,1631610.709,Crown Heights (South)
21-Jul,36047031900,3031900,5807,46098,51905,Brooklyn,1631610.709,Crown Heights (South)
19-Aug,36047031900,3031900,577,65096,65673,Brooklyn,1631610.709,Crown Heights (South)
21-Aug,36047031900,3031900,6632,69538,76170,Brooklyn,1631610.709,Crown Heights (South)
19-May,36047032100,3032100,10864,79058,89922,Brooklyn,1724842.161,Crown Heights (South)
21-May,36047032100,3032100,9023,143303,152326,Brooklyn,1724842.161,Crown Heights (South)
19-Jun,36047032100,3032100,10997,70780,81777,Brooklyn,1724842.161,Crown Heights (South)
21-Jun,36047032100,3032100,8005,75901,83906,Brooklyn,1724842.161,Crown Heights (South)
19-Jul,36047032100,3032100,5047,106294,111341,Brooklyn,1724842.161,Crown Heights (South)
21-Jul,36047032100,3032100,12751,64302,77053,Brooklyn,1724842.161,Crown Heights (South)
19-Aug,36047032100,3032100,13347,71,13418,Brooklyn,1724842.161,Crown Heights (South)
21-Aug,36047032100,3032100,11052,63785,74837,Brooklyn,1724842.161,Crown Heights (South)
19-May,36047032300,3032300,5455,41163,46618,Brooklyn,1862961.947,Crown Heights (South)
21-May,36047032300,3032300,11564,36618,48182,Brooklyn,1862961.947,Crown Heights (South)
19-Jun,36047032300,3032300,2161,153539,155700,Brooklyn,1862961.947,Crown Heights (South)
21-Jun,36047032300,3032300,994,71,1065,Brooklyn,1862961.947,Crown Heights (South)
19-Jul,36047032300,3032300,6209,72086,78295,Brooklyn,1862961.947,Crown Heights (South)
21-Jul,36047032300,3032300,5100,57730,62830,Brooklyn,1862961.947,Crown Heights (South)
19-Aug,36047032300,3032300,0,30273,30273,Brooklyn,1862961.947,Crown Heights (South)
21-Aug,36047032300,3032300,1476,77745,79221,Brooklyn,1862961.947,Crown Heights (South)
19-May,36047032500,3032500,3961,77375,81336,Brooklyn,1812069.769,Crown Heights (South)
21-May,36047032500,3032500,4536,163886,168422,Brooklyn,1812069.769,Crown Heights (South)
19-Jun,36047032500,3032500,8495,65074,73569,Brooklyn,1812069.769,Crown Heights (South)
21-Jun,36047032500,3032500,14959,155943,170902,Brooklyn,1812069.769,Crown Heights (South)
19-Jul,36047032500,3032500,3781,4928,8709,Brooklyn,1812069.769,Crown Heights (South)
21-Jul,36047032500,3032500,9604,85006,94610,Brooklyn,1812069.769,Crown Heights (South)
19-Aug,36047032500,3032500,3823,32279,36102,Brooklyn,1812069.769,Crown Heights (South)
21-Aug,36047032500,3032500,3387,83207,86594,Brooklyn,1812069.769,Crown Heights (South)
19-May,36047032600,3032600,7991,83212,91203,Brooklyn,3542648.858,Coney Island-Sea Gate
21-May,36047032600,3032600,6515,117243,123758,Brooklyn,3542648.858,Coney Island-Sea Gate
19-Jun,36047032600,3032600,22281,33354,55635,Brooklyn,3542648.858,Coney Island-Sea Gate
21-Jun,36047032600,3032600,8136,65935,74071,Brooklyn,3542648.858,Coney Island-Sea Gate
19-Jul,36047032600,3032600,2836,42165,45001,Brooklyn,3542648.858,Coney Island-Sea Gate
21-Jul,36047032600,3032600,10364,108853,119217,Brooklyn,3542648.858,Coney Island-Sea Gate
19-Aug,36047032600,3032600,9649,21942,31591,Brooklyn,3542648.858,Coney Island-Sea Gate
21-Aug,36047032600,3032600,9319,78322,87641,Brooklyn,3542648.858,Coney Island-Sea Gate
19-May,36047032800,3032800,9235,44975,54210,Brooklyn,2507369.091,Coney Island-Sea Gate
21-May,36047032800,3032800,12197,35403,47600,Brooklyn,2507369.091,Coney Island-Sea Gate
19-Jun,36047032800,3032800,17418,57740,75158,Brooklyn,2507369.091,Coney Island-Sea Gate
21-Jun,36047032800,3032800,6285,97818,104103,Brooklyn,2507369.091,Coney Island-Sea Gate
19-Jul,36047032800,3032800,7950,92904,100854,Brooklyn,2507369.091,Coney Island-Sea Gate
21-Jul,36047032800,3032800,8276,108327,116603,Brooklyn,2507369.091,Coney Island-Sea Gate
19-Aug,36047032800,3032800,5220,40169,45389,Brooklyn,2507369.091,Coney Island-Sea Gate
21-Aug,36047032800,3032800,9470,122104,131574,Brooklyn,2507369.091,Coney Island-Sea Gate
19-May,36047032900,3032900,15617,27897,43514,Brooklyn,1683542.599,Prospect Lefferts Gardens-Wingate
21-May,36047032900,3032900,7106,44118,51224,Brooklyn,1683542.599,Prospect Lefferts Gardens-Wingate
19-Jun,36047032900,3032900,9280,32781,42061,Brooklyn,1683542.599,Prospect Lefferts Gardens-Wingate
21-Jun,36047032900,3032900,16063,64686,80749,Brooklyn,1683542.599,Prospect Lefferts Gardens-Wingate
19-Jul,36047032900,3032900,3417,69104,72521,Brooklyn,1683542.599,Prospect Lefferts Gardens-Wingate
21-Jul,36047032900,3032900,11870,125567,137437,Brooklyn,1683542.599,Prospect Lefferts Gardens-Wingate
19-Aug,36047032900,3032900,11416,18955,30371,Brooklyn,1683542.599,Prospect Lefferts Gardens-Wingate
21-Aug,36047032900,3032900,13297,186009,199306,Brooklyn,1683542.599,Prospect Lefferts Gardens-Wingate
19-May,36047033000,3033000,11650,71,11721,Brooklyn,3866465.549,Coney Island-Sea Gate
21-May,36047033000,3033000,0,9895,9895,Brooklyn,3866465.549,Coney Island-Sea Gate
19-Jun,36047033000,3033000,895,68536,69431,Brooklyn,3866465.549,Coney Island-Sea Gate
21-Jun,36047033000,3033000,7398,88076,95474,Brooklyn,3866465.549,Coney Island-Sea Gate
19-Jul,36047033000,3033000,10991,140404,151395,Brooklyn,3866465.549,Coney Island-Sea Gate
21-Jul,36047033000,3033000,2728,73367,76095,Brooklyn,3866465.549,Coney Island-Sea Gate
19-Aug,36047033000,3033000,4625,31542,36167,Brooklyn,3866465.549,Coney Island-Sea Gate
21-Aug,36047033000,3033000,5202,58464,63666,Brooklyn,3866465.549,Coney Island-Sea Gate
19-May,36047033100,3033100,5527,174996,180523,Brooklyn,1533546.83,Crown Heights (South)
21-May,36047033100,3033100,2753,44917,47670,Brooklyn,1533546.83,Crown Heights (South)
19-Jun,36047033100,3033100,2995,124013,127008,Brooklyn,1533546.83,Crown Heights (South)
21-Jun,36047033100,3033100,13593,54579,68172,Brooklyn,1533546.83,Crown Heights (South)
19-Jul,36047033100,3033100,13869,65171,79040,Brooklyn,1533546.83,Crown Heights (South)
21-Jul,36047033100,3033100,6218,38523,44741,Brooklyn,1533546.83,Crown Heights (South)
19-Aug,36047033100,3033100,8878,60419,69297,Brooklyn,1533546.83,Crown Heights (South)
21-Aug,36047033100,3033100,11829,78261,90090,Brooklyn,1533546.83,Crown Heights (South)
19-May,36047033300,3033300,17528,43943,61471,Brooklyn,2005663.044,Crown Heights (South)
21-May,36047033300,3033300,9435,127938,137373,Brooklyn,2005663.044,Crown Heights (South)
19-Jun,36047033300,3033300,12145,13378,25523,Brooklyn,2005663.044,Crown Heights (South)
21-Jun,36047033300,3033300,11630,73449,85079,Brooklyn,2005663.044,Crown Heights (South)
19-Jul,36047033300,3033300,10733,59826,70559,Brooklyn,2005663.044,Crown Heights (South)
21-Jul,36047033300,3033300,6399,74810,81209,Brooklyn,2005663.044,Crown Heights (South)
19-Aug,36047033300,3033300,19211,56620,75831,Brooklyn,2005663.044,Crown Heights (South)
21-Aug,36047033300,3033300,6663,27894,34557,Brooklyn,2005663.044,Crown Heights (South)
19-May,36047033500,3033500,0,41734,41734,Brooklyn,1944377.103,Crown Heights (South)
21-May,36047033500,3033500,12093,77962,90055,Brooklyn,1944377.103,Crown Heights (South)
19-Jun,36047033500,3033500,5423,58349,63772,Brooklyn,1944377.103,Crown Heights (South)
21-Jun,36047033500,3033500,6574,61036,67610,Brooklyn,1944377.103,Crown Heights (South)
19-Jul,36047033500,3033500,4648,146457,151105,Brooklyn,1944377.103,Crown Heights (South)
21-Jul,36047033500,3033500,14582,122726,137308,Brooklyn,1944377.103,Crown Heights (South)
19-Aug,36047033500,3033500,9798,136492,146290,Brooklyn,1944377.103,Crown Heights (South)
21-Aug,36047033500,3033500,12822,9871,22693,Brooklyn,1944377.103,Crown Heights (South)
19-May,36047033600,3033600,7991,106853,114844,Brooklyn,7312012.13,Coney Island-Sea Gate
21-May,36047033600,3033600,17442,35986,53428,Brooklyn,7312012.13,Coney Island-Sea Gate
19-Jun,36047033600,3033600,13683,35397,49080,Brooklyn,7312012.13,Coney Island-Sea Gate
21-Jun,36047033600,3033600,9630,83846,93476,Brooklyn,7312012.13,Coney Island-Sea Gate
19-Jul,36047033600,3033600,11085,71,11156,Brooklyn,7312012.13,Coney Island-Sea Gate
21-Jul,36047033600,3033600,14021,93076,107097,Brooklyn,7312012.13,Coney Island-Sea Gate
19-Aug,36047033600,3033600,9877,23760,33637,Brooklyn,7312012.13,Coney Island-Sea Gate
21-Aug,36047033600,3033600,21644,129096,150740,Brooklyn,7312012.13,Coney Island-Sea Gate
19-May,36047033701,3033701,13637,41056,54693,Brooklyn,1061778.638,Crown Heights (North)
21-May,36047033701,3033701,12939,75125,88064,Brooklyn,1061778.638,Crown Heights (North)
19-Jun,36047033701,3033701,6583,70126,76709,Brooklyn,1061778.638,Crown Heights (North)
21-Jun,36047033701,3033701,2419,96152,98571,Brooklyn,1061778.638,Crown Heights (North)
19-Jul,36047033701,3033701,4652,68699,73351,Brooklyn,1061778.638,Crown Heights (North)
21-Jul,36047033701,3033701,1530,69485,71015,Brooklyn,1061778.638,Crown Heights (North)
19-Aug,36047033701,3033701,11702,80164,91866,Brooklyn,1061778.638,Crown Heights (North)
21-Aug,36047033701,3033701,7067,91954,99021,Brooklyn,1061778.638,Crown Heights (North)
19-May,36047033702,3033702,3773,101234,105007,Brooklyn,1065103.774,Crown Heights (South)
21-May,36047033702,3033702,8847,41094,49941,Brooklyn,1065103.774,Crown Heights (South)
19-Jun,36047033702,3033702,9478,38051,47529,Brooklyn,1065103.774,Crown Heights (South)
21-Jun,36047033702,3033702,8861,65405,74266,Brooklyn,1065103.774,Crown Heights (South)
19-Jul,36047033702,3033702,10311,70730,81041,Brooklyn,1065103.774,Crown Heights (South)
21-Jul,36047033702,3033702,7013,111294,118307,Brooklyn,1065103.774,Crown Heights (South)
19-Aug,36047033702,3033702,16537,104782,121319,Brooklyn,1065103.774,Crown Heights (South)
21-Aug,36047033702,3033702,20247,51717,71964,Brooklyn,1065103.774,Crown Heights (South)
19-May,36047033900,3033900,12570,76931,89501,Brooklyn,1945657.829,Crown Heights (North)
21-May,36047033900,3033900,12391,65360,77751,Brooklyn,1945657.829,Crown Heights (North)
19-Jun,36047033900,3033900,7004,139065,146069,Brooklyn,1945657.829,Crown Heights (North)
21-Jun,36047033900,3033900,8358,71779,80137,Brooklyn,1945657.829,Crown Heights (North)
19-Jul,36047033900,3033900,11472,103385,114857,Brooklyn,1945657.829,Crown Heights (North)
21-Jul,36047033900,3033900,0,66841,66841,Brooklyn,1945657.829,Crown Heights (North)
19-Aug,36047033900,3033900,12886,75821,88707,Brooklyn,1945657.829,Crown Heights (North)
21-Aug,36047033900,3033900,9943,95261,105204,Brooklyn,1945657.829,Crown Heights (North)
19-May,36047034000,3034000,0,59902,59902,Brooklyn,1419227.539,Coney Island-Sea Gate
21-May,36047034000,3034000,8817,49403,58220,Brooklyn,1419227.539,Coney Island-Sea Gate
19-Jun,36047034000,3034000,7011,156691,163702,Brooklyn,1419227.539,Coney Island-Sea Gate
21-Jun,36047034000,3034000,8115,71,8186,Brooklyn,1419227.539,Coney Island-Sea Gate
19-Jul,36047034000,3034000,9239,75991,85230,Brooklyn,1419227.539,Coney Island-Sea Gate
21-Jul,36047034000,3034000,11424,117216,128640,Brooklyn,1419227.539,Coney Island-Sea Gate
19-Aug,36047034000,3034000,5622,60938,66560,Brooklyn,1419227.539,Coney Island-Sea Gate
21-Aug,36047034000,3034000,0,6500,6500,Brooklyn,1419227.539,Coney Island-Sea Gate
19-May,36047034100,3034100,3644,84592,88236,Brooklyn,1504308.063,Crown Heights (North)
21-May,36047034100,3034100,6015,93754,99769,Brooklyn,1504308.063,Crown Heights (North)
19-Jun,36047034100,3034100,9739,116857,126596,Brooklyn,1504308.063,Crown Heights (North)
21-Jun,36047034100,3034100,14498,69043,83541,Brooklyn,1504308.063,Crown Heights (North)
19-Jul,36047034100,3034100,12963,45910,58873,Brooklyn,1504308.063,Crown Heights (North)
21-Jul,36047034100,3034100,11435,94752,106187,Brooklyn,1504308.063,Crown Heights (North)
19-Aug,36047034100,3034100,11545,37550,49095,Brooklyn,1504308.063,Crown Heights (North)
21-Aug,36047034100,3034100,6010,123381,129391,Brooklyn,1504308.063,Crown Heights (North)
19-May,36047034200,3034200,10329,10762,21091,Brooklyn,2475181.592,Coney Island-Sea Gate
21-May,36047034200,3034200,5836,51755,57591,Brooklyn,2475181.592,Coney Island-Sea Gate
19-Jun,36047034200,3034200,131,88677,88808,Brooklyn,2475181.592,Coney Island-Sea Gate
21-Jun,36047034200,3034200,9770,56217,65987,Brooklyn,2475181.592,Coney Island-Sea Gate
19-Jul,36047034200,3034200,10915,35278,46193,Brooklyn,2475181.592,Coney Island-Sea Gate
21-Jul,36047034200,3034200,9891,22117,32008,Brooklyn,2475181.592,Coney Island-Sea Gate
19-Aug,36047034200,3034200,3037,24224,27261,Brooklyn,2475181.592,Coney Island-Sea Gate
21-Aug,36047034200,3034200,71,149600,149671,Brooklyn,2475181.592,Coney Island-Sea Gate
19-May,36047034300,3034300,9331,6273,15604,Brooklyn,1745165.905,Crown Heights (North)
21-May,36047034300,3034300,16665,22121,38786,Brooklyn,1745165.905,Crown Heights (North)
19-Jun,36047034300,3034300,3338,36909,40247,Brooklyn,1745165.905,Crown Heights (North)
21-Jun,36047034300,3034300,7754,101672,109426,Brooklyn,1745165.905,Crown Heights (North)
19-Jul,36047034300,3034300,1531,72169,73700,Brooklyn,1745165.905,Crown Heights (North)
21-Jul,36047034300,3034300,10745,8507,19252,Brooklyn,1745165.905,Crown Heights (North)
19-Aug,36047034300,3034300,5168,36858,42026,Brooklyn,1745165.905,Crown Heights (North)
21-Aug,36047034300,3034300,5970,168344,174314,Brooklyn,1745165.905,Crown Heights (North)
19-May,36047034500,3034500,10780,138595,149375,Brooklyn,1759935.575,Crown Heights (North)
21-May,36047034500,3034500,14484,59594,74078,Brooklyn,1759935.575,Crown Heights (North)
19-Jun,36047034500,3034500,11083,4969,16052,Brooklyn,1759935.575,Crown Heights (North)
21-Jun,36047034500,3034500,9586,67732,77318,Brooklyn,1759935.575,Crown Heights (North)
19-Jul,36047034500,3034500,0,131561,131561,Brooklyn,1759935.575,Crown Heights (North)
21-Jul,36047034500,3034500,15794,81133,96927,Brooklyn,1759935.575,Crown Heights (North)
19-Aug,36047034500,3034500,9281,74030,83311,Brooklyn,1759935.575,Crown Heights (North)
21-Aug,36047034500,3034500,5614,63459,69073,Brooklyn,1759935.575,Crown Heights (North)
19-May,36047034700,3034700,13628,68628,82256,Brooklyn,1505056.72,Crown Heights (North)
21-May,36047034700,3034700,12642,52775,65417,Brooklyn,1505056.72,Crown Heights (North)
19-Jun,36047034700,3034700,11193,42069,53262,Brooklyn,1505056.72,Crown Heights (North)
21-Jun,36047034700,3034700,10908,48181,59089,Brooklyn,1505056.72,Crown Heights (North)
19-Jul,36047034700,3034700,13366,63057,76423,Brooklyn,1505056.72,Crown Heights (North)
21-Jul,36047034700,3034700,10178,116554,126732,Brooklyn,1505056.72,Crown Heights (North)
19-Aug,36047034700,3034700,12806,49213,62019,Brooklyn,1505056.72,Crown Heights (North)
21-Aug,36047034700,3034700,15191,88003,103194,Brooklyn,1505056.72,Crown Heights (North)
19-May,36047034800,3034800,11603,92906,104509,Brooklyn,6985056.381,Coney Island-Sea Gate
21-May,36047034800,3034800,6796,22543,29339,Brooklyn,6985056.381,Coney Island-Sea Gate
19-Jun,36047034800,3034800,19098,85774,104872,Brooklyn,6985056.381,Coney Island-Sea Gate
21-Jun,36047034800,3034800,1873,62829,64702,Brooklyn,6985056.381,Coney Island-Sea Gate
19-Jul,36047034800,3034800,4694,59686,64380,Brooklyn,6985056.381,Coney Island-Sea Gate
21-Jul,36047034800,3034800,11832,43597,55429,Brooklyn,6985056.381,Coney Island-Sea Gate
19-Aug,36047034800,3034800,5060,36335,41395,Brooklyn,6985056.381,Coney Island-Sea Gate
21-Aug,36047034800,3034800,2505,57976,60481,Brooklyn,6985056.381,Coney Island-Sea Gate
19-May,36047034901,3034901,9252,71412,80664,Brooklyn,752964.1237,Crown Heights (North)
21-May,36047034901,3034901,5828,44506,50334,Brooklyn,752964.1237,Crown Heights (North)
19-Jun,36047034901,3034901,9349,94206,103555,Brooklyn,752964.1237,Crown Heights (North)
21-Jun,36047034901,3034901,3030,14777,17807,Brooklyn,752964.1237,Crown Heights (North)
19-Jul,36047034901,3034901,5171,119071,124242,Brooklyn,752964.1237,Crown Heights (North)
21-Jul,36047034901,3034901,8888,44861,53749,Brooklyn,752964.1237,Crown Heights (North)
19-Aug,36047034901,3034901,6705,62642,69347,Brooklyn,752964.1237,Crown Heights (North)
21-Aug,36047034901,3034901,4877,71,4948,Brooklyn,752964.1237,Crown Heights (North)
19-May,36047034902,3034902,16081,1261,17342,Brooklyn,1003908.528,Crown Heights (South)
21-May,36047034902,3034902,3414,41701,45115,Brooklyn,1003908.528,Crown Heights (South)
19-Jun,36047034902,3034902,0,84965,84965,Brooklyn,1003908.528,Crown Heights (South)
21-Jun,36047034902,3034902,15680,26192,41872,Brooklyn,1003908.528,Crown Heights (South)
19-Jul,36047034902,3034902,0,132896,132896,Brooklyn,1003908.528,Crown Heights (South)
21-Jul,36047034902,3034902,11558,89529,101087,Brooklyn,1003908.528,Crown Heights (South)
19-Aug,36047034902,3034902,9987,43808,53795,Brooklyn,1003908.528,Crown Heights (South)
21-Aug,36047034902,3034902,5171,74505,79676,Brooklyn,1003908.528,Crown Heights (South)
19-May,36047035000,3035000,0,29944,29944,Brooklyn,2123245.445,Coney Island-Sea Gate
21-May,36047035000,3035000,10838,61613,72451,Brooklyn,2123245.445,Coney Island-Sea Gate
19-Jun,36047035000,3035000,1402,28849,30251,Brooklyn,2123245.445,Coney Island-Sea Gate
21-Jun,36047035000,3035000,4065,54000,58065,Brooklyn,2123245.445,Coney Island-Sea Gate
19-Jul,36047035000,3035000,9025,36917,45942,Brooklyn,2123245.445,Coney Island-Sea Gate
21-Jul,36047035000,3035000,8458,71340,79798,Brooklyn,2123245.445,Coney Island-Sea Gate
19-Aug,36047035000,3035000,12186,92179,104365,Brooklyn,2123245.445,Coney Island-Sea Gate
21-Aug,36047035000,3035000,9106,133702,142808,Brooklyn,2123245.445,Coney Island-Sea Gate
19-May,36047035101,3035101,7292,56045,63337,Brooklyn,752633.3383,Crown Heights (North)
21-May,36047035101,3035101,11811,22862,34673,Brooklyn,752633.3383,Crown Heights (North)
19-Jun,36047035101,3035101,10694,60139,70833,Brooklyn,752633.3383,Crown Heights (North)
21-Jun,36047035101,3035101,4901,119418,124319,Brooklyn,752633.3383,Crown Heights (North)
19-Jul,36047035101,3035101,6423,5967,12390,Brooklyn,752633.3383,Crown Heights (North)
21-Jul,36047035101,3035101,804,100144,100948,Brooklyn,752633.3383,Crown Heights (North)
19-Aug,36047035101,3035101,17344,53287,70631,Brooklyn,752633.3383,Crown Heights (North)
21-Aug,36047035101,3035101,12064,119106,131170,Brooklyn,752633.3383,Crown Heights (North)
19-May,36047035102,3035102,8043,107517,115560,Brooklyn,1002516.393,Crown Heights (South)
21-May,36047035102,3035102,7945,142499,150444,Brooklyn,1002516.393,Crown Heights (South)
19-Jun,36047035102,3035102,0,148617,148617,Brooklyn,1002516.393,Crown Heights (South)
21-Jun,36047035102,3035102,4939,45626,50565,Brooklyn,1002516.393,Crown Heights (South)
19-Jul,36047035102,3035102,11547,70760,82307,Brooklyn,1002516.393,Crown Heights (South)
21-Jul,36047035102,3035102,12598,113491,126089,Brooklyn,1002516.393,Crown Heights (South)
19-Aug,36047035102,3035102,17986,94618,112604,Brooklyn,1002516.393,Crown Heights (South)
21-Aug,36047035102,3035102,2057,26127,28184,Brooklyn,1002516.393,Crown Heights (South)
19-May,36047035200,3035200,3010,100085,103095,Brooklyn,10662098.73,Coney Island-Sea Gate
21-May,36047035200,3035200,10357,100691,111048,Brooklyn,10662098.73,Coney Island-Sea Gate
19-Jun,36047035200,3035200,6344,60593,66937,Brooklyn,10662098.73,Coney Island-Sea Gate
21-Jun,36047035200,3035200,2631,56509,59140,Brooklyn,10662098.73,Coney Island-Sea Gate
19-Jul,36047035200,3035200,11766,83406,95172,Brooklyn,10662098.73,Coney Island-Sea Gate
21-Jul,36047035200,3035200,12022,69614,81636,Brooklyn,10662098.73,Coney Island-Sea Gate
19-Aug,36047035200,3035200,9666,100931,110597,Brooklyn,10662098.73,Coney Island-Sea Gate
21-Aug,36047035200,3035200,6339,52618,58957,Brooklyn,10662098.73,Coney Island-Sea Gate
19-May,36047035301,3035301,7849,90608,98457,Brooklyn,752264.8879,Crown Heights (North)
21-May,36047035301,3035301,0,30107,30107,Brooklyn,752264.8879,Crown Heights (North)
19-Jun,36047035301,3035301,4649,34070,38719,Brooklyn,752264.8879,Crown Heights (North)
21-Jun,36047035301,3035301,10954,126229,137183,Brooklyn,752264.8879,Crown Heights (North)
19-Jul,36047035301,3035301,10874,127702,138576,Brooklyn,752264.8879,Crown Heights (North)
21-Jul,36047035301,3035301,6661,33829,40490,Brooklyn,752264.8879,Crown Heights (North)
19-Aug,36047035301,3035301,5360,6443,11803,Brooklyn,752264.8879,Crown Heights (North)
21-Aug,36047035301,3035301,3612,70752,74364,Brooklyn,752264.8879,Crown Heights (North)
19-May,36047035302,3035302,8999,88325,97324,Brooklyn,1003190.912,Crown Heights (South)
21-May,36047035302,3035302,5090,55049,60139,Brooklyn,1003190.912,Crown Heights (South)
19-Jun,36047035302,3035302,13418,157627,171045,Brooklyn,1003190.912,Crown Heights (South)
21-Jun,36047035302,3035302,4044,52253,56297,Brooklyn,1003190.912,Crown Heights (South)
19-Jul,36047035302,3035302,4913,27471,32384,Brooklyn,1003190.912,Crown Heights (South)
21-Jul,36047035302,3035302,7289,68039,75328,Brooklyn,1003190.912,Crown Heights (South)
19-Aug,36047035302,3035302,16258,132052,148310,Brooklyn,1003190.912,Crown Heights (South)
21-Aug,36047035302,3035302,9984,60846,70830,Brooklyn,1003190.912,Crown Heights (South)
19-May,36047035500,3035500,5857,74833,80690,Brooklyn,1485518.381,Crown Heights (South)
21-May,36047035500,3035500,12986,101374,114360,Brooklyn,1485518.381,Crown Heights (South)
19-Jun,36047035500,3035500,4707,60443,65150,Brooklyn,1485518.381,Crown Heights (South)
21-Jun,36047035500,3035500,8601,146521,155122,Brooklyn,1485518.381,Crown Heights (South)
19-Jul,36047035500,3035500,812,100483,101295,Brooklyn,1485518.381,Crown Heights (South)
21-Jul,36047035500,3035500,0,112226,112226,Brooklyn,1485518.381,Crown Heights (South)
19-Aug,36047035500,3035500,4581,41718,46299,Brooklyn,1485518.381,Crown Heights (South)
21-Aug,36047035500,3035500,4267,69069,73336,Brooklyn,1485518.381,Crown Heights (South)
19-May,36047035601,3035601,10402,59764,70166,Brooklyn,719519.8919,Coney Island-Sea Gate
21-May,36047035601,3035601,13204,34245,47449,Brooklyn,719519.8919,Coney Island-Sea Gate
19-Jun,36047035601,3035601,1961,189835,191796,Brooklyn,719519.8919,Coney Island-Sea Gate
21-Jun,36047035601,3035601,4827,108344,113171,Brooklyn,719519.8919,Coney Island-Sea Gate
19-Jul,36047035601,3035601,9588,121115,130703,Brooklyn,719519.8919,Coney Island-Sea Gate
21-Jul,36047035601,3035601,13514,123158,136672,Brooklyn,719519.8919,Coney Island-Sea Gate
19-Aug,36047035601,3035601,14704,132381,147085,Brooklyn,719519.8919,Coney Island-Sea Gate
21-Aug,36047035601,3035601,11574,119261,130835,Brooklyn,719519.8919,Coney Island-Sea Gate
19-May,36047035602,3035602,12122,101058,113180,Brooklyn,1843967.138,Coney Island-Sea Gate
21-May,36047035602,3035602,4681,56318,60999,Brooklyn,1843967.138,Coney Island-Sea Gate
19-Jun,36047035602,3035602,13958,69695,83653,Brooklyn,1843967.138,Coney Island-Sea Gate
21-Jun,36047035602,3035602,7849,98505,106354,Brooklyn,1843967.138,Coney Island-Sea Gate
19-Jul,36047035602,3035602,13355,32001,45356,Brooklyn,1843967.138,Coney Island-Sea Gate
21-Jul,36047035602,3035602,8762,1879,10641,Brooklyn,1843967.138,Coney Island-Sea Gate
19-Aug,36047035602,3035602,1157,91448,92605,Brooklyn,1843967.138,Coney Island-Sea Gate
21-Aug,36047035602,3035602,7026,38582,45608,Brooklyn,1843967.138,Coney Island-Sea Gate
19-May,36047035701,3035701,10982,8769,19751,Brooklyn,750004.9026,Crown Heights (North)
21-May,36047035701,3035701,4745,55697,60442,Brooklyn,750004.9026,Crown Heights (North)
19-Jun,36047035701,3035701,17566,124895,142461,Brooklyn,750004.9026,Crown Heights (North)
21-Jun,36047035701,3035701,9048,63906,72954,Brooklyn,750004.9026,Crown Heights (North)
19-Jul,36047035701,3035701,6556,121711,128267,Brooklyn,750004.9026,Crown Heights (North)
21-Jul,36047035701,3035701,12385,115362,127747,Brooklyn,750004.9026,Crown Heights (North)
19-Aug,36047035701,3035701,10889,149008,159897,Brooklyn,750004.9026,Crown Heights (North)
21-Aug,36047035701,3035701,0,96163,96163,Brooklyn,750004.9026,Crown Heights (North)
19-May,36047035702,3035702,8664,127846,136510,Brooklyn,1214617.175,Lincoln Terrace Park
21-May,36047035702,3035702,4100,70007,74107,Brooklyn,1214617.175,Lincoln Terrace Park
19-Jun,36047035702,3035702,1036,145014,146050,Brooklyn,1214617.175,Lincoln Terrace Park
21-Jun,36047035702,3035702,8749,107945,116694,Brooklyn,1214617.175,Lincoln Terrace Park
19-Jul,36047035702,3035702,8901,69446,78347,Brooklyn,1214617.175,Lincoln Terrace Park
21-Jul,36047035702,3035702,9433,20833,30266,Brooklyn,1214617.175,Lincoln Terrace Park
19-Aug,36047035702,3035702,10710,102665,113375,Brooklyn,1214617.175,Lincoln Terrace Park
21-Aug,36047035702,3035702,15878,82599,98477,Brooklyn,1214617.175,Lincoln Terrace Park
19-May,36047035900,3035900,16079,73963,90042,Brooklyn,1955169.233,Crown Heights (North)
21-May,36047035900,3035900,0,98841,98841,Brooklyn,1955169.233,Crown Heights (North)
19-Jun,36047035900,3035900,4105,88420,92525,Brooklyn,1955169.233,Crown Heights (North)
21-Jun,36047035900,3035900,9248,3205,12453,Brooklyn,1955169.233,Crown Heights (North)
19-Jul,36047035900,3035900,9363,89104,98467,Brooklyn,1955169.233,Crown Heights (North)
21-Jul,36047035900,3035900,1621,104026,105647,Brooklyn,1955169.233,Crown Heights (North)
19-Aug,36047035900,3035900,794,82054,82848,Brooklyn,1955169.233,Crown Heights (North)
21-Aug,36047035900,3035900,4876,90723,95599,Brooklyn,1955169.233,Crown Heights (North)
19-May,36047036001,3036001,13446,85653,99099,Brooklyn,1019097.094,Brighton Beach
21-May,36047036001,3036001,6893,56516,63409,Brooklyn,1019097.094,Brighton Beach
19-Jun,36047036001,3036001,5767,25338,31105,Brooklyn,1019097.094,Brighton Beach
21-Jun,36047036001,3036001,13905,78748,92653,Brooklyn,1019097.094,Brighton Beach
19-Jul,36047036001,3036001,341,49130,49471,Brooklyn,1019097.094,Brighton Beach
21-Jul,36047036001,3036001,2530,97780,100310,Brooklyn,1019097.094,Brighton Beach
19-Aug,36047036001,3036001,15756,137003,152759,Brooklyn,1019097.094,Brighton Beach
21-Aug,36047036001,3036001,12031,97451,109482,Brooklyn,1019097.094,Brighton Beach
19-May,36047036002,3036002,9144,96648,105792,Brooklyn,924234.9631,Brighton Beach
21-May,36047036002,3036002,13162,15253,28415,Brooklyn,924234.9631,Brighton Beach
19-Jun,36047036002,3036002,1867,73974,75841,Brooklyn,924234.9631,Brighton Beach
21-Jun,36047036002,3036002,10721,42030,52751,Brooklyn,924234.9631,Brighton Beach
19-Jul,36047036002,3036002,15656,62660,78316,Brooklyn,924234.9631,Brighton Beach
21-Jul,36047036002,3036002,5906,120276,126182,Brooklyn,924234.9631,Brighton Beach
19-Aug,36047036002,3036002,7556,36928,44484,Brooklyn,924234.9631,Brighton Beach
21-Aug,36047036002,3036002,9857,138054,147911,Brooklyn,924234.9631,Brighton Beach
19-May,36047036100,3036100,9255,129062,138317,Brooklyn,1524420.501,Ocean Hill
21-May,36047036100,3036100,18888,62935,81823,Brooklyn,1524420.501,Ocean Hill
19-Jun,36047036100,3036100,16220,70578,86798,Brooklyn,1524420.501,Ocean Hill
21-Jun,36047036100,3036100,1934,58603,60537,Brooklyn,1524420.501,Ocean Hill
19-Jul,36047036100,3036100,0,50473,50473,Brooklyn,1524420.501,Ocean Hill
21-Jul,36047036100,3036100,15033,70170,85203,Brooklyn,1524420.501,Ocean Hill
19-Aug,36047036100,3036100,4353,40820,45173,Brooklyn,1524420.501,Ocean Hill
21-Aug,36047036100,3036100,14385,81660,96045,Brooklyn,1524420.501,Ocean Hill
19-May,36047036200,3036200,6695,128481,135176,Brooklyn,1845171.643,Brighton Beach
21-May,36047036200,3036200,12961,53592,66553,Brooklyn,1845171.643,Brighton Beach
19-Jun,36047036200,3036200,13471,68969,82440,Brooklyn,1845171.643,Brighton Beach
21-Jun,36047036200,3036200,0,151437,151437,Brooklyn,1845171.643,Brighton Beach
19-Jul,36047036200,3036200,5506,110616,116122,Brooklyn,1845171.643,Brighton Beach
21-Jul,36047036200,3036200,15127,57603,72730,Brooklyn,1845171.643,Brighton Beach
19-Aug,36047036200,3036200,10501,67983,78484,Brooklyn,1845171.643,Brighton Beach
21-Aug,36047036200,3036200,14410,63668,78078,Brooklyn,1845171.643,Brighton Beach
19-May,36047036300,3036300,10237,102279,112516,Brooklyn,2786930.307,Ocean Hill
21-May,36047036300,3036300,13836,31673,45509,Brooklyn,2786930.307,Ocean Hill
19-Jun,36047036300,3036300,9029,84614,93643,Brooklyn,2786930.307,Ocean Hill
21-Jun,36047036300,3036300,8359,80378,88737,Brooklyn,2786930.307,Ocean Hill
19-Jul,36047036300,3036300,0,83667,83667,Brooklyn,2786930.307,Ocean Hill
21-Jul,36047036300,3036300,13198,164085,177283,Brooklyn,2786930.307,Ocean Hill
19-Aug,36047036300,3036300,10920,49097,60017,Brooklyn,2786930.307,Ocean Hill
21-Aug,36047036300,3036300,11318,44115,55433,Brooklyn,2786930.307,Ocean Hill
19-May,36047036400,3036400,8224,45927,54151,Brooklyn,1539580.438,Brighton Beach
21-May,36047036400,3036400,12608,133972,146580,Brooklyn,1539580.438,Brighton Beach
19-Jun,36047036400,3036400,9795,63122,72917,Brooklyn,1539580.438,Brighton Beach
21-Jun,36047036400,3036400,5800,34173,39973,Brooklyn,1539580.438,Brighton Beach
19-Jul,36047036400,3036400,11181,66249,77430,Brooklyn,1539580.438,Brighton Beach
21-Jul,36047036400,3036400,13944,129958,143902,Brooklyn,1539580.438,Brighton Beach
19-Aug,36047036400,3036400,11270,29641,40911,Brooklyn,1539580.438,Brighton Beach
21-Aug,36047036400,3036400,6923,69089,76012,Brooklyn,1539580.438,Brighton Beach
19-May,36047036501,3036501,11767,96306,108073,Brooklyn,1367343.964,Ocean Hill
21-May,36047036501,3036501,11191,105214,116405,Brooklyn,1367343.964,Ocean Hill
19-Jun,36047036501,3036501,8242,66154,74396,Brooklyn,1367343.964,Ocean Hill
21-Jun,36047036501,3036501,12490,71885,84375,Brooklyn,1367343.964,Ocean Hill
19-Jul,36047036501,3036501,13687,39535,53222,Brooklyn,1367343.964,Ocean Hill
21-Jul,36047036501,3036501,10603,140692,151295,Brooklyn,1367343.964,Ocean Hill
19-Aug,36047036501,3036501,7218,82664,89882,Brooklyn,1367343.964,Ocean Hill
21-Aug,36047036501,3036501,14378,38363,52741,Brooklyn,1367343.964,Ocean Hill
19-May,36047036900,3036900,7258,122387,129645,Brooklyn,2433755.739,Ocean Hill
21-May,36047036900,3036900,7360,47487,54847,Brooklyn,2433755.739,Ocean Hill
19-Jun,36047036900,3036900,11158,67219,78377,Brooklyn,2433755.739,Ocean Hill
21-Jun,36047036900,3036900,14545,28294,42839,Brooklyn,2433755.739,Ocean Hill
19-Jul,36047036900,3036900,2834,69912,72746,Brooklyn,2433755.739,Ocean Hill
21-Jul,36047036900,3036900,0,77991,77991,Brooklyn,2433755.739,Ocean Hill
19-Aug,36047036900,3036900,4713,78039,82752,Brooklyn,2433755.739,Ocean Hill
21-Aug,36047036900,3036900,340,24274,24614,Brooklyn,2433755.739,Ocean Hill
19-May,36047037000,3037000,13493,24799,38292,Brooklyn,3617885.986,Gravesend (South)
21-May,36047037000,3037000,2371,7882,10253,Brooklyn,3617885.986,Gravesend (South)
19-Jun,36047037000,3037000,7704,69387,77091,Brooklyn,3617885.986,Gravesend (South)
21-Jun,36047037000,3037000,13549,123815,137364,Brooklyn,3617885.986,Gravesend (South)
19-Jul,36047037000,3037000,4018,51062,55080,Brooklyn,3617885.986,Gravesend (South)
21-Jul,36047037000,3037000,16632,47928,64560,Brooklyn,3617885.986,Gravesend (South)
19-Aug,36047037000,3037000,15979,107367,123346,Brooklyn,3617885.986,Gravesend (South)
21-Aug,36047037000,3037000,4926,106132,111058,Brooklyn,3617885.986,Gravesend (South)
19-May,36047037100,3037100,10734,67481,78215,Brooklyn,2037041.341,Ocean Hill
21-May,36047037100,3037100,7851,100800,108651,Brooklyn,2037041.341,Ocean Hill
19-Jun,36047037100,3037100,4831,51113,55944,Brooklyn,2037041.341,Ocean Hill
21-Jun,36047037100,3037100,13929,88051,101980,Brooklyn,2037041.341,Ocean Hill
19-Jul,36047037100,3037100,0,53096,53096,Brooklyn,2037041.341,Ocean Hill
21-Jul,36047037100,3037100,6891,43228,50119,Brooklyn,2037041.341,Ocean Hill
19-Aug,36047037100,3037100,5956,20728,26684,Brooklyn,2037041.341,Ocean Hill
21-Aug,36047037100,3037100,8018,30368,38386,Brooklyn,2037041.341,Ocean Hill
19-May,36047037300,3037300,9189,52964,62153,Brooklyn,1838509.746,Ocean Hill
21-May,36047037300,3037300,11265,133803,145068,Brooklyn,1838509.746,Ocean Hill
19-Jun,36047037300,3037300,11408,69749,81157,Brooklyn,1838509.746,Ocean Hill
21-Jun,36047037300,3037300,7348,30080,37428,Brooklyn,1838509.746,Ocean Hill
19-Jul,36047037300,3037300,15198,78779,93977,Brooklyn,1838509.746,Ocean Hill
21-Jul,36047037300,3037300,2221,50176,52397,Brooklyn,1838509.746,Ocean Hill
19-Aug,36047037300,3037300,5893,71210,77103,Brooklyn,1838509.746,Ocean Hill
21-Aug,36047037300,3037300,5776,118236,124012,Brooklyn,1838509.746,Ocean Hill
19-May,36047037401,3037401,6958,59239,66197,Brooklyn,2422862.804,Gravesend (South)
21-May,36047037401,3037401,4357,87632,91989,Brooklyn,2422862.804,Gravesend (South)
19-Jun,36047037401,3037401,549,52024,52573,Brooklyn,2422862.804,Gravesend (South)
21-Jun,36047037401,3037401,3224,48570,51794,Brooklyn,2422862.804,Gravesend (South)
19-Jul,36047037401,3037401,0,61815,61815,Brooklyn,2422862.804,Gravesend (South)
21-Jul,36047037401,3037401,9212,73997,83209,Brooklyn,2422862.804,Gravesend (South)
19-Aug,36047037401,3037401,6481,102075,108556,Brooklyn,2422862.804,Gravesend (South)
21-Aug,36047037401,3037401,0,71,71,Brooklyn,2422862.804,Gravesend (South)
19-May,36047037402,3037402,13511,27202,40713,Brooklyn,3270016.085,Gravesend (South)
21-May,36047037402,3037402,8944,134688,143632,Brooklyn,3270016.085,Gravesend (South)
19-Jun,36047037402,3037402,6527,80584,87111,Brooklyn,3270016.085,Gravesend (South)
21-Jun,36047037402,3037402,11334,109328,120662,Brooklyn,3270016.085,Gravesend (South)
19-Jul,36047037402,3037402,8396,119517,127913,Brooklyn,3270016.085,Gravesend (South)
21-Jul,36047037402,3037402,7748,42599,50347,Brooklyn,3270016.085,Gravesend (South)
19-Aug,36047037402,3037402,4835,58267,63102,Brooklyn,3270016.085,Gravesend (South)
21-Aug,36047037402,3037402,7724,95617,103341,Brooklyn,3270016.085,Gravesend (South)
19-May,36047037500,3037500,9940,97292,107232,Brooklyn,1708659.744,Bedford-Stuyvesant (East)
21-May,36047037500,3037500,3681,71694,75375,Brooklyn,1708659.744,Bedford-Stuyvesant (East)
19-Jun,36047037500,3037500,0,107075,107075,Brooklyn,1708659.744,Bedford-Stuyvesant (East)
21-Jun,36047037500,3037500,15404,76199,91603,Brooklyn,1708659.744,Bedford-Stuyvesant (East)
19-Jul,36047037500,3037500,10022,59524,69546,Brooklyn,1708659.744,Bedford-Stuyvesant (East)
21-Jul,36047037500,3037500,7172,91378,98550,Brooklyn,1708659.744,Bedford-Stuyvesant (East)
19-Aug,36047037500,3037500,3370,82622,85992,Brooklyn,1708659.744,Bedford-Stuyvesant (East)
21-Aug,36047037500,3037500,9458,53529,62987,Brooklyn,1708659.744,Bedford-Stuyvesant (East)
19-May,36047037700,3037700,9010,120269,129279,Brooklyn,2047553.747,Bedford-Stuyvesant (East)
21-May,36047037700,3037700,11405,93648,105053,Brooklyn,2047553.747,Bedford-Stuyvesant (East)
19-Jun,36047037700,3037700,6317,72128,78445,Brooklyn,2047553.747,Bedford-Stuyvesant (East)
21-Jun,36047037700,3037700,12194,30462,42656,Brooklyn,2047553.747,Bedford-Stuyvesant (East)
19-Jul,36047037700,3037700,18263,92917,111180,Brooklyn,2047553.747,Bedford-Stuyvesant (East)
21-Jul,36047037700,3037700,6111,32048,38159,Brooklyn,2047553.747,Bedford-Stuyvesant (East)
19-Aug,36047037700,3037700,17861,87471,105332,Brooklyn,2047553.747,Bedford-Stuyvesant (East)
21-Aug,36047037700,3037700,8166,55883,64049,Brooklyn,2047553.747,Bedford-Stuyvesant (East)
19-May,36047037900,3037900,786,92716,93502,Brooklyn,1978231.312,Bedford-Stuyvesant (East)
21-May,36047037900,3037900,15386,107762,123148,Brooklyn,1978231.312,Bedford-Stuyvesant (East)
19-Jun,36047037900,3037900,7313,58668,65981,Brooklyn,1978231.312,Bedford-Stuyvesant (East)
21-Jun,36047037900,3037900,7978,50548,58526,Brooklyn,1978231.312,Bedford-Stuyvesant (East)
19-Jul,36047037900,3037900,9815,31566,41381,Brooklyn,1978231.312,Bedford-Stuyvesant (East)
21-Jul,36047037900,3037900,8476,21724,30200,Brooklyn,1978231.312,Bedford-Stuyvesant (East)
19-Aug,36047037900,3037900,4878,124727,129605,Brooklyn,1978231.312,Bedford-Stuyvesant (East)
21-Aug,36047037900,3037900,9482,91333,100815,Brooklyn,1978231.312,Bedford-Stuyvesant (East)
19-May,36047038100,3038100,12656,101282,113938,Brooklyn,2579146.091,Bedford-Stuyvesant (East)
21-May,36047038100,3038100,15597,107755,123352,Brooklyn,2579146.091,Bedford-Stuyvesant (East)
19-Jun,36047038100,3038100,254,31599,31853,Brooklyn,2579146.091,Bedford-Stuyvesant (East)
21-Jun,36047038100,3038100,10534,84146,94680,Brooklyn,2579146.091,Bedford-Stuyvesant (East)
19-Jul,36047038100,3038100,8565,65519,74084,Brooklyn,2579146.091,Bedford-Stuyvesant (East)
21-Jul,36047038100,3038100,16753,59413,76166,Brooklyn,2579146.091,Bedford-Stuyvesant (East)
19-Aug,36047038100,3038100,12093,57240,69333,Brooklyn,2579146.091,Bedford-Stuyvesant (East)
21-Aug,36047038100,3038100,5374,98420,103794,Brooklyn,2579146.091,Bedford-Stuyvesant (East)
19-May,36047038200,3038200,8155,45732,53887,Brooklyn,2524535.312,Gravesend (South)
21-May,36047038200,3038200,5141,2295,7436,Brooklyn,2524535.312,Gravesend (South)
19-Jun,36047038200,3038200,13873,108438,122311,Brooklyn,2524535.312,Gravesend (South)
21-Jun,36047038200,3038200,5088,76939,82027,Brooklyn,2524535.312,Gravesend (South)
19-Jul,36047038200,3038200,11968,99095,111063,Brooklyn,2524535.312,Gravesend (South)
21-Jul,36047038200,3038200,7448,102724,110172,Brooklyn,2524535.312,Gravesend (South)
19-Aug,36047038200,3038200,5494,127490,132984,Brooklyn,2524535.312,Gravesend (South)
21-Aug,36047038200,3038200,0,63070,63070,Brooklyn,2524535.312,Gravesend (South)
19-May,36047038300,3038300,5194,95394,100588,Brooklyn,1878496.912,Bedford-Stuyvesant (East)
21-May,36047038300,3038300,5555,46156,51711,Brooklyn,1878496.912,Bedford-Stuyvesant (East)
19-Jun,36047038300,3038300,0,33815,33815,Brooklyn,1878496.912,Bedford-Stuyvesant (East)
21-Jun,36047038300,3038300,12232,26031,38263,Brooklyn,1878496.912,Bedford-Stuyvesant (East)
19-Jul,36047038300,3038300,0,91148,91148,Brooklyn,1878496.912,Bedford-Stuyvesant (East)
21-Jul,36047038300,3038300,12,54159,54171,Brooklyn,1878496.912,Bedford-Stuyvesant (East)
19-Aug,36047038300,3038300,10461,13048,23509,Brooklyn,1878496.912,Bedford-Stuyvesant (East)
21-Aug,36047038300,3038300,9,18306,18315,Brooklyn,1878496.912,Bedford-Stuyvesant (East)
19-May,36047038500,3038500,10745,27455,38200,Brooklyn,1877794.424,Bedford-Stuyvesant (East)
21-May,36047038500,3038500,9788,26274,36062,Brooklyn,1877794.424,Bedford-Stuyvesant (East)
19-Jun,36047038500,3038500,14354,59535,73889,Brooklyn,1877794.424,Bedford-Stuyvesant (East)
21-Jun,36047038500,3038500,9452,190669,200121,Brooklyn,1877794.424,Bedford-Stuyvesant (East)
19-Jul,36047038500,3038500,11964,26436,38400,Brooklyn,1877794.424,Bedford-Stuyvesant (East)
21-Jul,36047038500,3038500,6502,80086,86588,Brooklyn,1877794.424,Bedford-Stuyvesant (East)
19-Aug,36047038500,3038500,7471,83243,90714,Brooklyn,1877794.424,Bedford-Stuyvesant (East)
21-Aug,36047038500,3038500,5756,121513,127269,Brooklyn,1877794.424,Bedford-Stuyvesant (East)
19-May,36047038600,3038600,5557,177795,183352,Brooklyn,2704671.015,Gravesend (East)-Homecrest
21-May,36047038600,3038600,17508,67829,85337,Brooklyn,2704671.015,Gravesend (East)-Homecrest
19-Jun,36047038600,3038600,13779,98913,112692,Brooklyn,2704671.015,Gravesend (East)-Homecrest
21-Jun,36047038600,3038600,9255,9289,18544,Brooklyn,2704671.015,Gravesend (East)-Homecrest
19-Jul,36047038600,3038600,7129,60526,67655,Brooklyn,2704671.015,Gravesend (East)-Homecrest
21-Jul,36047038600,3038600,2355,134931,137286,Brooklyn,2704671.015,Gravesend (East)-Homecrest
19-Aug,36047038600,3038600,2204,99397,101601,Brooklyn,2704671.015,Gravesend (East)-Homecrest
21-Aug,36047038600,3038600,11705,84366,96071,Brooklyn,2704671.015,Gravesend (East)-Homecrest
19-May,36047038800,3038800,19215,123531,142746,Brooklyn,2130565.696,Gravesend (East)-Homecrest
21-May,36047038800,3038800,6912,8162,15074,Brooklyn,2130565.696,Gravesend (East)-Homecrest
19-Jun,36047038800,3038800,13361,71,13432,Brooklyn,2130565.696,Gravesend (East)-Homecrest
21-Jun,36047038800,3038800,6126,26762,32888,Brooklyn,2130565.696,Gravesend (East)-Homecrest
19-Jul,36047038800,3038800,10583,68898,79481,Brooklyn,2130565.696,Gravesend (East)-Homecrest
21-Jul,36047038800,3038800,11749,48729,60478,Brooklyn,2130565.696,Gravesend (East)-Homecrest
19-Aug,36047038800,3038800,1474,109970,111444,Brooklyn,2130565.696,Gravesend (East)-Homecrest
21-Aug,36047038800,3038800,12199,108073,120272,Brooklyn,2130565.696,Gravesend (East)-Homecrest
19-May,36047038900,3038900,11019,58384,69403,Brooklyn,1753535.471,Bushwick (West)
21-May,36047038900,3038900,9303,97259,106562,Brooklyn,1753535.471,Bushwick (West)
19-Jun,36047038900,3038900,10230,110742,120972,Brooklyn,1753535.471,Bushwick (West)
21-Jun,36047038900,3038900,5820,74034,79854,Brooklyn,1753535.471,Bushwick (West)
19-Jul,36047038900,3038900,13930,115177,129107,Brooklyn,1753535.471,Bushwick (West)
21-Jul,36047038900,3038900,9719,65805,75524,Brooklyn,1753535.471,Bushwick (West)
19-Aug,36047038900,3038900,9786,46918,56704,Brooklyn,1753535.471,Bushwick (West)
21-Aug,36047038900,3038900,2334,128694,131028,Brooklyn,1753535.471,Bushwick (West)
19-May,36047039000,3039000,5781,193850,199631,Brooklyn,1871799.724,Gravesend (East)-Homecrest
21-May,36047039000,3039000,7171,53671,60842,Brooklyn,1871799.724,Gravesend (East)-Homecrest
19-Jun,36047039000,3039000,15511,68485,83996,Brooklyn,1871799.724,Gravesend (East)-Homecrest
21-Jun,36047039000,3039000,13760,110473,124233,Brooklyn,1871799.724,Gravesend (East)-Homecrest
19-Jul,36047039000,3039000,8065,109580,117645,Brooklyn,1871799.724,Gravesend (East)-Homecrest
21-Jul,36047039000,3039000,11222,60284,71506,Brooklyn,1871799.724,Gravesend (East)-Homecrest
19-Aug,36047039000,3039000,7721,55815,63536,Brooklyn,1871799.724,Gravesend (East)-Homecrest
21-Aug,36047039000,3039000,6485,161219,167704,Brooklyn,1871799.724,Gravesend (East)-Homecrest
19-May,36047039100,3039100,4007,127493,131500,Brooklyn,1788881.254,Bushwick (West)
21-May,36047039100,3039100,0,72439,72439,Brooklyn,1788881.254,Bushwick (West)
19-Jun,36047039100,3039100,8283,85674,93957,Brooklyn,1788881.254,Bushwick (West)
21-Jun,36047039100,3039100,7559,46587,54146,Brooklyn,1788881.254,Bushwick (West)
19-Jul,36047039100,3039100,13862,96273,110135,Brooklyn,1788881.254,Bushwick (West)
21-Jul,36047039100,3039100,5551,61119,66670,Brooklyn,1788881.254,Bushwick (West)
19-Aug,36047039100,3039100,14029,47856,61885,Brooklyn,1788881.254,Bushwick (West)
21-Aug,36047039100,3039100,193,46702,46895,Brooklyn,1788881.254,Bushwick (West)
19-May,36047039200,3039200,11675,45240,56915,Brooklyn,1875666.606,Gravesend (East)-Homecrest
21-May,36047039200,3039200,4616,82111,86727,Brooklyn,1875666.606,Gravesend (East)-Homecrest
19-Jun,36047039200,3039200,22134,61334,83468,Brooklyn,1875666.606,Gravesend (East)-Homecrest
21-Jun,36047039200,3039200,1257,111794,113051,Brooklyn,1875666.606,Gravesend (East)-Homecrest
19-Jul,36047039200,3039200,9642,69051,78693,Brooklyn,1875666.606,Gravesend (East)-Homecrest
21-Jul,36047039200,3039200,12486,49227,61713,Brooklyn,1875666.606,Gravesend (East)-Homecrest
19-Aug,36047039200,3039200,14003,12902,26905,Brooklyn,1875666.606,Gravesend (East)-Homecrest
21-Aug,36047039200,3039200,9682,86632,96314,Brooklyn,1875666.606,Gravesend (East)-Homecrest
19-May,36047039400,3039400,8891,49011,57902,Brooklyn,2067691.625,Gravesend (East)-Homecrest
21-May,36047039400,3039400,7773,26706,34479,Brooklyn,2067691.625,Gravesend (East)-Homecrest
19-Jun,36047039400,3039400,2435,156094,158529,Brooklyn,2067691.625,Gravesend (East)-Homecrest
21-Jun,36047039400,3039400,6721,52779,59500,Brooklyn,2067691.625,Gravesend (East)-Homecrest
19-Jul,36047039400,3039400,10645,63722,74367,Brooklyn,2067691.625,Gravesend (East)-Homecrest
21-Jul,36047039400,3039400,10868,68784,79652,Brooklyn,2067691.625,Gravesend (East)-Homecrest
19-Aug,36047039400,3039400,0,67419,67419,Brooklyn,2067691.625,Gravesend (East)-Homecrest
21-Aug,36047039400,3039400,5877,48799,54676,Brooklyn,2067691.625,Gravesend (East)-Homecrest
19-May,36047039600,3039600,6172,78650,84822,Brooklyn,1757819.253,Gravesend (East)-Homecrest
21-May,36047039600,3039600,322,79848,80170,Brooklyn,1757819.253,Gravesend (East)-Homecrest
19-Jun,36047039600,3039600,3897,22239,26136,Brooklyn,1757819.253,Gravesend (East)-Homecrest
21-Jun,36047039600,3039600,11163,104601,115764,Brooklyn,1757819.253,Gravesend (East)-Homecrest
19-Jul,36047039600,3039600,7017,76603,83620,Brooklyn,1757819.253,Gravesend (East)-Homecrest
21-Jul,36047039600,3039600,9032,82959,91991,Brooklyn,1757819.253,Gravesend (East)-Homecrest
19-Aug,36047039600,3039600,8051,7459,15510,Brooklyn,1757819.253,Gravesend (East)-Homecrest
21-Aug,36047039600,3039600,1657,147649,149306,Brooklyn,1757819.253,Gravesend (East)-Homecrest
19-May,36047039700,3039700,12578,56366,68944,Brooklyn,1712820.5,Bushwick (East)
21-May,36047039700,3039700,7248,83575,90823,Brooklyn,1712820.5,Bushwick (East)
19-Jun,36047039700,3039700,10859,39767,50626,Brooklyn,1712820.5,Bushwick (East)
21-Jun,36047039700,3039700,13857,27389,41246,Brooklyn,1712820.5,Bushwick (East)
19-Jul,36047039700,3039700,11379,35325,46704,Brooklyn,1712820.5,Bushwick (East)
21-Jul,36047039700,3039700,6254,49767,56021,Brooklyn,1712820.5,Bushwick (East)
19-Aug,36047039700,3039700,12025,5347,17372,Brooklyn,1712820.5,Bushwick (East)
21-Aug,36047039700,3039700,2816,101582,104398,Brooklyn,1712820.5,Bushwick (East)
19-May,36047039800,3039800,5531,44571,50102,Brooklyn,2184133.466,Gravesend (East)-Homecrest
21-May,36047039800,3039800,9905,42034,51939,Brooklyn,2184133.466,Gravesend (East)-Homecrest
19-Jun,36047039800,3039800,10163,573,10736,Brooklyn,2184133.466,Gravesend (East)-Homecrest
21-Jun,36047039800,3039800,3239,86975,90214,Brooklyn,2184133.466,Gravesend (East)-Homecrest
19-Jul,36047039800,3039800,6268,80727,86995,Brooklyn,2184133.466,Gravesend (East)-Homecrest
21-Jul,36047039800,3039800,10734,113268,124002,Brooklyn,2184133.466,Gravesend (East)-Homecrest
19-Aug,36047039800,3039800,2880,33287,36167,Brooklyn,2184133.466,Gravesend (East)-Homecrest
21-Aug,36047039800,3039800,14766,41091,55857,Brooklyn,2184133.466,Gravesend (East)-Homecrest
19-May,36047039900,3039900,11933,58186,70119,Brooklyn,1627809.179,Bushwick (East)
21-May,36047039900,3039900,9445,75706,85151,Brooklyn,1627809.179,Bushwick (East)
19-Jun,36047039900,3039900,12836,70983,83819,Brooklyn,1627809.179,Bushwick (East)
21-Jun,36047039900,3039900,0,6710,6710,Brooklyn,1627809.179,Bushwick (East)
19-Jul,36047039900,3039900,6472,68366,74838,Brooklyn,1627809.179,Bushwick (East)
21-Jul,36047039900,3039900,8818,107448,116266,Brooklyn,1627809.179,Bushwick (East)
19-Aug,36047039900,3039900,12735,84678,97413,Brooklyn,1627809.179,Bushwick (East)
21-Aug,36047039900,3039900,11417,57265,68682,Brooklyn,1627809.179,Bushwick (East)
19-May,36047040000,3040000,11051,132715,143766,Brooklyn,2058373.12,Gravesend (West)
21-May,36047040000,3040000,10306,112387,122693,Brooklyn,2058373.12,Gravesend (West)
19-Jun,36047040000,3040000,3912,32897,36809,Brooklyn,2058373.12,Gravesend (West)
21-Jun,36047040000,3040000,18549,135456,154005,Brooklyn,2058373.12,Gravesend (West)
19-Jul,36047040000,3040000,11812,53695,65507,Brooklyn,2058373.12,Gravesend (West)
21-Jul,36047040000,3040000,17638,7786,25424,Brooklyn,2058373.12,Gravesend (West)
19-Aug,36047040000,3040000,10489,110249,120738,Brooklyn,2058373.12,Gravesend (West)
21-Aug,36047040000,3040000,15939,49570,65509,Brooklyn,2058373.12,Gravesend (West)
19-May,36047040100,3040100,2304,29930,32234,Brooklyn,1718319.032,Bushwick (East)
21-May,36047040100,3040100,20852,42723,63575,Brooklyn,1718319.032,Bushwick (East)
19-Jun,36047040100,3040100,7877,10299,18176,Brooklyn,1718319.032,Bushwick (East)
21-Jun,36047040100,3040100,9571,29176,38747,Brooklyn,1718319.032,Bushwick (East)
19-Jul,36047040100,3040100,8293,89894,98187,Brooklyn,1718319.032,Bushwick (East)
21-Jul,36047040100,3040100,7808,71,7879,Brooklyn,1718319.032,Bushwick (East)
19-Aug,36047040100,3040100,9790,108719,118509,Brooklyn,1718319.032,Bushwick (East)
21-Aug,36047040100,3040100,2792,60890,63682,Brooklyn,1718319.032,Bushwick (East)
19-May,36047040200,3040200,11897,85066,96963,Brooklyn,2126179.913,Gravesend (West)
21-May,36047040200,3040200,0,109676,109676,Brooklyn,2126179.913,Gravesend (West)
19-Jun,36047040200,3040200,9388,88281,97669,Brooklyn,2126179.913,Gravesend (West)
21-Jun,36047040200,3040200,9309,14219,23528,Brooklyn,2126179.913,Gravesend (West)
19-Jul,36047040200,3040200,11180,81428,92608,Brooklyn,2126179.913,Gravesend (West)
21-Jul,36047040200,3040200,14010,71892,85902,Brooklyn,2126179.913,Gravesend (West)
19-Aug,36047040200,3040200,0,41892,41892,Brooklyn,2126179.913,Gravesend (West)
21-Aug,36047040200,3040200,13181,78055,91236,Brooklyn,2126179.913,Gravesend (West)
19-May,36047040300,3040300,17981,100475,118456,Brooklyn,2208072.005,Bushwick (East)
21-May,36047040300,3040300,14306,157733,172039,Brooklyn,2208072.005,Bushwick (East)
19-Jun,36047040300,3040300,8630,104578,113208,Brooklyn,2208072.005,Bushwick (East)
21-Jun,36047040300,3040300,9466,74910,84376,Brooklyn,2208072.005,Bushwick (East)
19-Jul,36047040300,3040300,8368,91924,100292,Brooklyn,2208072.005,Bushwick (East)
21-Jul,36047040300,3040300,9480,71478,80958,Brooklyn,2208072.005,Bushwick (East)
19-Aug,36047040300,3040300,1113,49014,50127,Brooklyn,2208072.005,Bushwick (East)
21-Aug,36047040300,3040300,18326,39014,57340,Brooklyn,2208072.005,Bushwick (East)
19-May,36047040400,3040400,0,31005,31005,Brooklyn,1653839.79,Gravesend (West)
21-May,36047040400,3040400,8029,83510,91539,Brooklyn,1653839.79,Gravesend (West)
19-Jun,36047040400,3040400,0,71,71,Brooklyn,1653839.79,Gravesend (West)
21-Jun,36047040400,3040400,22467,108633,131100,Brooklyn,1653839.79,Gravesend (West)
19-Jul,36047040400,3040400,9238,117628,126866,Brooklyn,1653839.79,Gravesend (West)
21-Jul,36047040400,3040400,8716,70410,79126,Brooklyn,1653839.79,Gravesend (West)
19-Aug,36047040400,3040400,13760,9072,22832,Brooklyn,1653839.79,Gravesend (West)
21-Aug,36047040400,3040400,17902,62324,80226,Brooklyn,1653839.79,Gravesend (West)
19-May,36047040500,3040500,8404,64792,73196,Brooklyn,1496440.317,Bushwick (East)
21-May,36047040500,3040500,4913,75287,80200,Brooklyn,1496440.317,Bushwick (East)
19-Jun,36047040500,3040500,8276,44361,52637,Brooklyn,1496440.317,Bushwick (East)
21-Jun,36047040500,3040500,1599,85357,86956,Brooklyn,1496440.317,Bushwick (East)
19-Jul,36047040500,3040500,8775,60390,69165,Brooklyn,1496440.317,Bushwick (East)
21-Jul,36047040500,3040500,1800,40025,41825,Brooklyn,1496440.317,Bushwick (East)
19-Aug,36047040500,3040500,8411,79665,88076,Brooklyn,1496440.317,Bushwick (East)
21-Aug,36047040500,3040500,2077,114493,116570,Brooklyn,1496440.317,Bushwick (East)
19-May,36047040600,3040600,4865,87687,92552,Brooklyn,1584439.823,Gravesend (West)
21-May,36047040600,3040600,9641,88939,98580,Brooklyn,1584439.823,Gravesend (West)
19-Jun,36047040600,3040600,6107,69209,75316,Brooklyn,1584439.823,Gravesend (West)
21-Jun,36047040600,3040600,4295,120908,125203,Brooklyn,1584439.823,Gravesend (West)
19-Jul,36047040600,3040600,0,110865,110865,Brooklyn,1584439.823,Gravesend (West)
21-Jul,36047040600,3040600,8739,70503,79242,Brooklyn,1584439.823,Gravesend (West)
19-Aug,36047040600,3040600,0,71306,71306,Brooklyn,1584439.823,Gravesend (West)
21-Aug,36047040600,3040600,14967,78218,93185,Brooklyn,1584439.823,Gravesend (West)
19-May,36047040700,3040700,5625,37514,43139,Brooklyn,5585573.164,The Evergreens Cemetery
21-May,36047040700,3040700,10205,102917,113122,Brooklyn,5585573.164,The Evergreens Cemetery
19-Jun,36047040700,3040700,12903,58440,71343,Brooklyn,5585573.164,The Evergreens Cemetery
21-Jun,36047040700,3040700,10497,100746,111243,Brooklyn,5585573.164,The Evergreens Cemetery
19-Jul,36047040700,3040700,0,128749,128749,Brooklyn,5585573.164,The Evergreens Cemetery
21-Jul,36047040700,3040700,9787,86567,96354,Brooklyn,5585573.164,The Evergreens Cemetery
19-Aug,36047040700,3040700,0,66478,66478,Brooklyn,5585573.164,The Evergreens Cemetery
21-Aug,36047040700,3040700,0,134227,134227,Brooklyn,5585573.164,The Evergreens Cemetery
19-May,36047040800,3040800,8059,71,8130,Brooklyn,1652207.634,Gravesend (West)
21-May,36047040800,3040800,9262,82397,91659,Brooklyn,1652207.634,Gravesend (West)
19-Jun,36047040800,3040800,13414,17847,31261,Brooklyn,1652207.634,Gravesend (West)
21-Jun,36047040800,3040800,5245,136739,141984,Brooklyn,1652207.634,Gravesend (West)
19-Jul,36047040800,3040800,7284,34510,41794,Brooklyn,1652207.634,Gravesend (West)
21-Jul,36047040800,3040800,896,142361,143257,Brooklyn,1652207.634,Gravesend (West)
19-Aug,36047040800,3040800,6939,50651,57590,Brooklyn,1652207.634,Gravesend (West)
21-Aug,36047040800,3040800,5193,45754,50947,Brooklyn,1652207.634,Gravesend (West)
19-May,36047040900,3040900,11798,119789,131587,Brooklyn,1773606.992,Bushwick (East)
21-May,36047040900,3040900,13287,154005,167292,Brooklyn,1773606.992,Bushwick (East)
19-Jun,36047040900,3040900,8744,111194,119938,Brooklyn,1773606.992,Bushwick (East)
21-Jun,36047040900,3040900,15071,98168,113239,Brooklyn,1773606.992,Bushwick (East)
19-Jul,36047040900,3040900,7490,54390,61880,Brooklyn,1773606.992,Bushwick (East)
21-Jul,36047040900,3040900,15928,72275,88203,Brooklyn,1773606.992,Bushwick (East)
19-Aug,36047040900,3040900,8489,82702,91191,Brooklyn,1773606.992,Bushwick (East)
21-Aug,36047040900,3040900,2991,136918,139909,Brooklyn,1773606.992,Bushwick (East)
19-May,36047041000,3041000,8535,129267,137802,Brooklyn,1537209.623,Gravesend (West)
21-May,36047041000,3041000,10500,36821,47321,Brooklyn,1537209.623,Gravesend (West)
19-Jun,36047041000,3041000,0,71,71,Brooklyn,1537209.623,Gravesend (West)
21-Jun,36047041000,3041000,716,93915,94631,Brooklyn,1537209.623,Gravesend (West)
19-Jul,36047041000,3041000,4756,71,4827,Brooklyn,1537209.623,Gravesend (West)
21-Jul,36047041000,3041000,8758,94015,102773,Brooklyn,1537209.623,Gravesend (West)
19-Aug,36047041000,3041000,4866,82856,87722,Brooklyn,1537209.623,Gravesend (West)
21-Aug,36047041000,3041000,21580,79940,101520,Brooklyn,1537209.623,Gravesend (West)
19-May,36047041100,3041100,12236,56551,68787,Brooklyn,1433607.152,Bushwick (East)
21-May,36047041100,3041100,3709,51363,55072,Brooklyn,1433607.152,Bushwick (East)
19-Jun,36047041100,3041100,8172,70071,78243,Brooklyn,1433607.152,Bushwick (East)
21-Jun,36047041100,3041100,10047,96524,106571,Brooklyn,1433607.152,Bushwick (East)
19-Jul,36047041100,3041100,7136,58423,65559,Brooklyn,1433607.152,Bushwick (East)
21-Jul,36047041100,3041100,8412,106864,115276,Brooklyn,1433607.152,Bushwick (East)
19-Aug,36047041100,3041100,12521,164008,176529,Brooklyn,1433607.152,Bushwick (East)
21-Aug,36047041100,3041100,15211,42407,57618,Brooklyn,1433607.152,Bushwick (East)
19-May,36047041200,3041200,8630,21858,30488,Brooklyn,1780125.315,Gravesend (West)
21-May,36047041200,3041200,277,156080,156357,Brooklyn,1780125.315,Gravesend (West)
19-Jun,36047041200,3041200,10484,33368,43852,Brooklyn,1780125.315,Gravesend (West)
21-Jun,36047041200,3041200,9900,42333,52233,Brooklyn,1780125.315,Gravesend (West)
19-Jul,36047041200,3041200,4136,55092,59228,Brooklyn,1780125.315,Gravesend (West)
21-Jul,36047041200,3041200,10694,109095,119789,Brooklyn,1780125.315,Gravesend (West)
19-Aug,36047041200,3041200,8480,97507,105987,Brooklyn,1780125.315,Gravesend (West)
21-Aug,36047041200,3041200,11992,115834,127826,Brooklyn,1780125.315,Gravesend (West)
19-May,36047041300,3041300,12460,115256,127716,Brooklyn,1745182.863,Bushwick (East)
21-May,36047041300,3041300,14375,69975,84350,Brooklyn,1745182.863,Bushwick (East)
19-Jun,36047041300,3041300,2949,109815,112764,Brooklyn,1745182.863,Bushwick (East)
21-Jun,36047041300,3041300,10136,108315,118451,Brooklyn,1745182.863,Bushwick (East)
19-Jul,36047041300,3041300,6353,131987,138340,Brooklyn,1745182.863,Bushwick (East)
21-Jul,36047041300,3041300,15902,66632,82534,Brooklyn,1745182.863,Bushwick (East)
19-Aug,36047041300,3041300,1938,93380,95318,Brooklyn,1745182.863,Bushwick (East)
21-Aug,36047041300,3041300,12342,74794,87136,Brooklyn,1745182.863,Bushwick (East)
19-May,36047041401,3041401,10946,69831,80777,Brooklyn,1454192.417,Gravesend (East)-Homecrest
21-May,36047041401,3041401,5985,91361,97346,Brooklyn,1454192.417,Gravesend (East)-Homecrest
19-Jun,36047041401,3041401,2121,33433,35554,Brooklyn,1454192.417,Gravesend (East)-Homecrest
21-Jun,36047041401,3041401,10354,102696,113050,Brooklyn,1454192.417,Gravesend (East)-Homecrest
19-Jul,36047041401,3041401,10721,83146,93867,Brooklyn,1454192.417,Gravesend (East)-Homecrest
21-Jul,36047041401,3041401,4460,73415,77875,Brooklyn,1454192.417,Gravesend (East)-Homecrest
19-Aug,36047041401,3041401,11716,58247,69963,Brooklyn,1454192.417,Gravesend (East)-Homecrest
21-Aug,36047041401,3041401,11591,79639,91230,Brooklyn,1454192.417,Gravesend (East)-Homecrest
19-May,36047041402,3041402,17290,74965,92255,Brooklyn,1659482.131,Gravesend (East)-Homecrest
21-May,36047041402,3041402,12674,22586,35260,Brooklyn,1659482.131,Gravesend (East)-Homecrest
19-Jun,36047041402,3041402,5419,49704,55123,Brooklyn,1659482.131,Gravesend (East)-Homecrest
21-Jun,36047041402,3041402,8479,30178,38657,Brooklyn,1659482.131,Gravesend (East)-Homecrest
19-Jul,36047041402,3041402,0,42132,42132,Brooklyn,1659482.131,Gravesend (East)-Homecrest
21-Jul,36047041402,3041402,4774,99081,103855,Brooklyn,1659482.131,Gravesend (East)-Homecrest
19-Aug,36047041402,3041402,6386,90045,96431,Brooklyn,1659482.131,Gravesend (East)-Homecrest
21-Aug,36047041402,3041402,10268,86818,97086,Brooklyn,1659482.131,Gravesend (East)-Homecrest
19-May,36047041500,3041500,6071,56036,62107,Brooklyn,1750287.744,Bushwick (East)
21-May,36047041500,3041500,15051,20461,35512,Brooklyn,1750287.744,Bushwick (East)
19-Jun,36047041500,3041500,10388,60301,70689,Brooklyn,1750287.744,Bushwick (East)
21-Jun,36047041500,3041500,13809,19201,33010,Brooklyn,1750287.744,Bushwick (East)
19-Jul,36047041500,3041500,3945,95233,99178,Brooklyn,1750287.744,Bushwick (East)
21-Jul,36047041500,3041500,7978,90072,98050,Brooklyn,1750287.744,Bushwick (East)
19-Aug,36047041500,3041500,5359,40087,45446,Brooklyn,1750287.744,Bushwick (East)
21-Aug,36047041500,3041500,5698,177347,183045,Brooklyn,1750287.744,Bushwick (East)
19-May,36047041600,3041600,676,35531,36207,Brooklyn,1749784.5,Gravesend (East)-Homecrest
21-May,36047041600,3041600,8812,145714,154526,Brooklyn,1749784.5,Gravesend (East)-Homecrest
19-Jun,36047041600,3041600,10215,36873,47088,Brooklyn,1749784.5,Gravesend (East)-Homecrest
21-Jun,36047041600,3041600,12822,56827,69649,Brooklyn,1749784.5,Gravesend (East)-Homecrest
19-Jul,36047041600,3041600,9505,106670,116175,Brooklyn,1749784.5,Gravesend (East)-Homecrest
21-Jul,36047041600,3041600,883,71606,72489,Brooklyn,1749784.5,Gravesend (East)-Homecrest
19-Aug,36047041600,3041600,3945,51337,55282,Brooklyn,1749784.5,Gravesend (East)-Homecrest
21-Aug,36047041600,3041600,11299,126479,137778,Brooklyn,1749784.5,Gravesend (East)-Homecrest
19-May,36047041700,3041700,1218,123179,124397,Brooklyn,1519400.595,Bushwick (East)
21-May,36047041700,3041700,9535,80136,89671,Brooklyn,1519400.595,Bushwick (East)
19-Jun,36047041700,3041700,3593,109519,113112,Brooklyn,1519400.595,Bushwick (East)
21-Jun,36047041700,3041700,7012,74197,81209,Brooklyn,1519400.595,Bushwick (East)
19-Jul,36047041700,3041700,8058,61248,69306,Brooklyn,1519400.595,Bushwick (East)
21-Jul,36047041700,3041700,7239,92946,100185,Brooklyn,1519400.595,Bushwick (East)
19-Aug,36047041700,3041700,11672,103650,115322,Brooklyn,1519400.595,Bushwick (East)
21-Aug,36047041700,3041700,10762,44732,55494,Brooklyn,1519400.595,Bushwick (East)
19-May,36047041800,3041800,8422,150607,159029,Brooklyn,1773170.385,Gravesend (East)-Homecrest
21-May,36047041800,3041800,9844,79215,89059,Brooklyn,1773170.385,Gravesend (East)-Homecrest
19-Jun,36047041800,3041800,3157,71,3228,Brooklyn,1773170.385,Gravesend (East)-Homecrest
21-Jun,36047041800,3041800,11617,71,11688,Brooklyn,1773170.385,Gravesend (East)-Homecrest
19-Jul,36047041800,3041800,7553,92915,100468,Brooklyn,1773170.385,Gravesend (East)-Homecrest
21-Jul,36047041800,3041800,5673,133336,139009,Brooklyn,1773170.385,Gravesend (East)-Homecrest
19-Aug,36047041800,3041800,6686,92704,99390,Brooklyn,1773170.385,Gravesend (East)-Homecrest
21-Aug,36047041800,3041800,7846,80644,88490,Brooklyn,1773170.385,Gravesend (East)-Homecrest
19-May,36047041900,3041900,11317,70319,81636,Brooklyn,1646861.688,Bushwick (East)
21-May,36047041900,3041900,6766,30450,37216,Brooklyn,1646861.688,Bushwick (East)
19-Jun,36047041900,3041900,13564,54012,67576,Brooklyn,1646861.688,Bushwick (East)
21-Jun,36047041900,3041900,10629,34594,45223,Brooklyn,1646861.688,Bushwick (East)
19-Jul,36047041900,3041900,6178,52260,58438,Brooklyn,1646861.688,Bushwick (East)
21-Jul,36047041900,3041900,10084,129369,139453,Brooklyn,1646861.688,Bushwick (East)
19-Aug,36047041900,3041900,5305,80376,85681,Brooklyn,1646861.688,Bushwick (East)
21-Aug,36047041900,3041900,14154,85657,99811,Brooklyn,1646861.688,Bushwick (East)
19-May,36047042100,3042100,6134,71,6205,Brooklyn,1651413.334,Bushwick (West)
21-May,36047042100,3042100,9281,56260,65541,Brooklyn,1651413.334,Bushwick (West)
19-Jun,36047042100,3042100,12699,163585,176284,Brooklyn,1651413.334,Bushwick (West)
21-Jun,36047042100,3042100,8435,103062,111497,Brooklyn,1651413.334,Bushwick (West)
19-Jul,36047042100,3042100,2089,66246,68335,Brooklyn,1651413.334,Bushwick (West)
21-Jul,36047042100,3042100,9743,96705,106448,Brooklyn,1651413.334,Bushwick (West)
19-Aug,36047042100,3042100,12316,133632,145948,Brooklyn,1651413.334,Bushwick (West)
21-Aug,36047042100,3042100,5555,86419,91974,Brooklyn,1651413.334,Bushwick (West)
19-May,36047042200,3042200,6259,60422,66681,Brooklyn,2443185.615,Gravesend (East)-Homecrest
21-May,36047042200,3042200,9039,121251,130290,Brooklyn,2443185.615,Gravesend (East)-Homecrest
19-Jun,36047042200,3042200,4231,98863,103094,Brooklyn,2443185.615,Gravesend (East)-Homecrest
21-Jun,36047042200,3042200,11770,80667,92437,Brooklyn,2443185.615,Gravesend (East)-Homecrest
19-Jul,36047042200,3042200,7792,56334,64126,Brooklyn,2443185.615,Gravesend (East)-Homecrest
21-Jul,36047042200,3042200,13548,91033,104581,Brooklyn,2443185.615,Gravesend (East)-Homecrest
19-Aug,36047042200,3042200,18139,70681,88820,Brooklyn,2443185.615,Gravesend (East)-Homecrest
21-Aug,36047042200,3042200,7750,27742,35492,Brooklyn,2443185.615,Gravesend (East)-Homecrest
19-May,36047042300,3042300,9040,105384,114424,Brooklyn,1961468.198,Bushwick (West)
21-May,36047042300,3042300,8721,41716,50437,Brooklyn,1961468.198,Bushwick (West)
19-Jun,36047042300,3042300,6727,68777,75504,Brooklyn,1961468.198,Bushwick (West)
21-Jun,36047042300,3042300,6232,167142,173374,Brooklyn,1961468.198,Bushwick (West)
19-Jul,36047042300,3042300,8659,115367,124026,Brooklyn,1961468.198,Bushwick (West)
21-Jul,36047042300,3042300,10615,61068,71683,Brooklyn,1961468.198,Bushwick (West)
19-Aug,36047042300,3042300,12252,61082,73334,Brooklyn,1961468.198,Bushwick (West)
21-Aug,36047042300,3042300,4485,79890,84375,Brooklyn,1961468.198,Bushwick (West)
19-May,36047042400,3042400,10484,70559,81043,Brooklyn,1733612.862,Gravesend (West)
21-May,36047042400,3042400,6913,120766,127679,Brooklyn,1733612.862,Gravesend (West)
19-Jun,36047042400,3042400,16275,143282,159557,Brooklyn,1733612.862,Gravesend (West)
21-Jun,36047042400,3042400,15728,36389,52117,Brooklyn,1733612.862,Gravesend (West)
19-Jul,36047042400,3042400,6594,78506,85100,Brooklyn,1733612.862,Gravesend (West)
21-Jul,36047042400,3042400,7129,67816,74945,Brooklyn,1733612.862,Gravesend (West)
19-Aug,36047042400,3042400,6436,134188,140624,Brooklyn,1733612.862,Gravesend (West)
21-Aug,36047042400,3042400,9942,40350,50292,Brooklyn,1733612.862,Gravesend (West)
19-May,36047042500,3042500,14845,100624,115469,Brooklyn,1806380.024,Bushwick (West)
21-May,36047042500,3042500,4710,167124,171834,Brooklyn,1806380.024,Bushwick (West)
19-Jun,36047042500,3042500,11792,45895,57687,Brooklyn,1806380.024,Bushwick (West)
21-Jun,36047042500,3042500,9750,18883,28633,Brooklyn,1806380.024,Bushwick (West)
19-Jul,36047042500,3042500,10004,107273,117277,Brooklyn,1806380.024,Bushwick (West)
21-Jul,36047042500,3042500,0,29553,29553,Brooklyn,1806380.024,Bushwick (West)
19-Aug,36047042500,3042500,9582,16202,25784,Brooklyn,1806380.024,Bushwick (West)
21-Aug,36047042500,3042500,2829,50685,53514,Brooklyn,1806380.024,Bushwick (West)
19-May,36047042600,3042600,15806,59168,74974,Brooklyn,1829969.176,Gravesend (West)
21-May,36047042600,3042600,10829,43223,54052,Brooklyn,1829969.176,Gravesend (West)
19-Jun,36047042600,3042600,3165,53443,56608,Brooklyn,1829969.176,Gravesend (West)
21-Jun,36047042600,3042600,10800,48523,59323,Brooklyn,1829969.176,Gravesend (West)
19-Jul,36047042600,3042600,8138,41838,49976,Brooklyn,1829969.176,Gravesend (West)
21-Jul,36047042600,3042600,7121,84392,91513,Brooklyn,1829969.176,Gravesend (West)
19-Aug,36047042600,3042600,3958,111086,115044,Brooklyn,1829969.176,Gravesend (West)
21-Aug,36047042600,3042600,5641,31322,36963,Brooklyn,1829969.176,Gravesend (West)
19-May,36047042700,3042700,11674,112309,123983,Brooklyn,1595262.245,Bushwick (West)
21-May,36047042700,3042700,7485,72021,79506,Brooklyn,1595262.245,Bushwick (West)
19-Jun,36047042700,3042700,5268,169577,174845,Brooklyn,1595262.245,Bushwick (West)
21-Jun,36047042700,3042700,7029,139897,146926,Brooklyn,1595262.245,Bushwick (West)
19-Jul,36047042700,3042700,2102,43582,45684,Brooklyn,1595262.245,Bushwick (West)
21-Jul,36047042700,3042700,8480,187361,195841,Brooklyn,1595262.245,Bushwick (West)
19-Aug,36047042700,3042700,21052,54310,75362,Brooklyn,1595262.245,Bushwick (West)
21-Aug,36047042700,3042700,3479,32406,35885,Brooklyn,1595262.245,Bushwick (West)
19-May,36047042800,3042800,4414,132513,136927,Brooklyn,1773181.707,Gravesend (West)
21-May,36047042800,3042800,0,77242,77242,Brooklyn,1773181.707,Gravesend (West)
19-Jun,36047042800,3042800,12108,159153,171261,Brooklyn,1773181.707,Gravesend (West)
21-Jun,36047042800,3042800,10029,68001,78030,Brooklyn,1773181.707,Gravesend (West)
19-Jul,36047042800,3042800,14590,71,14661,Brooklyn,1773181.707,Gravesend (West)
21-Jul,36047042800,3042800,4503,8663,13166,Brooklyn,1773181.707,Gravesend (West)
19-Aug,36047042800,3042800,9931,47174,57105,Brooklyn,1773181.707,Gravesend (West)
21-Aug,36047042800,3042800,7305,86132,93437,Brooklyn,1773181.707,Gravesend (West)
19-May,36047042900,3042900,0,62087,62087,Brooklyn,1809836.589,Bushwick (West)
21-May,36047042900,3042900,14308,26624,40932,Brooklyn,1809836.589,Bushwick (West)
19-Jun,36047042900,3042900,7466,120338,127804,Brooklyn,1809836.589,Bushwick (West)
21-Jun,36047042900,3042900,11085,115675,126760,Brooklyn,1809836.589,Bushwick (West)
19-Jul,36047042900,3042900,13140,79504,92644,Brooklyn,1809836.589,Bushwick (West)
21-Jul,36047042900,3042900,4484,42301,46785,Brooklyn,1809836.589,Bushwick (West)
19-Aug,36047042900,3042900,8105,127248,135353,Brooklyn,1809836.589,Bushwick (West)
21-Aug,36047042900,3042900,5219,122810,128029,Brooklyn,1809836.589,Bushwick (West)
19-May,36047043000,3043000,4758,97092,101850,Brooklyn,1721309.836,Bensonhurst
21-May,36047043000,3043000,9556,114760,124316,Brooklyn,1721309.836,Bensonhurst
19-Jun,36047043000,3043000,12537,38289,50826,Brooklyn,1721309.836,Bensonhurst
21-Jun,36047043000,3043000,13842,62026,75868,Brooklyn,1721309.836,Bensonhurst
19-Jul,36047043000,3043000,11218,46330,57548,Brooklyn,1721309.836,Bensonhurst
21-Jul,36047043000,3043000,9120,77995,87115,Brooklyn,1721309.836,Bensonhurst
19-Aug,36047043000,3043000,0,67179,67179,Brooklyn,1721309.836,Bensonhurst
21-Aug,36047043000,3043000,1600,75075,76675,Brooklyn,1721309.836,Bensonhurst
19-May,36047043100,3043100,11309,68830,80139,Brooklyn,1810786.764,Bushwick (West)
21-May,36047043100,3043100,11158,149778,160936,Brooklyn,1810786.764,Bushwick (West)
19-Jun,36047043100,3043100,9011,59543,68554,Brooklyn,1810786.764,Bushwick (West)
21-Jun,36047043100,3043100,4201,71,4272,Brooklyn,1810786.764,Bushwick (West)
19-Jul,36047043100,3043100,10240,27713,37953,Brooklyn,1810786.764,Bushwick (West)
21-Jul,36047043100,3043100,3944,35606,39550,Brooklyn,1810786.764,Bushwick (West)
19-Aug,36047043100,3043100,9438,81485,90923,Brooklyn,1810786.764,Bushwick (West)
21-Aug,36047043100,3043100,12104,67479,79583,Brooklyn,1810786.764,Bushwick (West)
19-May,36047043200,3043200,12681,55842,68523,Brooklyn,1594317.091,Bensonhurst
21-May,36047043200,3043200,11609,84206,95815,Brooklyn,1594317.091,Bensonhurst
19-Jun,36047043200,3043200,16564,150745,167309,Brooklyn,1594317.091,Bensonhurst
21-Jun,36047043200,3043200,3439,111531,114970,Brooklyn,1594317.091,Bensonhurst
19-Jul,36047043200,3043200,5560,51875,57435,Brooklyn,1594317.091,Bensonhurst
21-Jul,36047043200,3043200,6573,76649,83222,Brooklyn,1594317.091,Bensonhurst
19-Aug,36047043200,3043200,7309,28333,35642,Brooklyn,1594317.091,Bensonhurst
21-Aug,36047043200,3043200,12260,138460,150720,Brooklyn,1594317.091,Bensonhurst
19-May,36047043300,3043300,11865,63001,74866,Brooklyn,1810979.36,Bushwick (East)
21-May,36047043300,3043300,3569,35115,38684,Brooklyn,1810979.36,Bushwick (East)
19-Jun,36047043300,3043300,3138,64308,67446,Brooklyn,1810979.36,Bushwick (East)
21-Jun,36047043300,3043300,14984,148625,163609,Brooklyn,1810979.36,Bushwick (East)
19-Jul,36047043300,3043300,3455,71,3526,Brooklyn,1810979.36,Bushwick (East)
21-Jul,36047043300,3043300,4292,83595,87887,Brooklyn,1810979.36,Bushwick (East)
19-Aug,36047043300,3043300,6637,69118,75755,Brooklyn,1810979.36,Bushwick (East)
21-Aug,36047043300,3043300,11270,43809,55079,Brooklyn,1810979.36,Bushwick (East)
19-May,36047043400,3043400,523,45106,45629,Brooklyn,1509164.712,Bensonhurst
21-May,36047043400,3043400,13942,80118,94060,Brooklyn,1509164.712,Bensonhurst
19-Jun,36047043400,3043400,9554,45560,55114,Brooklyn,1509164.712,Bensonhurst
21-Jun,36047043400,3043400,12721,84860,97581,Brooklyn,1509164.712,Bensonhurst
19-Jul,36047043400,3043400,7560,25786,33346,Brooklyn,1509164.712,Bensonhurst
21-Jul,36047043400,3043400,6461,65328,71789,Brooklyn,1509164.712,Bensonhurst
19-Aug,36047043400,3043400,4865,39187,44052,Brooklyn,1509164.712,Bensonhurst
21-Aug,36047043400,3043400,8339,100365,108704,Brooklyn,1509164.712,Bensonhurst
19-May,36047043500,3043500,3069,98800,101869,Brooklyn,1810895.273,Bushwick (East)
21-May,36047043500,3043500,7680,89149,96829,Brooklyn,1810895.273,Bushwick (East)
19-Jun,36047043500,3043500,1446,27752,29198,Brooklyn,1810895.273,Bushwick (East)
21-Jun,36047043500,3043500,12131,25161,37292,Brooklyn,1810895.273,Bushwick (East)
19-Jul,36047043500,3043500,18011,67733,85744,Brooklyn,1810895.273,Bushwick (East)
21-Jul,36047043500,3043500,14491,101378,115869,Brooklyn,1810895.273,Bushwick (East)
19-Aug,36047043500,3043500,3312,121847,125159,Brooklyn,1810895.273,Bushwick (East)
21-Aug,36047043500,3043500,15665,52663,68328,Brooklyn,1810895.273,Bushwick (East)
19-May,36047043600,3043600,9051,10100,19151,Brooklyn,1480301.697,Bensonhurst
21-May,36047043600,3043600,9252,83251,92503,Brooklyn,1480301.697,Bensonhurst
19-Jun,36047043600,3043600,8964,11737,20701,Brooklyn,1480301.697,Bensonhurst
21-Jun,36047043600,3043600,10331,111727,122058,Brooklyn,1480301.697,Bensonhurst
19-Jul,36047043600,3043600,14445,103468,117913,Brooklyn,1480301.697,Bensonhurst
21-Jul,36047043600,3043600,5543,54545,60088,Brooklyn,1480301.697,Bensonhurst
19-Aug,36047043600,3043600,11494,36763,48257,Brooklyn,1480301.697,Bensonhurst
21-Aug,36047043600,3043600,12384,60243,72627,Brooklyn,1480301.697,Bensonhurst
19-May,36047043700,3043700,5531,24382,29913,Brooklyn,1809983.893,Bushwick (East)
21-May,36047043700,3043700,6251,84751,91002,Brooklyn,1809983.893,Bushwick (East)
19-Jun,36047043700,3043700,8489,128549,137038,Brooklyn,1809983.893,Bushwick (East)
21-Jun,36047043700,3043700,0,55488,55488,Brooklyn,1809983.893,Bushwick (East)
19-Jul,36047043700,3043700,13021,102240,115261,Brooklyn,1809983.893,Bushwick (East)
21-Jul,36047043700,3043700,7191,10330,17521,Brooklyn,1809983.893,Bushwick (East)
19-Aug,36047043700,3043700,8576,102646,111222,Brooklyn,1809983.893,Bushwick (East)
21-Aug,36047043700,3043700,15536,71,15607,Brooklyn,1809983.893,Bushwick (East)
19-May,36047043800,3043800,4346,77852,82198,Brooklyn,1671530.592,Mapleton-Midwood (West)
21-May,36047043800,3043800,12994,38216,51210,Brooklyn,1671530.592,Mapleton-Midwood (West)
19-Jun,36047043800,3043800,3576,69648,73224,Brooklyn,1671530.592,Mapleton-Midwood (West)
21-Jun,36047043800,3043800,7482,61515,68997,Brooklyn,1671530.592,Mapleton-Midwood (West)
19-Jul,36047043800,3043800,0,60742,60742,Brooklyn,1671530.592,Mapleton-Midwood (West)
21-Jul,36047043800,3043800,4156,20012,24168,Brooklyn,1671530.592,Mapleton-Midwood (West)
19-Aug,36047043800,3043800,8054,31799,39853,Brooklyn,1671530.592,Mapleton-Midwood (West)
21-Aug,36047043800,3043800,3510,9245,12755,Brooklyn,1671530.592,Mapleton-Midwood (West)
19-May,36047043900,3043900,6855,71,6926,Brooklyn,2152392.913,Bushwick (East)
21-May,36047043900,3043900,6287,29320,35607,Brooklyn,2152392.913,Bushwick (East)
19-Jun,36047043900,3043900,12342,90148,102490,Brooklyn,2152392.913,Bushwick (East)
21-Jun,36047043900,3043900,0,130975,130975,Brooklyn,2152392.913,Bushwick (East)
19-Jul,36047043900,3043900,11887,151840,163727,Brooklyn,2152392.913,Bushwick (East)
21-Jul,36047043900,3043900,10222,75072,85294,Brooklyn,2152392.913,Bushwick (East)
19-Aug,36047043900,3043900,5165,115167,120332,Brooklyn,2152392.913,Bushwick (East)
21-Aug,36047043900,3043900,12116,18385,30501,Brooklyn,2152392.913,Bushwick (East)
19-May,36047044000,3044000,9121,106505,115626,Brooklyn,2173529.606,Mapleton-Midwood (West)
21-May,36047044000,3044000,9807,17328,27135,Brooklyn,2173529.606,Mapleton-Midwood (West)
19-Jun,36047044000,3044000,15042,68145,83187,Brooklyn,2173529.606,Mapleton-Midwood (West)
21-Jun,36047044000,3044000,15148,84123,99271,Brooklyn,2173529.606,Mapleton-Midwood (West)
19-Jul,36047044000,3044000,13422,13510,26932,Brooklyn,2173529.606,Mapleton-Midwood (West)
21-Jul,36047044000,3044000,11826,71,11897,Brooklyn,2173529.606,Mapleton-Midwood (West)
19-Aug,36047044000,3044000,0,89098,89098,Brooklyn,2173529.606,Mapleton-Midwood (West)
21-Aug,36047044000,3044000,13961,82889,96850,Brooklyn,2173529.606,Mapleton-Midwood (West)
19-May,36047044100,3044100,9167,34354,43521,Brooklyn,1528572.594,Bushwick (West)
21-May,36047044100,3044100,5855,72653,78508,Brooklyn,1528572.594,Bushwick (West)
19-Jun,36047044100,3044100,0,10781,10781,Brooklyn,1528572.594,Bushwick (West)
21-Jun,36047044100,3044100,9219,104530,113749,Brooklyn,1528572.594,Bushwick (West)
19-Jul,36047044100,3044100,10763,71,10834,Brooklyn,1528572.594,Bushwick (West)
21-Jul,36047044100,3044100,10356,29303,39659,Brooklyn,1528572.594,Bushwick (West)
19-Aug,36047044100,3044100,0,85005,85005,Brooklyn,1528572.594,Bushwick (West)
21-Aug,36047044100,3044100,8860,48968,57828,Brooklyn,1528572.594,Bushwick (West)
19-May,36047044200,3044200,7963,135825,143788,Brooklyn,1969036.038,Mapleton-Midwood (West)
21-May,36047044200,3044200,12666,64258,76924,Brooklyn,1969036.038,Mapleton-Midwood (West)
19-Jun,36047044200,3044200,0,130124,130124,Brooklyn,1969036.038,Mapleton-Midwood (West)
21-Jun,36047044200,3044200,15041,113023,128064,Brooklyn,1969036.038,Mapleton-Midwood (West)
19-Jul,36047044200,3044200,9285,115880,125165,Brooklyn,1969036.038,Mapleton-Midwood (West)
21-Jul,36047044200,3044200,10700,132184,142884,Brooklyn,1969036.038,Mapleton-Midwood (West)
19-Aug,36047044200,3044200,15973,60218,76191,Brooklyn,1969036.038,Mapleton-Midwood (West)
21-Aug,36047044200,3044200,9034,52274,61308,Brooklyn,1969036.038,Mapleton-Midwood (West)
19-May,36047044300,3044300,1582,113026,114608,Brooklyn,1805749.926,Bushwick (West)
21-May,36047044300,3044300,4728,9844,14572,Brooklyn,1805749.926,Bushwick (West)
19-Jun,36047044300,3044300,4838,52085,56923,Brooklyn,1805749.926,Bushwick (West)
21-Jun,36047044300,3044300,3619,42657,46276,Brooklyn,1805749.926,Bushwick (West)
19-Jul,36047044300,3044300,4877,91734,96611,Brooklyn,1805749.926,Bushwick (West)
21-Jul,36047044300,3044300,22016,34700,56716,Brooklyn,1805749.926,Bushwick (West)
19-Aug,36047044300,3044300,9383,100871,110254,Brooklyn,1805749.926,Bushwick (West)
21-Aug,36047044300,3044300,6583,91794,98377,Brooklyn,1805749.926,Bushwick (West)
19-May,36047044400,3044400,11798,118884,130682,Brooklyn,1878089.971,Mapleton-Midwood (West)
21-May,36047044400,3044400,4702,77007,81709,Brooklyn,1878089.971,Mapleton-Midwood (West)
19-Jun,36047044400,3044400,13760,32545,46305,Brooklyn,1878089.971,Mapleton-Midwood (West)
21-Jun,36047044400,3044400,0,108900,108900,Brooklyn,1878089.971,Mapleton-Midwood (West)
19-Jul,36047044400,3044400,10788,114021,124809,Brooklyn,1878089.971,Mapleton-Midwood (West)
21-Jul,36047044400,3044400,6885,89059,95944,Brooklyn,1878089.971,Mapleton-Midwood (West)
19-Aug,36047044400,3044400,3602,79723,83325,Brooklyn,1878089.971,Mapleton-Midwood (West)
21-Aug,36047044400,3044400,13656,71,13727,Brooklyn,1878089.971,Mapleton-Midwood (West)
19-May,36047044500,3044500,7327,42434,49761,Brooklyn,1827455.903,Bushwick (West)
21-May,36047044500,3044500,13960,21238,35198,Brooklyn,1827455.903,Bushwick (West)
19-Jun,36047044500,3044500,5338,42710,48048,Brooklyn,1827455.903,Bushwick (West)
21-Jun,36047044500,3044500,11688,10488,22176,Brooklyn,1827455.903,Bushwick (West)
19-Jul,36047044500,3044500,11372,23444,34816,Brooklyn,1827455.903,Bushwick (West)
21-Jul,36047044500,3044500,1361,30487,31848,Brooklyn,1827455.903,Bushwick (West)
19-Aug,36047044500,3044500,4727,122643,127370,Brooklyn,1827455.903,Bushwick (West)
21-Aug,36047044500,3044500,5098,16940,22038,Brooklyn,1827455.903,Bushwick (West)
19-May,36047044600,3044600,6857,76362,83219,Brooklyn,1523482.72,Mapleton-Midwood (West)
21-May,36047044600,3044600,5456,71,5527,Brooklyn,1523482.72,Mapleton-Midwood (West)
19-Jun,36047044600,3044600,10647,168439,179086,Brooklyn,1523482.72,Mapleton-Midwood (West)
21-Jun,36047044600,3044600,6068,86584,92652,Brooklyn,1523482.72,Mapleton-Midwood (West)
19-Jul,36047044600,3044600,17481,131468,148949,Brooklyn,1523482.72,Mapleton-Midwood (West)
21-Jul,36047044600,3044600,0,96839,96839,Brooklyn,1523482.72,Mapleton-Midwood (West)
19-Aug,36047044600,3044600,10051,90568,100619,Brooklyn,1523482.72,Mapleton-Midwood (West)
21-Aug,36047044600,3044600,10030,120838,130868,Brooklyn,1523482.72,Mapleton-Midwood (West)
19-May,36047044700,3044700,500,70855,71355,Brooklyn,1752244.62,Bushwick (West)
21-May,36047044700,3044700,8409,12968,21377,Brooklyn,1752244.62,Bushwick (West)
19-Jun,36047044700,3044700,6991,69936,76927,Brooklyn,1752244.62,Bushwick (West)
21-Jun,36047044700,3044700,3637,36405,40042,Brooklyn,1752244.62,Bushwick (West)
19-Jul,36047044700,3044700,0,43791,43791,Brooklyn,1752244.62,Bushwick (West)
21-Jul,36047044700,3044700,0,61519,61519,Brooklyn,1752244.62,Bushwick (West)
19-Aug,36047044700,3044700,11081,135878,146959,Brooklyn,1752244.62,Bushwick (West)
21-Aug,36047044700,3044700,2776,72360,75136,Brooklyn,1752244.62,Bushwick (West)
19-May,36047044800,3044800,0,66317,66317,Brooklyn,2419978.343,Mapleton-Midwood (West)
21-May,36047044800,3044800,8791,125770,134561,Brooklyn,2419978.343,Mapleton-Midwood (West)
19-Jun,36047044800,3044800,2646,71,2717,Brooklyn,2419978.343,Mapleton-Midwood (West)
21-Jun,36047044800,3044800,8782,135071,143853,Brooklyn,2419978.343,Mapleton-Midwood (West)
19-Jul,36047044800,3044800,1571,55081,56652,Brooklyn,2419978.343,Mapleton-Midwood (West)
21-Jul,36047044800,3044800,3905,49223,53128,Brooklyn,2419978.343,Mapleton-Midwood (West)
19-Aug,36047044800,3044800,9864,9887,19751,Brooklyn,2419978.343,Mapleton-Midwood (West)
21-Aug,36047044800,3044800,7263,38568,45831,Brooklyn,2419978.343,Mapleton-Midwood (West)
19-May,36047044901,3044901,13440,99388,112828,Brooklyn,4142652.641,East Williamsburg
21-May,36047044901,3044901,4436,9001,13437,Brooklyn,4142652.641,East Williamsburg
19-Jun,36047044901,3044901,8649,105883,114532,Brooklyn,4142652.641,East Williamsburg
21-Jun,36047044901,3044901,6061,15366,21427,Brooklyn,4142652.641,East Williamsburg
19-Jul,36047044901,3044901,9257,55790,65047,Brooklyn,4142652.641,East Williamsburg
21-Jul,36047044901,3044901,8891,55815,64706,Brooklyn,4142652.641,East Williamsburg
19-Aug,36047044901,3044901,13434,60442,73876,Brooklyn,4142652.641,East Williamsburg
21-Aug,36047044901,3044901,0,71,71,Brooklyn,4142652.641,East Williamsburg
19-May,36047045000,3045000,7652,69200,76852,Brooklyn,2370291.963,Mapleton-Midwood (West)
21-May,36047045000,3045000,8014,46532,54546,Brooklyn,2370291.963,Mapleton-Midwood (West)
19-Jun,36047045000,3045000,12797,121915,134712,Brooklyn,2370291.963,Mapleton-Midwood (West)
21-Jun,36047045000,3045000,11795,68210,80005,Brooklyn,2370291.963,Mapleton-Midwood (West)
19-Jul,36047045000,3045000,3802,56297,60099,Brooklyn,2370291.963,Mapleton-Midwood (West)
21-Jul,36047045000,3045000,7736,57066,64802,Brooklyn,2370291.963,Mapleton-Midwood (West)
19-Aug,36047045000,3045000,8633,63538,72171,Brooklyn,2370291.963,Mapleton-Midwood (West)
21-Aug,36047045000,3045000,9543,52334,61877,Brooklyn,2370291.963,Mapleton-Midwood (West)
19-May,36047045200,3045200,7871,45966,53837,Brooklyn,2005613.052,Mapleton-Midwood (West)
21-May,36047045200,3045200,11206,88510,99716,Brooklyn,2005613.052,Mapleton-Midwood (West)
19-Jun,36047045200,3045200,6633,139636,146269,Brooklyn,2005613.052,Mapleton-Midwood (West)
21-Jun,36047045200,3045200,8436,89549,97985,Brooklyn,2005613.052,Mapleton-Midwood (West)
19-Jul,36047045200,3045200,7454,113816,121270,Brooklyn,2005613.052,Mapleton-Midwood (West)
21-Jul,36047045200,3045200,4794,85788,90582,Brooklyn,2005613.052,Mapleton-Midwood (West)
19-Aug,36047045200,3045200,0,95780,95780,Brooklyn,2005613.052,Mapleton-Midwood (West)
21-Aug,36047045200,3045200,13364,136485,149849,Brooklyn,2005613.052,Mapleton-Midwood (West)
19-May,36047045300,3045300,11504,57401,68905,Brooklyn,3440160.214,East Williamsburg
21-May,36047045300,3045300,8216,101465,109681,Brooklyn,3440160.214,East Williamsburg
19-Jun,36047045300,3045300,0,47239,47239,Brooklyn,3440160.214,East Williamsburg
21-Jun,36047045300,3045300,9341,74265,83606,Brooklyn,3440160.214,East Williamsburg
19-Jul,36047045300,3045300,11091,63136,74227,Brooklyn,3440160.214,East Williamsburg
21-Jul,36047045300,3045300,10257,64124,74381,Brooklyn,3440160.214,East Williamsburg
19-Aug,36047045300,3045300,12528,87203,99731,Brooklyn,3440160.214,East Williamsburg
21-Aug,36047045300,3045300,5104,56010,61114,Brooklyn,3440160.214,East Williamsburg
19-May,36047045400,3045400,8123,41791,49914,Brooklyn,1423881.878,Mapleton-Midwood (West)
21-May,36047045400,3045400,2786,32747,35533,Brooklyn,1423881.878,Mapleton-Midwood (West)
19-Jun,36047045400,3045400,9956,22789,32745,Brooklyn,1423881.878,Mapleton-Midwood (West)
21-Jun,36047045400,3045400,6425,43527,49952,Brooklyn,1423881.878,Mapleton-Midwood (West)
19-Jul,36047045400,3045400,12497,114613,127110,Brooklyn,1423881.878,Mapleton-Midwood (West)
21-Jul,36047045400,3045400,12734,4615,17349,Brooklyn,1423881.878,Mapleton-Midwood (West)
19-Aug,36047045400,3045400,14141,80419,94560,Brooklyn,1423881.878,Mapleton-Midwood (West)
21-Aug,36047045400,3045400,4220,97956,102176,Brooklyn,1423881.878,Mapleton-Midwood (West)
19-May,36047045600,3045600,1020,71,1091,Brooklyn,1653625.131,Mapleton-Midwood (West)
21-May,36047045600,3045600,5310,36886,42196,Brooklyn,1653625.131,Mapleton-Midwood (West)
19-Jun,36047045600,3045600,4961,112281,117242,Brooklyn,1653625.131,Mapleton-Midwood (West)
21-Jun,36047045600,3045600,17328,58608,75936,Brooklyn,1653625.131,Mapleton-Midwood (West)
19-Jul,36047045600,3045600,1967,103461,105428,Brooklyn,1653625.131,Mapleton-Midwood (West)
21-Jul,36047045600,3045600,8702,115711,124413,Brooklyn,1653625.131,Mapleton-Midwood (West)
19-Aug,36047045600,3045600,12361,76697,89058,Brooklyn,1653625.131,Mapleton-Midwood (West)
21-Aug,36047045600,3045600,13862,91058,104920,Brooklyn,1653625.131,Mapleton-Midwood (West)
19-May,36047045800,3045800,133,79703,79836,Brooklyn,1928211.641,Mapleton-Midwood (West)
21-May,36047045800,3045800,6507,95374,101881,Brooklyn,1928211.641,Mapleton-Midwood (West)
19-Jun,36047045800,3045800,1591,90788,92379,Brooklyn,1928211.641,Mapleton-Midwood (West)
21-Jun,36047045800,3045800,10646,96256,106902,Brooklyn,1928211.641,Mapleton-Midwood (West)
19-Jul,36047045800,3045800,3151,30004,33155,Brooklyn,1928211.641,Mapleton-Midwood (West)
21-Jul,36047045800,3045800,1615,126126,127741,Brooklyn,1928211.641,Mapleton-Midwood (West)
19-Aug,36047045800,3045800,4349,34718,39067,Brooklyn,1928211.641,Mapleton-Midwood (West)
21-Aug,36047045800,3045800,5429,68721,74150,Brooklyn,1928211.641,Mapleton-Midwood (West)
19-May,36047046000,3046000,10504,27897,38401,Brooklyn,2107798.14,Flatbush (West)-Ditmas Park-Parkville
21-May,36047046000,3046000,3487,35340,38827,Brooklyn,2107798.14,Flatbush (West)-Ditmas Park-Parkville
19-Jun,36047046000,3046000,6248,85406,91654,Brooklyn,2107798.14,Flatbush (West)-Ditmas Park-Parkville
21-Jun,36047046000,3046000,5402,35586,40988,Brooklyn,2107798.14,Flatbush (West)-Ditmas Park-Parkville
19-Jul,36047046000,3046000,10608,74077,84685,Brooklyn,2107798.14,Flatbush (West)-Ditmas Park-Parkville
21-Jul,36047046000,3046000,13903,48015,61918,Brooklyn,2107798.14,Flatbush (West)-Ditmas Park-Parkville
19-Aug,36047046000,3046000,9768,79228,88996,Brooklyn,2107798.14,Flatbush (West)-Ditmas Park-Parkville
21-Aug,36047046000,3046000,10119,101651,111770,Brooklyn,2107798.14,Flatbush (West)-Ditmas Park-Parkville
19-May,36047046201,3046201,9527,39504,49031,Brooklyn,1381203.808,Flatbush (West)-Ditmas Park-Parkville
21-May,36047046201,3046201,13243,61556,74799,Brooklyn,1381203.808,Flatbush (West)-Ditmas Park-Parkville
19-Jun,36047046201,3046201,15364,28399,43763,Brooklyn,1381203.808,Flatbush (West)-Ditmas Park-Parkville
21-Jun,36047046201,3046201,12127,55930,68057,Brooklyn,1381203.808,Flatbush (West)-Ditmas Park-Parkville
19-Jul,36047046201,3046201,6259,51883,58142,Brooklyn,1381203.808,Flatbush (West)-Ditmas Park-Parkville
21-Jul,36047046201,3046201,8564,88424,96988,Brooklyn,1381203.808,Flatbush (West)-Ditmas Park-Parkville
19-Aug,36047046201,3046201,11143,57390,68533,Brooklyn,1381203.808,Flatbush (West)-Ditmas Park-Parkville
21-Aug,36047046201,3046201,1786,90122,91908,Brooklyn,1381203.808,Flatbush (West)-Ditmas Park-Parkville
19-May,36047046202,3046202,7327,59344,66671,Brooklyn,1866157.456,Mapleton-Midwood (West)
21-May,36047046202,3046202,6603,72908,79511,Brooklyn,1866157.456,Mapleton-Midwood (West)
19-Jun,36047046202,3046202,48,78613,78661,Brooklyn,1866157.456,Mapleton-Midwood (West)
21-Jun,36047046202,3046202,3068,106455,109523,Brooklyn,1866157.456,Mapleton-Midwood (West)
19-Jul,36047046202,3046202,14302,52651,66953,Brooklyn,1866157.456,Mapleton-Midwood (West)
21-Jul,36047046202,3046202,10606,127730,138336,Brooklyn,1866157.456,Mapleton-Midwood (West)
19-Aug,36047046202,3046202,9295,53662,62957,Brooklyn,1866157.456,Mapleton-Midwood (West)
21-Aug,36047046202,3046202,13529,117599,131128,Brooklyn,1866157.456,Mapleton-Midwood (West)
19-May,36047046400,3046400,8766,52318,61084,Brooklyn,1762932.832,Mapleton-Midwood (West)
21-May,36047046400,3046400,9067,25052,34119,Brooklyn,1762932.832,Mapleton-Midwood (West)
19-Jun,36047046400,3046400,8555,1846,10401,Brooklyn,1762932.832,Mapleton-Midwood (West)
21-Jun,36047046400,3046400,13891,43332,57223,Brooklyn,1762932.832,Mapleton-Midwood (West)
19-Jul,36047046400,3046400,4163,38643,42806,Brooklyn,1762932.832,Mapleton-Midwood (West)
21-Jul,36047046400,3046400,11932,124833,136765,Brooklyn,1762932.832,Mapleton-Midwood (West)
19-Aug,36047046400,3046400,3665,112342,116007,Brooklyn,1762932.832,Mapleton-Midwood (West)
21-Aug,36047046400,3046400,8257,77427,85684,Brooklyn,1762932.832,Mapleton-Midwood (West)
19-May,36047046800,3046800,6561,71,6632,Brooklyn,3193544.19,Mapleton-Midwood (West)
21-May,36047046800,3046800,10393,111921,122314,Brooklyn,3193544.19,Mapleton-Midwood (West)
19-Jun,36047046800,3046800,7575,89851,97426,Brooklyn,3193544.19,Mapleton-Midwood (West)
21-Jun,36047046800,3046800,9397,26678,36075,Brooklyn,3193544.19,Mapleton-Midwood (West)
19-Jul,36047046800,3046800,6963,109801,116764,Brooklyn,3193544.19,Mapleton-Midwood (West)
21-Jul,36047046800,3046800,6506,9339,15845,Brooklyn,3193544.19,Mapleton-Midwood (West)
19-Aug,36047046800,3046800,7841,55368,63209,Brooklyn,3193544.19,Mapleton-Midwood (West)
21-Aug,36047046800,3046800,3668,74810,78478,Brooklyn,3193544.19,Mapleton-Midwood (West)
19-May,36047047000,3047000,13422,55352,68774,Brooklyn,1966226.009,Borough Park
21-May,36047047000,3047000,6928,10085,17013,Brooklyn,1966226.009,Borough Park
19-Jun,36047047000,3047000,9824,46358,56182,Brooklyn,1966226.009,Borough Park
21-Jun,36047047000,3047000,14705,52971,67676,Brooklyn,1966226.009,Borough Park
19-Jul,36047047000,3047000,3294,82478,85772,Brooklyn,1966226.009,Borough Park
21-Jul,36047047000,3047000,8435,77864,86299,Brooklyn,1966226.009,Borough Park
19-Aug,36047047000,3047000,0,106994,106994,Brooklyn,1966226.009,Borough Park
21-Aug,36047047000,3047000,6993,100422,107415,Brooklyn,1966226.009,Borough Park
19-May,36047047200,3047200,907,40489,41396,Brooklyn,1850619.25,Borough Park
21-May,36047047200,3047200,7331,70379,77710,Brooklyn,1850619.25,Borough Park
19-Jun,36047047200,3047200,7136,119590,126726,Brooklyn,1850619.25,Borough Park
21-Jun,36047047200,3047200,8712,101211,109923,Brooklyn,1850619.25,Borough Park
19-Jul,36047047200,3047200,7544,32352,39896,Brooklyn,1850619.25,Borough Park
21-Jul,36047047200,3047200,15441,65655,81096,Brooklyn,1850619.25,Borough Park
19-Aug,36047047200,3047200,7571,51288,58859,Brooklyn,1850619.25,Borough Park
21-Aug,36047047200,3047200,6169,139331,145500,Brooklyn,1850619.25,Borough Park
19-May,36047047400,3047400,14643,82727,97370,Brooklyn,1892923.316,Borough Park
21-May,36047047400,3047400,10160,93873,104033,Brooklyn,1892923.316,Borough Park
19-Jun,36047047400,3047400,1092,68583,69675,Brooklyn,1892923.316,Borough Park
21-Jun,36047047400,3047400,11674,71,11745,Brooklyn,1892923.316,Borough Park
19-Jul,36047047400,3047400,22948,88972,111920,Brooklyn,1892923.316,Borough Park
21-Jul,36047047400,3047400,0,68047,68047,Brooklyn,1892923.316,Borough Park
19-Aug,36047047400,3047400,7295,71,7366,Brooklyn,1892923.316,Borough Park
21-Aug,36047047400,3047400,2251,94500,96751,Brooklyn,1892923.316,Borough Park
19-May,36047047600,3047600,8304,76739,85043,Brooklyn,2236222.608,Borough Park
21-May,36047047600,3047600,7485,1739,9224,Brooklyn,2236222.608,Borough Park
19-Jun,36047047600,3047600,12266,130792,143058,Brooklyn,2236222.608,Borough Park
21-Jun,36047047600,3047600,4674,133384,138058,Brooklyn,2236222.608,Borough Park
19-Jul,36047047600,3047600,8956,100957,109913,Brooklyn,2236222.608,Borough Park
21-Jul,36047047600,3047600,3807,38723,42530,Brooklyn,2236222.608,Borough Park
19-Aug,36047047600,3047600,16111,70536,86647,Brooklyn,2236222.608,Borough Park
21-Aug,36047047600,3047600,7829,141440,149269,Brooklyn,2236222.608,Borough Park
19-May,36047047700,3047700,11765,121315,133080,Brooklyn,2342850.518,East Williamsburg
21-May,36047047700,3047700,5857,85303,91160,Brooklyn,2342850.518,East Williamsburg
19-Jun,36047047700,3047700,8582,86170,94752,Brooklyn,2342850.518,East Williamsburg
21-Jun,36047047700,3047700,18943,170196,189139,Brooklyn,2342850.518,East Williamsburg
19-Jul,36047047700,3047700,1087,31488,32575,Brooklyn,2342850.518,East Williamsburg
21-Jul,36047047700,3047700,0,29832,29832,Brooklyn,2342850.518,East Williamsburg
19-Aug,36047047700,3047700,14062,75570,89632,Brooklyn,2342850.518,East Williamsburg
21-Aug,36047047700,3047700,10337,75599,85936,Brooklyn,2342850.518,East Williamsburg
19-May,36047047800,3047800,7274,116390,123664,Brooklyn,2380722.015,Borough Park
21-May,36047047800,3047800,12643,88970,101613,Brooklyn,2380722.015,Borough Park
19-Jun,36047047800,3047800,9562,132822,142384,Brooklyn,2380722.015,Borough Park
21-Jun,36047047800,3047800,1847,99964,101811,Brooklyn,2380722.015,Borough Park
19-Jul,36047047800,3047800,13595,92596,106191,Brooklyn,2380722.015,Borough Park
21-Jul,36047047800,3047800,13786,43665,57451,Brooklyn,2380722.015,Borough Park
19-Aug,36047047800,3047800,15274,297,15571,Brooklyn,2380722.015,Borough Park
21-Aug,36047047800,3047800,9556,43492,53048,Brooklyn,2380722.015,Borough Park
19-May,36047048000,3048000,9018,66281,75299,Brooklyn,1643769.372,Flatbush (West)-Ditmas Park-Parkville
21-May,36047048000,3048000,0,53365,53365,Brooklyn,1643769.372,Flatbush (West)-Ditmas Park-Parkville
19-Jun,36047048000,3048000,3793,80397,84190,Brooklyn,1643769.372,Flatbush (West)-Ditmas Park-Parkville
21-Jun,36047048000,3048000,5736,97624,103360,Brooklyn,1643769.372,Flatbush (West)-Ditmas Park-Parkville
19-Jul,36047048000,3048000,5495,63839,69334,Brooklyn,1643769.372,Flatbush (West)-Ditmas Park-Parkville
21-Jul,36047048000,3048000,12470,105997,118467,Brooklyn,1643769.372,Flatbush (West)-Ditmas Park-Parkville
19-Aug,36047048000,3048000,10979,40929,51908,Brooklyn,1643769.372,Flatbush (West)-Ditmas Park-Parkville
21-Aug,36047048000,3048000,9469,67237,76706,Brooklyn,1643769.372,Flatbush (West)-Ditmas Park-Parkville
19-May,36047048200,3048200,7342,137901,145243,Brooklyn,2121452.664,Flatbush (West)-Ditmas Park-Parkville
21-May,36047048200,3048200,9082,71,9153,Brooklyn,2121452.664,Flatbush (West)-Ditmas Park-Parkville
19-Jun,36047048200,3048200,7460,45825,53285,Brooklyn,2121452.664,Flatbush (West)-Ditmas Park-Parkville
21-Jun,36047048200,3048200,11482,69645,81127,Brooklyn,2121452.664,Flatbush (West)-Ditmas Park-Parkville
19-Jul,36047048200,3048200,5762,74585,80347,Brooklyn,2121452.664,Flatbush (West)-Ditmas Park-Parkville
21-Jul,36047048200,3048200,10882,64786,75668,Brooklyn,2121452.664,Flatbush (West)-Ditmas Park-Parkville
19-Aug,36047048200,3048200,9852,65982,75834,Brooklyn,2121452.664,Flatbush (West)-Ditmas Park-Parkville
21-Aug,36047048200,3048200,11311,13021,24332,Brooklyn,2121452.664,Flatbush (West)-Ditmas Park-Parkville
19-May,36047048400,3048400,9013,40222,49235,Brooklyn,2251840.732,Kensington
21-May,36047048400,3048400,0,68170,68170,Brooklyn,2251840.732,Kensington
19-Jun,36047048400,3048400,6142,51727,57869,Brooklyn,2251840.732,Kensington
21-Jun,36047048400,3048400,11780,1489,13269,Brooklyn,2251840.732,Kensington
19-Jul,36047048400,3048400,4998,93445,98443,Brooklyn,2251840.732,Kensington
21-Jul,36047048400,3048400,6175,83816,89991,Brooklyn,2251840.732,Kensington
19-Aug,36047048400,3048400,6782,14048,20830,Brooklyn,2251840.732,Kensington
21-Aug,36047048400,3048400,14184,64316,78500,Brooklyn,2251840.732,Kensington
19-May,36047048500,3048500,12660,90898,103558,Brooklyn,6259294.181,East Williamsburg
21-May,36047048500,3048500,1174,36995,38169,Brooklyn,6259294.181,East Williamsburg
19-Jun,36047048500,3048500,5067,77286,82353,Brooklyn,6259294.181,East Williamsburg
21-Jun,36047048500,3048500,8841,71634,80475,Brooklyn,6259294.181,East Williamsburg
19-Jul,36047048500,3048500,9994,84662,94656,Brooklyn,6259294.181,East Williamsburg
21-Jul,36047048500,3048500,12888,83161,96049,Brooklyn,6259294.181,East Williamsburg
19-Aug,36047048500,3048500,13737,114296,128033,Brooklyn,6259294.181,East Williamsburg
21-Aug,36047048500,3048500,11829,93135,104964,Brooklyn,6259294.181,East Williamsburg
19-May,36047048600,3048600,3464,33005,36469,Brooklyn,1888238.852,Kensington
21-May,36047048600,3048600,9433,71597,81030,Brooklyn,1888238.852,Kensington
19-Jun,36047048600,3048600,10521,96213,106734,Brooklyn,1888238.852,Kensington
21-Jun,36047048600,3048600,3661,46898,50559,Brooklyn,1888238.852,Kensington
19-Jul,36047048600,3048600,9600,29338,38938,Brooklyn,1888238.852,Kensington
21-Jul,36047048600,3048600,10943,77809,88752,Brooklyn,1888238.852,Kensington
19-Aug,36047048600,3048600,4200,146240,150440,Brooklyn,1888238.852,Kensington
21-Aug,36047048600,3048600,14726,54214,68940,Brooklyn,1888238.852,Kensington
19-May,36047048800,3048800,1704,26197,27901,Brooklyn,1542860.213,Kensington
21-May,36047048800,3048800,14155,128971,143126,Brooklyn,1542860.213,Kensington
19-Jun,36047048800,3048800,16663,78565,95228,Brooklyn,1542860.213,Kensington
21-Jun,36047048800,3048800,9848,70447,80295,Brooklyn,1542860.213,Kensington
19-Jul,36047048800,3048800,8233,79517,87750,Brooklyn,1542860.213,Kensington
21-Jul,36047048800,3048800,10603,143276,153879,Brooklyn,1542860.213,Kensington
19-Aug,36047048800,3048800,9124,115401,124525,Brooklyn,1542860.213,Kensington
21-Aug,36047048800,3048800,9886,52654,62540,Brooklyn,1542860.213,Kensington
19-May,36047048900,3048900,10976,102503,113479,Brooklyn,985798.4155,East Williamsburg
21-May,36047048900,3048900,7069,132456,139525,Brooklyn,985798.4155,East Williamsburg
19-Jun,36047048900,3048900,11732,85591,97323,Brooklyn,985798.4155,East Williamsburg
21-Jun,36047048900,3048900,516,83939,84455,Brooklyn,985798.4155,East Williamsburg
19-Jul,36047048900,3048900,11122,63530,74652,Brooklyn,985798.4155,East Williamsburg
21-Jul,36047048900,3048900,6625,91016,97641,Brooklyn,985798.4155,East Williamsburg
19-Aug,36047048900,3048900,1676,12192,13868,Brooklyn,985798.4155,East Williamsburg
21-Aug,36047048900,3048900,17127,79024,96151,Brooklyn,985798.4155,East Williamsburg
19-May,36047049000,3049000,1549,115121,116670,Brooklyn,2074872.371,Kensington
21-May,36047049000,3049000,5375,109605,114980,Brooklyn,2074872.371,Kensington
19-Jun,36047049000,3049000,4913,78533,83446,Brooklyn,2074872.371,Kensington
21-Jun,36047049000,3049000,8350,114941,123291,Brooklyn,2074872.371,Kensington
19-Jul,36047049000,3049000,16853,112937,129790,Brooklyn,2074872.371,Kensington
21-Jul,36047049000,3049000,16228,107680,123908,Brooklyn,2074872.371,Kensington
19-Aug,36047049000,3049000,2855,113184,116039,Brooklyn,2074872.371,Kensington
21-Aug,36047049000,3049000,9828,115064,124892,Brooklyn,2074872.371,Kensington
19-May,36047049100,3049100,7621,30861,38482,Brooklyn,2294137.532,East Williamsburg
21-May,36047049100,3049100,14133,90259,104392,Brooklyn,2294137.532,East Williamsburg
19-Jun,36047049100,3049100,7547,10347,17894,Brooklyn,2294137.532,East Williamsburg
21-Jun,36047049100,3049100,7406,185387,192793,Brooklyn,2294137.532,East Williamsburg
19-Jul,36047049100,3049100,9929,37061,46990,Brooklyn,2294137.532,East Williamsburg
21-Jul,36047049100,3049100,8775,71,8846,Brooklyn,2294137.532,East Williamsburg
19-Aug,36047049100,3049100,11623,75750,87373,Brooklyn,2294137.532,East Williamsburg
21-Aug,36047049100,3049100,3598,75906,79504,Brooklyn,2294137.532,East Williamsburg
19-May,36047049200,3049200,7188,34909,42097,Brooklyn,1780102.533,Kensington
21-May,36047049200,3049200,5463,10223,15686,Brooklyn,1780102.533,Kensington
19-Jun,36047049200,3049200,5301,82238,87539,Brooklyn,1780102.533,Kensington
21-Jun,36047049200,3049200,9784,48469,58253,Brooklyn,1780102.533,Kensington
19-Jul,36047049200,3049200,10898,33084,43982,Brooklyn,1780102.533,Kensington
21-Jul,36047049200,3049200,0,139398,139398,Brooklyn,1780102.533,Kensington
19-Aug,36047049200,3049200,9274,94810,104084,Brooklyn,1780102.533,Kensington
21-Aug,36047049200,3049200,9782,64249,74031,Brooklyn,1780102.533,Kensington
19-May,36047049301,3049301,6808,29488,36296,Brooklyn,730013.0267,East Williamsburg
21-May,36047049301,3049301,14258,137267,151525,Brooklyn,730013.0267,East Williamsburg
19-Jun,36047049301,3049301,5377,152001,157378,Brooklyn,730013.0267,East Williamsburg
21-Jun,36047049301,3049301,10266,160966,171232,Brooklyn,730013.0267,East Williamsburg
19-Jul,36047049301,3049301,3881,40926,44807,Brooklyn,730013.0267,East Williamsburg
21-Jul,36047049301,3049301,4354,121744,126098,Brooklyn,730013.0267,East Williamsburg
19-Aug,36047049301,3049301,10168,71,10239,Brooklyn,730013.0267,East Williamsburg
21-Aug,36047049301,3049301,4863,158096,162959,Brooklyn,730013.0267,East Williamsburg
19-May,36047049302,3049302,8112,17249,25361,Brooklyn,1724511.678,East Williamsburg
21-May,36047049302,3049302,5528,90036,95564,Brooklyn,1724511.678,East Williamsburg
19-Jun,36047049302,3049302,7273,49514,56787,Brooklyn,1724511.678,East Williamsburg
21-Jun,36047049302,3049302,11665,54101,65766,Brooklyn,1724511.678,East Williamsburg
19-Jul,36047049302,3049302,9021,102422,111443,Brooklyn,1724511.678,East Williamsburg
21-Jul,36047049302,3049302,9020,70926,79946,Brooklyn,1724511.678,East Williamsburg
19-Aug,36047049302,3049302,5244,83586,88830,Brooklyn,1724511.678,East Williamsburg
21-Aug,36047049302,3049302,14989,68330,83319,Brooklyn,1724511.678,East Williamsburg
19-May,36047049400,3049400,3835,2869,6704,Brooklyn,1970839.689,Kensington
21-May,36047049400,3049400,7532,71,7603,Brooklyn,1970839.689,Kensington
19-Jun,36047049400,3049400,0,68341,68341,Brooklyn,1970839.689,Kensington
21-Jun,36047049400,3049400,6368,68397,74765,Brooklyn,1970839.689,Kensington
19-Jul,36047049400,3049400,11792,57298,69090,Brooklyn,1970839.689,Kensington
21-Jul,36047049400,3049400,21231,71,21302,Brooklyn,1970839.689,Kensington
19-Aug,36047049400,3049400,2591,47782,50373,Brooklyn,1970839.689,Kensington
21-Aug,36047049400,3049400,8678,71,8749,Brooklyn,1970839.689,Kensington
19-May,36047049500,3049500,4526,81809,86335,Brooklyn,1389722.75,East Williamsburg
21-May,36047049500,3049500,6483,147488,153971,Brooklyn,1389722.75,East Williamsburg
19-Jun,36047049500,3049500,9318,99981,109299,Brooklyn,1389722.75,East Williamsburg
21-Jun,36047049500,3049500,8930,49924,58854,Brooklyn,1389722.75,East Williamsburg
19-Jul,36047049500,3049500,4966,88010,92976,Brooklyn,1389722.75,East Williamsburg
21-Jul,36047049500,3049500,7187,71,7258,Brooklyn,1389722.75,East Williamsburg
19-Aug,36047049500,3049500,18889,98273,117162,Brooklyn,1389722.75,East Williamsburg
21-Aug,36047049500,3049500,258,123262,123520,Brooklyn,1389722.75,East Williamsburg
19-May,36047049600,3049600,4206,96455,100661,Brooklyn,2184807.484,Kensington
21-May,36047049600,3049600,10490,3586,14076,Brooklyn,2184807.484,Kensington
19-Jun,36047049600,3049600,10655,57528,68183,Brooklyn,2184807.484,Kensington
21-Jun,36047049600,3049600,1203,27692,28895,Brooklyn,2184807.484,Kensington
19-Jul,36047049600,3049600,4183,30285,34468,Brooklyn,2184807.484,Kensington
21-Jul,36047049600,3049600,4622,82909,87531,Brooklyn,2184807.484,Kensington
19-Aug,36047049600,3049600,11944,93708,105652,Brooklyn,2184807.484,Kensington
21-Aug,36047049600,3049600,9326,51137,60463,Brooklyn,2184807.484,Kensington
19-May,36047049700,3049700,7161,24225,31386,Brooklyn,1772556.572,East Williamsburg
21-May,36047049700,3049700,17338,79874,97212,Brooklyn,1772556.572,East Williamsburg
19-Jun,36047049700,3049700,11139,59230,70369,Brooklyn,1772556.572,East Williamsburg
21-Jun,36047049700,3049700,7324,45186,52510,Brooklyn,1772556.572,East Williamsburg
19-Jul,36047049700,3049700,9967,74649,84616,Brooklyn,1772556.572,East Williamsburg
21-Jul,36047049700,3049700,11129,84447,95576,Brooklyn,1772556.572,East Williamsburg
19-Aug,36047049700,3049700,14139,54597,68736,Brooklyn,1772556.572,East Williamsburg
21-Aug,36047049700,3049700,12000,29072,41072,Brooklyn,1772556.572,East Williamsburg
19-May,36047049800,3049800,10314,59610,69924,Brooklyn,2199772.108,Kensington
21-May,36047049800,3049800,12477,156228,168705,Brooklyn,2199772.108,Kensington
19-Jun,36047049800,3049800,10060,58821,68881,Brooklyn,2199772.108,Kensington
21-Jun,36047049800,3049800,12892,27821,40713,Brooklyn,2199772.108,Kensington
19-Jul,36047049800,3049800,3820,86272,90092,Brooklyn,2199772.108,Kensington
21-Jul,36047049800,3049800,7237,90736,97973,Brooklyn,2199772.108,Kensington
19-Aug,36047049800,3049800,10446,56224,66670,Brooklyn,2199772.108,Kensington
21-Aug,36047049800,3049800,7132,65669,72801,Brooklyn,2199772.108,Kensington
19-May,36047050002,3050002,8013,120885,128898,Brooklyn,661680.2038,Kensington
21-May,36047050002,3050002,13888,76546,90434,Brooklyn,661680.2038,Kensington
19-Jun,36047050002,3050002,15814,6972,22786,Brooklyn,661680.2038,Kensington
21-Jun,36047050002,3050002,10499,50606,61105,Brooklyn,661680.2038,Kensington
19-Jul,36047050002,3050002,9278,42762,52040,Brooklyn,661680.2038,Kensington
21-Jul,36047050002,3050002,4154,89355,93509,Brooklyn,661680.2038,Kensington
19-Aug,36047050002,3050002,15612,70724,86336,Brooklyn,661680.2038,Kensington
21-Aug,36047050002,3050002,8411,54851,63262,Brooklyn,661680.2038,Kensington
19-May,36047050300,3050300,6900,71,6971,Brooklyn,1348755.441,East Williamsburg
21-May,36047050300,3050300,6919,36847,43766,Brooklyn,1348755.441,East Williamsburg
19-Jun,36047050300,3050300,13219,13954,27173,Brooklyn,1348755.441,East Williamsburg
21-Jun,36047050300,3050300,0,115909,115909,Brooklyn,1348755.441,East Williamsburg
19-Jul,36047050300,3050300,13226,50067,63293,Brooklyn,1348755.441,East Williamsburg
21-Jul,36047050300,3050300,6334,34762,41096,Brooklyn,1348755.441,East Williamsburg
19-Aug,36047050300,3050300,4771,43856,48627,Brooklyn,1348755.441,East Williamsburg
21-Aug,36047050300,3050300,14129,104327,118456,Brooklyn,1348755.441,East Williamsburg
19-May,36047050402,3050402,18022,59802,77824,Brooklyn,916214.4616,Kensington
21-May,36047050402,3050402,2976,67039,70015,Brooklyn,916214.4616,Kensington
19-Jun,36047050402,3050402,9885,77851,87736,Brooklyn,916214.4616,Kensington
21-Jun,36047050402,3050402,9127,98276,107403,Brooklyn,916214.4616,Kensington
19-Jul,36047050402,3050402,9990,143434,153424,Brooklyn,916214.4616,Kensington
21-Jul,36047050402,3050402,8397,82720,91117,Brooklyn,916214.4616,Kensington
19-Aug,36047050402,3050402,14974,117500,132474,Brooklyn,916214.4616,Kensington
21-Aug,36047050402,3050402,13093,41501,54594,Brooklyn,916214.4616,Kensington
19-May,36047050500,3050500,11471,35337,46808,Brooklyn,1823285.596,East Williamsburg
21-May,36047050500,3050500,2933,14185,17118,Brooklyn,1823285.596,East Williamsburg
19-Jun,36047050500,3050500,3179,59112,62291,Brooklyn,1823285.596,East Williamsburg
21-Jun,36047050500,3050500,19953,65596,85549,Brooklyn,1823285.596,East Williamsburg
19-Jul,36047050500,3050500,7732,23414,31146,Brooklyn,1823285.596,East Williamsburg
21-Jul,36047050500,3050500,14048,137951,151999,Brooklyn,1823285.596,East Williamsburg
19-Aug,36047050500,3050500,3708,103607,107315,Brooklyn,1823285.596,East Williamsburg
21-Aug,36047050500,3050500,3071,42719,45790,Brooklyn,1823285.596,East Williamsburg
19-May,36047050700,3050700,10682,124916,135598,Brooklyn,1877637.027,South Williamsburg
21-May,36047050700,3050700,16230,100427,116657,Brooklyn,1877637.027,South Williamsburg
19-Jun,36047050700,3050700,15810,73861,89671,Brooklyn,1877637.027,South Williamsburg
21-Jun,36047050700,3050700,7044,2971,10015,Brooklyn,1877637.027,South Williamsburg
19-Jul,36047050700,3050700,6975,45307,52282,Brooklyn,1877637.027,South Williamsburg
21-Jul,36047050700,3050700,10823,71,10894,Brooklyn,1877637.027,South Williamsburg
19-Aug,36047050700,3050700,14124,91691,105815,Brooklyn,1877637.027,South Williamsburg
21-Aug,36047050700,3050700,6107,7046,13153,Brooklyn,1877637.027,South Williamsburg
19-May,36047050801,3050801,15445,4485,19930,Brooklyn,843739.4891,Flatbush
21-May,36047050801,3050801,0,64040,64040,Brooklyn,843739.4891,Flatbush
19-Jun,36047050801,3050801,1620,42341,43961,Brooklyn,843739.4891,Flatbush
21-Jun,36047050801,3050801,6089,85658,91747,Brooklyn,843739.4891,Flatbush
19-Jul,36047050801,3050801,11356,9321,20677,Brooklyn,843739.4891,Flatbush
21-Jul,36047050801,3050801,14522,36620,51142,Brooklyn,843739.4891,Flatbush
19-Aug,36047050801,3050801,8202,51982,60184,Brooklyn,843739.4891,Flatbush
21-Aug,36047050801,3050801,6191,39124,45315,Brooklyn,843739.4891,Flatbush
19-May,36047050804,3050804,0,73715,73715,Brooklyn,1110945.7,Flatbush
21-May,36047050804,3050804,14275,29301,43576,Brooklyn,1110945.7,Flatbush
19-Jun,36047050804,3050804,8008,71,8079,Brooklyn,1110945.7,Flatbush
21-Jun,36047050804,3050804,9561,114574,124135,Brooklyn,1110945.7,Flatbush
19-Jul,36047050804,3050804,4877,54000,58877,Brooklyn,1110945.7,Flatbush
21-Jul,36047050804,3050804,4091,71,4162,Brooklyn,1110945.7,Flatbush
19-Aug,36047050804,3050804,13681,76329,90010,Brooklyn,1110945.7,Flatbush
21-Aug,36047050804,3050804,7125,21195,28320,Brooklyn,1110945.7,Flatbush
19-May,36047050900,3050900,8152,82333,90485,Brooklyn,1526103.187,South Williamsburg
21-May,36047050900,3050900,4054,74837,78891,Brooklyn,1526103.187,South Williamsburg
19-Jun,36047050900,3050900,15587,134728,150315,Brooklyn,1526103.187,South Williamsburg
21-Jun,36047050900,3050900,5624,54935,60559,Brooklyn,1526103.187,South Williamsburg
19-Jul,36047050900,3050900,10376,70857,81233,Brooklyn,1526103.187,South Williamsburg
21-Jul,36047050900,3050900,6050,78661,84711,Brooklyn,1526103.187,South Williamsburg
19-Aug,36047050900,3050900,8822,71,8893,Brooklyn,1526103.187,South Williamsburg
21-Aug,36047050900,3050900,3860,65854,69714,Brooklyn,1526103.187,South Williamsburg
19-May,36047051001,3051001,7699,75767,83466,Brooklyn,828176.3974,Flatbush
21-May,36047051001,3051001,3019,93875,96894,Brooklyn,828176.3974,Flatbush
19-Jun,36047051001,3051001,12302,76522,88824,Brooklyn,828176.3974,Flatbush
21-Jun,36047051001,3051001,17793,71,17864,Brooklyn,828176.3974,Flatbush
19-Jul,36047051001,3051001,11413,9650,21063,Brooklyn,828176.3974,Flatbush
21-Jul,36047051001,3051001,15214,39516,54730,Brooklyn,828176.3974,Flatbush
19-Aug,36047051001,3051001,5546,47984,53530,Brooklyn,828176.3974,Flatbush
21-Aug,36047051001,3051001,1749,56166,57915,Brooklyn,828176.3974,Flatbush
19-May,36047051002,3051002,2558,96232,98790,Brooklyn,1152098.814,Flatbush
21-May,36047051002,3051002,6660,122732,129392,Brooklyn,1152098.814,Flatbush
19-Jun,36047051002,3051002,8843,63859,72702,Brooklyn,1152098.814,Flatbush
21-Jun,36047051002,3051002,3684,30053,33737,Brooklyn,1152098.814,Flatbush
19-Jul,36047051002,3051002,2553,60893,63446,Brooklyn,1152098.814,Flatbush
21-Jul,36047051002,3051002,8177,80590,88767,Brooklyn,1152098.814,Flatbush
19-Aug,36047051002,3051002,1257,140236,141493,Brooklyn,1152098.814,Flatbush
21-Aug,36047051002,3051002,8314,122613,130927,Brooklyn,1152098.814,Flatbush
19-May,36047051100,3051100,11343,54322,65665,Brooklyn,1711548.91,East Williamsburg
21-May,36047051100,3051100,7753,30647,38400,Brooklyn,1711548.91,East Williamsburg
19-Jun,36047051100,3051100,5710,106207,111917,Brooklyn,1711548.91,East Williamsburg
21-Jun,36047051100,3051100,11859,65164,77023,Brooklyn,1711548.91,East Williamsburg
19-Jul,36047051100,3051100,8439,44582,53021,Brooklyn,1711548.91,East Williamsburg
21-Jul,36047051100,3051100,8444,132581,141025,Brooklyn,1711548.91,East Williamsburg
19-Aug,36047051100,3051100,876,123414,124290,Brooklyn,1711548.91,East Williamsburg
21-Aug,36047051100,3051100,12345,55055,67400,Brooklyn,1711548.91,East Williamsburg
19-May,36047051300,3051300,13093,98624,111717,Brooklyn,2775918.877,Williamsburg
21-May,36047051300,3051300,1451,115042,116493,Brooklyn,2775918.877,Williamsburg
19-Jun,36047051300,3051300,8401,160836,169237,Brooklyn,2775918.877,Williamsburg
21-Jun,36047051300,3051300,2668,103407,106075,Brooklyn,2775918.877,Williamsburg
19-Jul,36047051300,3051300,12982,73551,86533,Brooklyn,2775918.877,Williamsburg
21-Jul,36047051300,3051300,9994,131398,141392,Brooklyn,2775918.877,Williamsburg
19-Aug,36047051300,3051300,4591,88719,93310,Brooklyn,2775918.877,Williamsburg
21-Aug,36047051300,3051300,6954,126153,133107,Brooklyn,2775918.877,Williamsburg
19-May,36047051400,3051400,703,65829,66532,Brooklyn,1949161.598,Flatbush
21-May,36047051400,3051400,1746,86508,88254,Brooklyn,1949161.598,Flatbush
19-Jun,36047051400,3051400,5887,81177,87064,Brooklyn,1949161.598,Flatbush
21-Jun,36047051400,3051400,9079,119458,128537,Brooklyn,1949161.598,Flatbush
19-Jul,36047051400,3051400,12337,73337,85674,Brooklyn,1949161.598,Flatbush
21-Jul,36047051400,3051400,18226,46891,65117,Brooklyn,1949161.598,Flatbush
19-Aug,36047051400,3051400,6843,65886,72729,Brooklyn,1949161.598,Flatbush
21-Aug,36047051400,3051400,10102,23902,34004,Brooklyn,1949161.598,Flatbush
19-May,36047051601,3051601,8325,15691,24016,Brooklyn,1247781.405,Flatbush
21-May,36047051601,3051601,206,60575,60781,Brooklyn,1247781.405,Flatbush
19-Jun,36047051601,3051601,1077,90389,91466,Brooklyn,1247781.405,Flatbush
21-Jun,36047051601,3051601,9170,5943,15113,Brooklyn,1247781.405,Flatbush
19-Jul,36047051601,3051601,11138,64693,75831,Brooklyn,1247781.405,Flatbush
21-Jul,36047051601,3051601,12816,9496,22312,Brooklyn,1247781.405,Flatbush
19-Aug,36047051601,3051601,15238,22704,37942,Brooklyn,1247781.405,Flatbush
21-Aug,36047051601,3051601,0,54342,54342,Brooklyn,1247781.405,Flatbush
19-May,36047051602,3051602,3201,44617,47818,Brooklyn,979567.9836,Flatbush
21-May,36047051602,3051602,11260,56801,68061,Brooklyn,979567.9836,Flatbush
19-Jun,36047051602,3051602,11828,12294,24122,Brooklyn,979567.9836,Flatbush
21-Jun,36047051602,3051602,3122,117648,120770,Brooklyn,979567.9836,Flatbush
19-Jul,36047051602,3051602,0,71,71,Brooklyn,979567.9836,Flatbush
21-Jul,36047051602,3051602,11376,162350,173726,Brooklyn,979567.9836,Flatbush
19-Aug,36047051602,3051602,7373,149832,157205,Brooklyn,979567.9836,Flatbush
21-Aug,36047051602,3051602,8073,73945,82018,Brooklyn,979567.9836,Flatbush
19-May,36047051700,3051700,6532,109466,115998,Brooklyn,2020312.392,Williamsburg
21-May,36047051700,3051700,13162,115741,128903,Brooklyn,2020312.392,Williamsburg
19-Jun,36047051700,3051700,14424,60036,74460,Brooklyn,2020312.392,Williamsburg
21-Jun,36047051700,3051700,6313,51761,58074,Brooklyn,2020312.392,Williamsburg
19-Jul,36047051700,3051700,10397,75419,85816,Brooklyn,2020312.392,Williamsburg
21-Jul,36047051700,3051700,0,72821,72821,Brooklyn,2020312.392,Williamsburg
19-Aug,36047051700,3051700,16502,70439,86941,Brooklyn,2020312.392,Williamsburg
21-Aug,36047051700,3051700,15937,107235,123172,Brooklyn,2020312.392,Williamsburg
19-May,36047051800,3051800,13446,108058,121504,Brooklyn,2170111.414,Flatbush (West)-Ditmas Park-Parkville
21-May,36047051800,3051800,2486,88301,90787,Brooklyn,2170111.414,Flatbush (West)-Ditmas Park-Parkville
19-Jun,36047051800,3051800,1953,86323,88276,Brooklyn,2170111.414,Flatbush (West)-Ditmas Park-Parkville
21-Jun,36047051800,3051800,2934,103787,106721,Brooklyn,2170111.414,Flatbush (West)-Ditmas Park-Parkville
19-Jul,36047051800,3051800,19680,136027,155707,Brooklyn,2170111.414,Flatbush (West)-Ditmas Park-Parkville
21-Jul,36047051800,3051800,7419,115179,122598,Brooklyn,2170111.414,Flatbush (West)-Ditmas Park-Parkville
19-Aug,36047051800,3051800,11899,73656,85555,Brooklyn,2170111.414,Flatbush (West)-Ditmas Park-Parkville
21-Aug,36047051800,3051800,10881,85242,96123,Brooklyn,2170111.414,Flatbush (West)-Ditmas Park-Parkville
19-May,36047051900,3051900,9989,54872,64861,Brooklyn,2959027.895,Williamsburg
21-May,36047051900,3051900,4277,65094,69371,Brooklyn,2959027.895,Williamsburg
19-Jun,36047051900,3051900,11420,48906,60326,Brooklyn,2959027.895,Williamsburg
21-Jun,36047051900,3051900,1522,54334,55856,Brooklyn,2959027.895,Williamsburg
19-Jul,36047051900,3051900,7069,30269,37338,Brooklyn,2959027.895,Williamsburg
21-Jul,36047051900,3051900,18654,78428,97082,Brooklyn,2959027.895,Williamsburg
19-Aug,36047051900,3051900,5816,33063,38879,Brooklyn,2959027.895,Williamsburg
21-Aug,36047051900,3051900,8221,115781,124002,Brooklyn,2959027.895,Williamsburg
19-May,36047052000,3052000,9356,102951,112307,Brooklyn,2056594.592,Flatbush (West)-Ditmas Park-Parkville
21-May,36047052000,3052000,2387,58299,60686,Brooklyn,2056594.592,Flatbush (West)-Ditmas Park-Parkville
19-Jun,36047052000,3052000,10567,12394,22961,Brooklyn,2056594.592,Flatbush (West)-Ditmas Park-Parkville
21-Jun,36047052000,3052000,6013,92426,98439,Brooklyn,2056594.592,Flatbush (West)-Ditmas Park-Parkville
19-Jul,36047052000,3052000,9337,65375,74712,Brooklyn,2056594.592,Flatbush (West)-Ditmas Park-Parkville
21-Jul,36047052000,3052000,12668,13566,26234,Brooklyn,2056594.592,Flatbush (West)-Ditmas Park-Parkville
19-Aug,36047052000,3052000,3214,66462,69676,Brooklyn,2056594.592,Flatbush (West)-Ditmas Park-Parkville
21-Aug,36047052000,3052000,12683,113349,126032,Brooklyn,2056594.592,Flatbush (West)-Ditmas Park-Parkville
19-May,36047052300,3052300,5641,61628,67269,Brooklyn,1555953.932,Williamsburg
21-May,36047052300,3052300,5789,85375,91164,Brooklyn,1555953.932,Williamsburg
19-Jun,36047052300,3052300,12461,25479,37940,Brooklyn,1555953.932,Williamsburg
21-Jun,36047052300,3052300,14886,58527,73413,Brooklyn,1555953.932,Williamsburg
19-Jul,36047052300,3052300,12568,22080,34648,Brooklyn,1555953.932,Williamsburg
21-Jul,36047052300,3052300,9731,111334,121065,Brooklyn,1555953.932,Williamsburg
19-Aug,36047052300,3052300,8353,89999,98352,Brooklyn,1555953.932,Williamsburg
21-Aug,36047052300,3052300,14853,42220,57073,Brooklyn,1555953.932,Williamsburg
19-May,36047052500,3052500,11557,106200,117757,Brooklyn,1340183.557,Williamsburg
21-May,36047052500,3052500,10165,70233,80398,Brooklyn,1340183.557,Williamsburg
19-Jun,36047052500,3052500,6391,25685,32076,Brooklyn,1340183.557,Williamsburg
21-Jun,36047052500,3052500,13002,72873,85875,Brooklyn,1340183.557,Williamsburg
19-Jul,36047052500,3052500,4669,116973,121642,Brooklyn,1340183.557,Williamsburg
21-Jul,36047052500,3052500,2443,85025,87468,Brooklyn,1340183.557,Williamsburg
19-Aug,36047052500,3052500,16127,34792,50919,Brooklyn,1340183.557,Williamsburg
21-Aug,36047052500,3052500,2884,138052,140936,Brooklyn,1340183.557,Williamsburg
19-May,36047052600,3052600,7571,60207,67778,Brooklyn,1823527.097,Flatbush (West)-Ditmas Park-Parkville
21-May,36047052600,3052600,11299,71061,82360,Brooklyn,1823527.097,Flatbush (West)-Ditmas Park-Parkville
19-Jun,36047052600,3052600,7500,124161,131661,Brooklyn,1823527.097,Flatbush (West)-Ditmas Park-Parkville
21-Jun,36047052600,3052600,13941,144836,158777,Brooklyn,1823527.097,Flatbush (West)-Ditmas Park-Parkville
19-Jul,36047052600,3052600,15455,101963,117418,Brooklyn,1823527.097,Flatbush (West)-Ditmas Park-Parkville
21-Jul,36047052600,3052600,18574,33880,52454,Brooklyn,1823527.097,Flatbush (West)-Ditmas Park-Parkville
19-Aug,36047052600,3052600,13561,118358,131919,Brooklyn,1823527.097,Flatbush (West)-Ditmas Park-Parkville
21-Aug,36047052600,3052600,5660,12059,17719,Brooklyn,1823527.097,Flatbush (West)-Ditmas Park-Parkville
19-May,36047052700,3052700,6207,77691,83898,Brooklyn,2047896.171,Williamsburg
21-May,36047052700,3052700,14768,60834,75602,Brooklyn,2047896.171,Williamsburg
19-Jun,36047052700,3052700,7973,29289,37262,Brooklyn,2047896.171,Williamsburg
21-Jun,36047052700,3052700,10922,49246,60168,Brooklyn,2047896.171,Williamsburg
19-Jul,36047052700,3052700,16587,680,17267,Brooklyn,2047896.171,Williamsburg
21-Jul,36047052700,3052700,3933,22522,26455,Brooklyn,2047896.171,Williamsburg
19-Aug,36047052700,3052700,16093,66698,82791,Brooklyn,2047896.171,Williamsburg
21-Aug,36047052700,3052700,8375,81514,89889,Brooklyn,2047896.171,Williamsburg
19-May,36047052800,3052800,7190,63409,70599,Brooklyn,1891640.287,Flatbush (West)-Ditmas Park-Parkville
21-May,36047052800,3052800,7234,90496,97730,Brooklyn,1891640.287,Flatbush (West)-Ditmas Park-Parkville
19-Jun,36047052800,3052800,8438,42219,50657,Brooklyn,1891640.287,Flatbush (West)-Ditmas Park-Parkville
21-Jun,36047052800,3052800,9146,92544,101690,Brooklyn,1891640.287,Flatbush (West)-Ditmas Park-Parkville
19-Jul,36047052800,3052800,1341,33745,35086,Brooklyn,1891640.287,Flatbush (West)-Ditmas Park-Parkville
21-Jul,36047052800,3052800,17641,17291,34932,Brooklyn,1891640.287,Flatbush (West)-Ditmas Park-Parkville
19-Aug,36047052800,3052800,3266,105582,108848,Brooklyn,1891640.287,Flatbush (West)-Ditmas Park-Parkville
21-Aug,36047052800,3052800,7103,71316,78419,Brooklyn,1891640.287,Flatbush (West)-Ditmas Park-Parkville
19-May,36047052900,3052900,161,89507,89668,Brooklyn,1882580.843,South Williamsburg
21-May,36047052900,3052900,991,92497,93488,Brooklyn,1882580.843,South Williamsburg
19-Jun,36047052900,3052900,7919,150430,158349,Brooklyn,1882580.843,South Williamsburg
21-Jun,36047052900,3052900,7061,33958,41019,Brooklyn,1882580.843,South Williamsburg
19-Jul,36047052900,3052900,6836,123569,130405,Brooklyn,1882580.843,South Williamsburg
21-Jul,36047052900,3052900,2300,59014,61314,Brooklyn,1882580.843,South Williamsburg
19-Aug,36047052900,3052900,10000,57509,67509,Brooklyn,1882580.843,South Williamsburg
21-Aug,36047052900,3052900,16107,19723,35830,Brooklyn,1882580.843,South Williamsburg
19-May,36047053000,3053000,9396,100134,109530,Brooklyn,1861289.96,Midwood
21-May,36047053000,3053000,2172,75938,78110,Brooklyn,1861289.96,Midwood
19-Jun,36047053000,3053000,2843,111620,114463,Brooklyn,1861289.96,Midwood
21-Jun,36047053000,3053000,0,92956,92956,Brooklyn,1861289.96,Midwood
19-Jul,36047053000,3053000,0,72928,72928,Brooklyn,1861289.96,Midwood
21-Jul,36047053000,3053000,8048,14756,22804,Brooklyn,1861289.96,Midwood
19-Aug,36047053000,3053000,0,49436,49436,Brooklyn,1861289.96,Midwood
21-Aug,36047053000,3053000,0,91154,91154,Brooklyn,1861289.96,Midwood
19-May,36047053101,3053101,3386,80785,84171,Brooklyn,848807.9092,South Williamsburg
21-May,36047053101,3053101,7336,70711,78047,Brooklyn,848807.9092,South Williamsburg
19-Jun,36047053101,3053101,4041,132750,136791,Brooklyn,848807.9092,South Williamsburg
21-Jun,36047053101,3053101,18,40441,40459,Brooklyn,848807.9092,South Williamsburg
19-Jul,36047053101,3053101,9028,94692,103720,Brooklyn,848807.9092,South Williamsburg
21-Jul,36047053101,3053101,8790,110897,119687,Brooklyn,848807.9092,South Williamsburg
19-Aug,36047053101,3053101,6949,92079,99028,Brooklyn,848807.9092,South Williamsburg
21-Aug,36047053101,3053101,168,103736,103904,Brooklyn,848807.9092,South Williamsburg
19-May,36047053102,3053102,14137,95965,110102,Brooklyn,892907.8523,South Williamsburg
21-May,36047053102,3053102,480,20365,20845,Brooklyn,892907.8523,South Williamsburg
19-Jun,36047053102,3053102,15691,65191,80882,Brooklyn,892907.8523,South Williamsburg
21-Jun,36047053102,3053102,3231,94410,97641,Brooklyn,892907.8523,South Williamsburg
19-Jul,36047053102,3053102,7049,77174,84223,Brooklyn,892907.8523,South Williamsburg
21-Jul,36047053102,3053102,8807,32702,41509,Brooklyn,892907.8523,South Williamsburg
19-Aug,36047053102,3053102,16399,142070,158469,Brooklyn,892907.8523,South Williamsburg
21-Aug,36047053102,3053102,7097,53846,60943,Brooklyn,892907.8523,South Williamsburg
19-May,36047053200,3053200,0,20062,20062,Brooklyn,1876179.11,Midwood
21-May,36047053200,3053200,7351,31395,38746,Brooklyn,1876179.11,Midwood
19-Jun,36047053200,3053200,9768,129785,139553,Brooklyn,1876179.11,Midwood
21-Jun,36047053200,3053200,7393,79927,87320,Brooklyn,1876179.11,Midwood
19-Jul,36047053200,3053200,10237,112449,122686,Brooklyn,1876179.11,Midwood
21-Jul,36047053200,3053200,6996,67282,74278,Brooklyn,1876179.11,Midwood
19-Aug,36047053200,3053200,16090,81093,97183,Brooklyn,1876179.11,Midwood
21-Aug,36047053200,3053200,7143,50683,57826,Brooklyn,1876179.11,Midwood
19-May,36047053300,3053300,10853,128926,139779,Brooklyn,2078811.997,South Williamsburg
21-May,36047053300,3053300,9547,74221,83768,Brooklyn,2078811.997,South Williamsburg
19-Jun,36047053300,3053300,12523,152963,165486,Brooklyn,2078811.997,South Williamsburg
21-Jun,36047053300,3053300,10136,107631,117767,Brooklyn,2078811.997,South Williamsburg
19-Jul,36047053300,3053300,6752,53519,60271,Brooklyn,2078811.997,South Williamsburg
21-Jul,36047053300,3053300,12861,134236,147097,Brooklyn,2078811.997,South Williamsburg
19-Aug,36047053300,3053300,9438,51724,61162,Brooklyn,2078811.997,South Williamsburg
21-Aug,36047053300,3053300,18867,99884,118751,Brooklyn,2078811.997,South Williamsburg
19-May,36047053400,3053400,6718,71,6789,Brooklyn,1866105.779,Midwood
21-May,36047053400,3053400,8926,80069,88995,Brooklyn,1866105.779,Midwood
19-Jun,36047053400,3053400,0,44784,44784,Brooklyn,1866105.779,Midwood
21-Jun,36047053400,3053400,15555,101965,117520,Brooklyn,1866105.779,Midwood
19-Jul,36047053400,3053400,6337,67890,74227,Brooklyn,1866105.779,Midwood
21-Jul,36047053400,3053400,9556,127692,137248,Brooklyn,1866105.779,Midwood
19-Aug,36047053400,3053400,4711,79393,84104,Brooklyn,1866105.779,Midwood
21-Aug,36047053400,3053400,9500,14175,23675,Brooklyn,1866105.779,Midwood
19-May,36047053500,3053500,15629,96500,112129,Brooklyn,1406193.279,South Williamsburg
21-May,36047053500,3053500,7559,117340,124899,Brooklyn,1406193.279,South Williamsburg
19-Jun,36047053500,3053500,10001,81356,91357,Brooklyn,1406193.279,South Williamsburg
21-Jun,36047053500,3053500,9553,86549,96102,Brooklyn,1406193.279,South Williamsburg
19-Jul,36047053500,3053500,11035,115585,126620,Brooklyn,1406193.279,South Williamsburg
21-Jul,36047053500,3053500,11236,51795,63031,Brooklyn,1406193.279,South Williamsburg
19-Aug,36047053500,3053500,8322,11851,20173,Brooklyn,1406193.279,South Williamsburg
21-Aug,36047053500,3053500,6782,37092,43874,Brooklyn,1406193.279,South Williamsburg
19-May,36047053700,3053700,12318,41170,53488,Brooklyn,1802604.124,South Williamsburg
21-May,36047053700,3053700,8193,107571,115764,Brooklyn,1802604.124,South Williamsburg
19-Jun,36047053700,3053700,13795,10779,24574,Brooklyn,1802604.124,South Williamsburg
21-Jun,36047053700,3053700,10739,99955,110694,Brooklyn,1802604.124,South Williamsburg
19-Jul,36047053700,3053700,4042,141737,145779,Brooklyn,1802604.124,South Williamsburg
21-Jul,36047053700,3053700,9464,102789,112253,Brooklyn,1802604.124,South Williamsburg
19-Aug,36047053700,3053700,6782,100527,107309,Brooklyn,1802604.124,South Williamsburg
21-Aug,36047053700,3053700,7937,95101,103038,Brooklyn,1802604.124,South Williamsburg
19-May,36047053800,3053800,11212,63402,74614,Brooklyn,1770108.368,Midwood
21-May,36047053800,3053800,10618,132326,142944,Brooklyn,1770108.368,Midwood
19-Jun,36047053800,3053800,2828,60588,63416,Brooklyn,1770108.368,Midwood
21-Jun,36047053800,3053800,6405,79542,85947,Brooklyn,1770108.368,Midwood
19-Jul,36047053800,3053800,10193,86915,97108,Brooklyn,1770108.368,Midwood
21-Jul,36047053800,3053800,5495,60921,66416,Brooklyn,1770108.368,Midwood
19-Aug,36047053800,3053800,5427,76743,82170,Brooklyn,1770108.368,Midwood
21-Aug,36047053800,3053800,16797,101392,118189,Brooklyn,1770108.368,Midwood
19-May,36047053900,3053900,4216,87161,91377,Brooklyn,1091542.912,South Williamsburg
21-May,36047053900,3053900,5683,119942,125625,Brooklyn,1091542.912,South Williamsburg
19-Jun,36047053900,3053900,10174,109027,119201,Brooklyn,1091542.912,South Williamsburg
21-Jun,36047053900,3053900,10104,103006,113110,Brooklyn,1091542.912,South Williamsburg
19-Jul,36047053900,3053900,6299,44440,50739,Brooklyn,1091542.912,South Williamsburg
21-Jul,36047053900,3053900,15869,97005,112874,Brooklyn,1091542.912,South Williamsburg
19-Aug,36047053900,3053900,2970,149543,152513,Brooklyn,1091542.912,South Williamsburg
21-Aug,36047053900,3053900,2017,47961,49978,Brooklyn,1091542.912,South Williamsburg
19-May,36047054400,3054400,0,71,71,Brooklyn,2045270.506,Midwood
21-May,36047054400,3054400,8838,1533,10371,Brooklyn,2045270.506,Midwood
19-Jun,36047054400,3054400,6087,88533,94620,Brooklyn,2045270.506,Midwood
21-Jun,36047054400,3054400,6403,49792,56195,Brooklyn,2045270.506,Midwood
19-Jul,36047054400,3054400,20273,47522,67795,Brooklyn,2045270.506,Midwood
21-Jul,36047054400,3054400,11960,29604,41564,Brooklyn,2045270.506,Midwood
19-Aug,36047054400,3054400,2504,41560,44064,Brooklyn,2045270.506,Midwood
21-Aug,36047054400,3054400,5613,68499,74112,Brooklyn,2045270.506,Midwood
19-May,36047054600,3054600,9263,93501,102764,Brooklyn,1942537.939,Midwood
21-May,36047054600,3054600,3867,18099,21966,Brooklyn,1942537.939,Midwood
19-Jun,36047054600,3054600,6919,28669,35588,Brooklyn,1942537.939,Midwood
21-Jun,36047054600,3054600,17364,63189,80553,Brooklyn,1942537.939,Midwood
19-Jul,36047054600,3054600,6355,125471,131826,Brooklyn,1942537.939,Midwood
21-Jul,36047054600,3054600,12541,71837,84378,Brooklyn,1942537.939,Midwood
19-Aug,36047054600,3054600,8626,7127,15753,Brooklyn,1942537.939,Midwood
21-Aug,36047054600,3054600,10085,85648,95733,Brooklyn,1942537.939,Midwood
19-May,36047054700,3054700,13486,106254,119740,Brooklyn,1825019.463,Williamsburg
21-May,36047054700,3054700,14726,71,14797,Brooklyn,1825019.463,Williamsburg
19-Jun,36047054700,3054700,3691,22419,26110,Brooklyn,1825019.463,Williamsburg
21-Jun,36047054700,3054700,8642,57154,65796,Brooklyn,1825019.463,Williamsburg
19-Jul,36047054700,3054700,13150,8180,21330,Brooklyn,1825019.463,Williamsburg
21-Jul,36047054700,3054700,5878,92299,98177,Brooklyn,1825019.463,Williamsburg
19-Aug,36047054700,3054700,3756,64280,68036,Brooklyn,1825019.463,Williamsburg
21-Aug,36047054700,3054700,7758,140114,147872,Brooklyn,1825019.463,Williamsburg
19-May,36047054800,3054800,3885,112130,116015,Brooklyn,1864436.176,Madison
21-May,36047054800,3054800,12477,26368,38845,Brooklyn,1864436.176,Madison
19-Jun,36047054800,3054800,3147,47577,50724,Brooklyn,1864436.176,Madison
21-Jun,36047054800,3054800,10366,70328,80694,Brooklyn,1864436.176,Madison
19-Jul,36047054800,3054800,10173,131088,141261,Brooklyn,1864436.176,Madison
21-Jul,36047054800,3054800,2271,95627,97898,Brooklyn,1864436.176,Madison
19-Aug,36047054800,3054800,15685,60738,76423,Brooklyn,1864436.176,Madison
21-Aug,36047054800,3054800,310,42742,43052,Brooklyn,1864436.176,Madison
19-May,36047054900,3054900,0,89351,89351,Brooklyn,2097786.524,Williamsburg
21-May,36047054900,3054900,13674,102315,115989,Brooklyn,2097786.524,Williamsburg
19-Jun,36047054900,3054900,10640,77224,87864,Brooklyn,2097786.524,Williamsburg
21-Jun,36047054900,3054900,15903,91952,107855,Brooklyn,2097786.524,Williamsburg
19-Jul,36047054900,3054900,14207,37723,51930,Brooklyn,2097786.524,Williamsburg
21-Jul,36047054900,3054900,4855,72853,77708,Brooklyn,2097786.524,Williamsburg
19-Aug,36047054900,3054900,8497,72466,80963,Brooklyn,2097786.524,Williamsburg
21-Aug,36047054900,3054900,7198,65170,72368,Brooklyn,2097786.524,Williamsburg
19-May,36047055000,3055000,7745,150377,158122,Brooklyn,1937232.653,Madison
21-May,36047055000,3055000,5053,49637,54690,Brooklyn,1937232.653,Madison
19-Jun,36047055000,3055000,1866,75741,77607,Brooklyn,1937232.653,Madison
21-Jun,36047055000,3055000,3699,37962,41661,Brooklyn,1937232.653,Madison
19-Jul,36047055000,3055000,2482,11421,13903,Brooklyn,1937232.653,Madison
21-Jul,36047055000,3055000,6550,50459,57009,Brooklyn,1937232.653,Madison
19-Aug,36047055000,3055000,2409,119404,121813,Brooklyn,1937232.653,Madison
21-Aug,36047055000,3055000,18622,63828,82450,Brooklyn,1937232.653,Madison
19-May,36047055200,3055200,14266,97335,111601,Brooklyn,1805017.48,Madison
21-May,36047055200,3055200,9549,66957,76506,Brooklyn,1805017.48,Madison
19-Jun,36047055200,3055200,5354,62496,67850,Brooklyn,1805017.48,Madison
21-Jun,36047055200,3055200,3886,65997,69883,Brooklyn,1805017.48,Madison
19-Jul,36047055200,3055200,12938,50853,63791,Brooklyn,1805017.48,Madison
21-Jul,36047055200,3055200,18401,29061,47462,Brooklyn,1805017.48,Madison
19-Aug,36047055200,3055200,14373,111550,125923,Brooklyn,1805017.48,Madison
21-Aug,36047055200,3055200,6463,37262,43725,Brooklyn,1805017.48,Madison
19-May,36047055300,3055300,15139,76648,91787,Brooklyn,1681865.622,Williamsburg
21-May,36047055300,3055300,10954,97364,108318,Brooklyn,1681865.622,Williamsburg
19-Jun,36047055300,3055300,15365,75606,90971,Brooklyn,1681865.622,Williamsburg
21-Jun,36047055300,3055300,9736,60365,70101,Brooklyn,1681865.622,Williamsburg
19-Jul,36047055300,3055300,9242,64522,73764,Brooklyn,1681865.622,Williamsburg
21-Jul,36047055300,3055300,6858,53511,60369,Brooklyn,1681865.622,Williamsburg
19-Aug,36047055300,3055300,10283,33466,43749,Brooklyn,1681865.622,Williamsburg
21-Aug,36047055300,3055300,6480,48963,55443,Brooklyn,1681865.622,Williamsburg
19-May,36047055600,3055600,11523,118878,130401,Brooklyn,2079990.378,Gravesend (East)-Homecrest
21-May,36047055600,3055600,8470,7128,15598,Brooklyn,2079990.378,Gravesend (East)-Homecrest
19-Jun,36047055600,3055600,5510,57866,63376,Brooklyn,2079990.378,Gravesend (East)-Homecrest
21-Jun,36047055600,3055600,7589,110219,117808,Brooklyn,2079990.378,Gravesend (East)-Homecrest
19-Jul,36047055600,3055600,0,75924,75924,Brooklyn,2079990.378,Gravesend (East)-Homecrest
21-Jul,36047055600,3055600,10514,140700,151214,Brooklyn,2079990.378,Gravesend (East)-Homecrest
19-Aug,36047055600,3055600,11184,80207,91391,Brooklyn,2079990.378,Gravesend (East)-Homecrest
21-Aug,36047055600,3055600,4640,88020,92660,Brooklyn,2079990.378,Gravesend (East)-Homecrest
19-May,36047055700,3055700,6933,61332,68265,Brooklyn,3195112.353,Williamsburg
21-May,36047055700,3055700,9327,5154,14481,Brooklyn,3195112.353,Williamsburg
19-Jun,36047055700,3055700,5152,66523,71675,Brooklyn,3195112.353,Williamsburg
21-Jun,36047055700,3055700,15282,85662,100944,Brooklyn,3195112.353,Williamsburg
19-Jul,36047055700,3055700,6653,106293,112946,Brooklyn,3195112.353,Williamsburg
21-Jul,36047055700,3055700,990,116294,117284,Brooklyn,3195112.353,Williamsburg
19-Aug,36047055700,3055700,8224,102908,111132,Brooklyn,3195112.353,Williamsburg
21-Aug,36047055700,3055700,14574,82523,97097,Brooklyn,3195112.353,Williamsburg
19-May,36047055800,3055800,10384,38099,48483,Brooklyn,1847310.305,Madison
21-May,36047055800,3055800,7328,104569,111897,Brooklyn,1847310.305,Madison
19-Jun,36047055800,3055800,7506,117559,125065,Brooklyn,1847310.305,Madison
21-Jun,36047055800,3055800,8246,148353,156599,Brooklyn,1847310.305,Madison
19-Jul,36047055800,3055800,7286,139217,146503,Brooklyn,1847310.305,Madison
21-Jul,36047055800,3055800,15662,19238,34900,Brooklyn,1847310.305,Madison
19-Aug,36047055800,3055800,10851,53990,64841,Brooklyn,1847310.305,Madison
21-Aug,36047055800,3055800,8921,50118,59039,Brooklyn,1847310.305,Madison
19-May,36047056000,3056000,13698,54384,68082,Brooklyn,1988439.742,Madison
21-May,36047056000,3056000,7145,45201,52346,Brooklyn,1988439.742,Madison
19-Jun,36047056000,3056000,7854,63853,71707,Brooklyn,1988439.742,Madison
21-Jun,36047056000,3056000,2710,126383,129093,Brooklyn,1988439.742,Madison
19-Jul,36047056000,3056000,7619,45757,53376,Brooklyn,1988439.742,Madison
21-Jul,36047056000,3056000,5429,102887,108316,Brooklyn,1988439.742,Madison
19-Aug,36047056000,3056000,4913,46778,51691,Brooklyn,1988439.742,Madison
21-Aug,36047056000,3056000,8846,69678,78524,Brooklyn,1988439.742,Madison
19-May,36047056200,3056200,7517,71612,79129,Brooklyn,1838820.745,Madison
21-May,36047056200,3056200,7616,92026,99642,Brooklyn,1838820.745,Madison
19-Jun,36047056200,3056200,14331,49240,63571,Brooklyn,1838820.745,Madison
21-Jun,36047056200,3056200,15099,112465,127564,Brooklyn,1838820.745,Madison
19-Jul,36047056200,3056200,13067,66078,79145,Brooklyn,1838820.745,Madison
21-Jul,36047056200,3056200,6716,151570,158286,Brooklyn,1838820.745,Madison
19-Aug,36047056200,3056200,5289,71,5360,Brooklyn,1838820.745,Madison
21-Aug,36047056200,3056200,15336,108628,123964,Brooklyn,1838820.745,Madison
19-May,36047056301,3056301,2214,49073,51287,Brooklyn,1932228.634,Greenpoint
21-May,36047056301,3056301,0,64833,64833,Brooklyn,1932228.634,Greenpoint
19-Jun,36047056301,3056301,8089,80990,89079,Brooklyn,1932228.634,Greenpoint
21-Jun,36047056301,3056301,13207,118487,131694,Brooklyn,1932228.634,Greenpoint
19-Jul,36047056301,3056301,5886,108586,114472,Brooklyn,1932228.634,Greenpoint
21-Jul,36047056301,3056301,15582,34973,50555,Brooklyn,1932228.634,Greenpoint
19-Aug,36047056301,3056301,8760,141446,150206,Brooklyn,1932228.634,Greenpoint
21-Aug,36047056301,3056301,10738,70512,81250,Brooklyn,1932228.634,Greenpoint
19-May,36047056400,3056400,356,91448,91804,Brooklyn,1972387.691,Madison
21-May,36047056400,3056400,6350,52201,58551,Brooklyn,1972387.691,Madison
19-Jun,36047056400,3056400,4833,59919,64752,Brooklyn,1972387.691,Madison
21-Jun,36047056400,3056400,1577,49421,50998,Brooklyn,1972387.691,Madison
19-Jul,36047056400,3056400,2572,59021,61593,Brooklyn,1972387.691,Madison
21-Jul,36047056400,3056400,5112,95176,100288,Brooklyn,1972387.691,Madison
19-Aug,36047056400,3056400,0,84351,84351,Brooklyn,1972387.691,Madison
21-Aug,36047056400,3056400,5416,69939,75355,Brooklyn,1972387.691,Madison
19-May,36047056600,3056600,17194,163696,180890,Brooklyn,1846300.334,Madison
21-May,36047056600,3056600,16607,160817,177424,Brooklyn,1846300.334,Madison
19-Jun,36047056600,3056600,4051,113171,117222,Brooklyn,1846300.334,Madison
21-Jun,36047056600,3056600,862,81425,82287,Brooklyn,1846300.334,Madison
19-Jul,36047056600,3056600,3655,69098,72753,Brooklyn,1846300.334,Madison
21-Jul,36047056600,3056600,13729,90828,104557,Brooklyn,1846300.334,Madison
19-Aug,36047056600,3056600,8009,45533,53542,Brooklyn,1846300.334,Madison
21-Aug,36047056600,3056600,351,108378,108729,Brooklyn,1846300.334,Madison
19-May,36047056800,3056800,767,65411,66178,Brooklyn,1267976.204,Madison
21-May,36047056800,3056800,3202,73436,76638,Brooklyn,1267976.204,Madison
19-Jun,36047056800,3056800,6534,29910,36444,Brooklyn,1267976.204,Madison
21-Jun,36047056800,3056800,6575,61381,67956,Brooklyn,1267976.204,Madison
19-Jul,36047056800,3056800,5924,79450,85374,Brooklyn,1267976.204,Madison
21-Jul,36047056800,3056800,9965,64969,74934,Brooklyn,1267976.204,Madison
19-Aug,36047056800,3056800,7545,79872,87417,Brooklyn,1267976.204,Madison
21-Aug,36047056800,3056800,18412,108137,126549,Brooklyn,1267976.204,Madison
19-May,36047056900,3056900,12018,137831,149849,Brooklyn,1376243.653,Greenpoint
21-May,36047056900,3056900,21721,71,21792,Brooklyn,1376243.653,Greenpoint
19-Jun,36047056900,3056900,3644,63760,67404,Brooklyn,1376243.653,Greenpoint
21-Jun,36047056900,3056900,3256,73297,76553,Brooklyn,1376243.653,Greenpoint
19-Jul,36047056900,3056900,4163,79925,84088,Brooklyn,1376243.653,Greenpoint
21-Jul,36047056900,3056900,3000,75323,78323,Brooklyn,1376243.653,Greenpoint
19-Aug,36047056900,3056900,6034,135355,141389,Brooklyn,1376243.653,Greenpoint
21-Aug,36047056900,3056900,7552,26034,33586,Brooklyn,1376243.653,Greenpoint
19-May,36047057000,3057000,3503,54387,57890,Brooklyn,2824696.868,Sheepshead Bay-Manhattan Beach-Gerritsen Beach
21-May,36047057000,3057000,5244,74272,79516,Brooklyn,2824696.868,Sheepshead Bay-Manhattan Beach-Gerritsen Beach
19-Jun,36047057000,3057000,4163,36045,40208,Brooklyn,2824696.868,Sheepshead Bay-Manhattan Beach-Gerritsen Beach
21-Jun,36047057000,3057000,8317,76605,84922,Brooklyn,2824696.868,Sheepshead Bay-Manhattan Beach-Gerritsen Beach
19-Jul,36047057000,3057000,19168,121381,140549,Brooklyn,2824696.868,Sheepshead Bay-Manhattan Beach-Gerritsen Beach
21-Jul,36047057000,3057000,15501,103702,119203,Brooklyn,2824696.868,Sheepshead Bay-Manhattan Beach-Gerritsen Beach
19-Aug,36047057000,3057000,11231,70347,81578,Brooklyn,2824696.868,Sheepshead Bay-Manhattan Beach-Gerritsen Beach
21-Aug,36047057000,3057000,6607,123745,130352,Brooklyn,2824696.868,Sheepshead Bay-Manhattan Beach-Gerritsen Beach
19-May,36047057100,3057100,8202,40636,48838,Brooklyn,1892836.467,Greenpoint
21-May,36047057100,3057100,0,46592,46592,Brooklyn,1892836.467,Greenpoint
19-Jun,36047057100,3057100,7713,43808,51521,Brooklyn,1892836.467,Greenpoint
21-Jun,36047057100,3057100,7623,76724,84347,Brooklyn,1892836.467,Greenpoint
19-Jul,36047057100,3057100,14705,73430,88135,Brooklyn,1892836.467,Greenpoint
21-Jul,36047057100,3057100,11343,71253,82596,Brooklyn,1892836.467,Greenpoint
19-Aug,36047057100,3057100,5982,80158,86140,Brooklyn,1892836.467,Greenpoint
21-Aug,36047057100,3057100,13274,60227,73501,Brooklyn,1892836.467,Greenpoint
19-May,36047057200,3057200,0,45834,45834,Brooklyn,2622725.216,Sheepshead Bay-Manhattan Beach-Gerritsen Beach
21-May,36047057200,3057200,8823,54065,62888,Brooklyn,2622725.216,Sheepshead Bay-Manhattan Beach-Gerritsen Beach
19-Jun,36047057200,3057200,14072,21739,35811,Brooklyn,2622725.216,Sheepshead Bay-Manhattan Beach-Gerritsen Beach
21-Jun,36047057200,3057200,10134,60243,70377,Brooklyn,2622725.216,Sheepshead Bay-Manhattan Beach-Gerritsen Beach
19-Jul,36047057200,3057200,8255,16908,25163,Brooklyn,2622725.216,Sheepshead Bay-Manhattan Beach-Gerritsen Beach
21-Jul,36047057200,3057200,7287,65462,72749,Brooklyn,2622725.216,Sheepshead Bay-Manhattan Beach-Gerritsen Beach
19-Aug,36047057200,3057200,14206,66754,80960,Brooklyn,2622725.216,Sheepshead Bay-Manhattan Beach-Gerritsen Beach
21-Aug,36047057200,3057200,12415,42090,54505,Brooklyn,2622725.216,Sheepshead Bay-Manhattan Beach-Gerritsen Beach
19-May,36047057300,3057300,19242,79676,98918,Brooklyn,1831149.75,Greenpoint
21-May,36047057300,3057300,5626,34339,39965,Brooklyn,1831149.75,Greenpoint
19-Jun,36047057300,3057300,16327,47051,63378,Brooklyn,1831149.75,Greenpoint
21-Jun,36047057300,3057300,9379,103516,112895,Brooklyn,1831149.75,Greenpoint
19-Jul,36047057300,3057300,13994,93132,107126,Brooklyn,1831149.75,Greenpoint
21-Jul,36047057300,3057300,4477,125792,130269,Brooklyn,1831149.75,Greenpoint
19-Aug,36047057300,3057300,10187,76481,86668,Brooklyn,1831149.75,Greenpoint
21-Aug,36047057300,3057300,9707,71,9778,Brooklyn,1831149.75,Greenpoint
19-May,36047057400,3057400,12794,94995,107789,Brooklyn,1713577.621,Madison
21-May,36047057400,3057400,6560,71,6631,Brooklyn,1713577.621,Madison
19-Jun,36047057400,3057400,5562,88821,94383,Brooklyn,1713577.621,Madison
21-Jun,36047057400,3057400,7138,72658,79796,Brooklyn,1713577.621,Madison
19-Jul,36047057400,3057400,8463,138314,146777,Brooklyn,1713577.621,Madison
21-Jul,36047057400,3057400,1911,144039,145950,Brooklyn,1713577.621,Madison
19-Aug,36047057400,3057400,2311,68671,70982,Brooklyn,1713577.621,Madison
21-Aug,36047057400,3057400,12391,89682,102073,Brooklyn,1713577.621,Madison
19-May,36047057500,3057500,15373,123342,138715,Brooklyn,1952560.431,Greenpoint
21-May,36047057500,3057500,4332,70128,74460,Brooklyn,1952560.431,Greenpoint
19-Jun,36047057500,3057500,7969,71928,79897,Brooklyn,1952560.431,Greenpoint
21-Jun,36047057500,3057500,11508,147018,158526,Brooklyn,1952560.431,Greenpoint
19-Jul,36047057500,3057500,4260,92701,96961,Brooklyn,1952560.431,Greenpoint
21-Jul,36047057500,3057500,5682,82508,88190,Brooklyn,1952560.431,Greenpoint
19-Aug,36047057500,3057500,8998,66875,75873,Brooklyn,1952560.431,Greenpoint
21-Aug,36047057500,3057500,17716,103949,121665,Brooklyn,1952560.431,Greenpoint
19-May,36047057600,3057600,3751,163393,167144,Brooklyn,1707334.502,Madison
21-May,36047057600,3057600,14593,73449,88042,Brooklyn,1707334.502,Madison
19-Jun,36047057600,3057600,7638,122557,130195,Brooklyn,1707334.502,Madison
21-Jun,36047057600,3057600,7109,78438,85547,Brooklyn,1707334.502,Madison
19-Jul,36047057600,3057600,23519,129193,152712,Brooklyn,1707334.502,Madison
21-Jul,36047057600,3057600,10311,90298,100609,Brooklyn,1707334.502,Madison
19-Aug,36047057600,3057600,6463,17731,24194,Brooklyn,1707334.502,Madison
21-Aug,36047057600,3057600,12309,103384,115693,Brooklyn,1707334.502,Madison
19-May,36047057800,3057800,10667,71,10738,Brooklyn,1853782.065,Madison
21-May,36047057800,3057800,5024,63237,68261,Brooklyn,1853782.065,Madison
19-Jun,36047057800,3057800,6614,95442,102056,Brooklyn,1853782.065,Madison
21-Jun,36047057800,3057800,3609,162260,165869,Brooklyn,1853782.065,Madison
19-Jul,36047057800,3057800,5770,35371,41141,Brooklyn,1853782.065,Madison
21-Jul,36047057800,3057800,113,112717,112830,Brooklyn,1853782.065,Madison
19-Aug,36047057800,3057800,6292,101048,107340,Brooklyn,1853782.065,Madison
21-Aug,36047057800,3057800,4515,52580,57095,Brooklyn,1853782.065,Madison
19-May,36047058000,3058000,11792,81688,93480,Brooklyn,1707766.479,Madison
21-May,36047058000,3058000,5026,22076,27102,Brooklyn,1707766.479,Madison
19-Jun,36047058000,3058000,16904,70390,87294,Brooklyn,1707766.479,Madison
21-Jun,36047058000,3058000,13435,74274,87709,Brooklyn,1707766.479,Madison
19-Jul,36047058000,3058000,17757,43559,61316,Brooklyn,1707766.479,Madison
21-Jul,36047058000,3058000,13488,77507,90995,Brooklyn,1707766.479,Madison
19-Aug,36047058000,3058000,10053,168593,178646,Brooklyn,1707766.479,Madison
21-Aug,36047058000,3058000,13025,61878,74903,Brooklyn,1707766.479,Madison
19-May,36047058200,3058200,3844,71916,75760,Brooklyn,1738266.683,Gravesend (East)-Homecrest
21-May,36047058200,3058200,5892,73317,79209,Brooklyn,1738266.683,Gravesend (East)-Homecrest
19-Jun,36047058200,3058200,1213,49059,50272,Brooklyn,1738266.683,Gravesend (East)-Homecrest
21-Jun,36047058200,3058200,2421,60227,62648,Brooklyn,1738266.683,Gravesend (East)-Homecrest
19-Jul,36047058200,3058200,9491,77862,87353,Brooklyn,1738266.683,Gravesend (East)-Homecrest
21-Jul,36047058200,3058200,5381,68941,74322,Brooklyn,1738266.683,Gravesend (East)-Homecrest
19-Aug,36047058200,3058200,6432,63334,69766,Brooklyn,1738266.683,Gravesend (East)-Homecrest
21-Aug,36047058200,3058200,12569,18656,31225,Brooklyn,1738266.683,Gravesend (East)-Homecrest
19-May,36047058400,3058400,3901,59590,63491,Brooklyn,2029005.504,Gravesend (East)-Homecrest
21-May,36047058400,3058400,9917,23016,32933,Brooklyn,2029005.504,Gravesend (East)-Homecrest
19-Jun,36047058400,3058400,5318,48917,54235,Brooklyn,2029005.504,Gravesend (East)-Homecrest
21-Jun,36047058400,3058400,7833,18582,26415,Brooklyn,2029005.504,Gravesend (East)-Homecrest
19-Jul,36047058400,3058400,5766,44651,50417,Brooklyn,2029005.504,Gravesend (East)-Homecrest
21-Jul,36047058400,3058400,5556,9059,14615,Brooklyn,2029005.504,Gravesend (East)-Homecrest
19-Aug,36047058400,3058400,736,83797,84533,Brooklyn,2029005.504,Gravesend (East)-Homecrest
21-Aug,36047058400,3058400,10809,74860,85669,Brooklyn,2029005.504,Gravesend (East)-Homecrest
19-May,36047058600,3058600,10137,44515,54652,Brooklyn,1759616.204,Sheepshead Bay-Manhattan Beach-Gerritsen Beach
21-May,36047058600,3058600,3547,118028,121575,Brooklyn,1759616.204,Sheepshead Bay-Manhattan Beach-Gerritsen Beach
19-Jun,36047058600,3058600,16255,76178,92433,Brooklyn,1759616.204,Sheepshead Bay-Manhattan Beach-Gerritsen Beach
21-Jun,36047058600,3058600,9926,62209,72135,Brooklyn,1759616.204,Sheepshead Bay-Manhattan Beach-Gerritsen Beach
19-Jul,36047058600,3058600,9480,84829,94309,Brooklyn,1759616.204,Sheepshead Bay-Manhattan Beach-Gerritsen Beach
21-Jul,36047058600,3058600,2743,66345,69088,Brooklyn,1759616.204,Sheepshead Bay-Manhattan Beach-Gerritsen Beach
19-Aug,36047058600,3058600,7209,128204,135413,Brooklyn,1759616.204,Sheepshead Bay-Manhattan Beach-Gerritsen Beach
21-Aug,36047058600,3058600,4099,91348,95447,Brooklyn,1759616.204,Sheepshead Bay-Manhattan Beach-Gerritsen Beach
19-May,36047058800,3058800,12158,91139,103297,Brooklyn,1718520.711,Gravesend (East)-Homecrest
21-May,36047058800,3058800,6433,95876,102309,Brooklyn,1718520.711,Gravesend (East)-Homecrest
19-Jun,36047058800,3058800,3859,147107,150966,Brooklyn,1718520.711,Gravesend (East)-Homecrest
21-Jun,36047058800,3058800,8984,34012,42996,Brooklyn,1718520.711,Gravesend (East)-Homecrest
19-Jul,36047058800,3058800,9726,22070,31796,Brooklyn,1718520.711,Gravesend (East)-Homecrest
21-Jul,36047058800,3058800,8963,100110,109073,Brooklyn,1718520.711,Gravesend (East)-Homecrest
19-Aug,36047058800,3058800,5339,73184,78523,Brooklyn,1718520.711,Gravesend (East)-Homecrest
21-Aug,36047058800,3058800,11552,85027,96579,Brooklyn,1718520.711,Gravesend (East)-Homecrest
19-May,36047058901,3058901,0,98359,98359,Brooklyn,2170252.337,Greenpoint
21-May,36047058901,3058901,4895,71,4966,Brooklyn,2170252.337,Greenpoint
19-Jun,36047058901,3058901,8733,66900,75633,Brooklyn,2170252.337,Greenpoint
21-Jun,36047058901,3058901,2918,20490,23408,Brooklyn,2170252.337,Greenpoint
19-Jul,36047058901,3058901,11775,77085,88860,Brooklyn,2170252.337,Greenpoint
21-Jul,36047058901,3058901,5489,52808,58297,Brooklyn,2170252.337,Greenpoint
19-Aug,36047058901,3058901,12220,96917,109137,Brooklyn,2170252.337,Greenpoint
21-Aug,36047058901,3058901,13412,66157,79569,Brooklyn,2170252.337,Greenpoint
19-May,36047058902,3058902,15514,114488,130002,Brooklyn,2403423.155,Greenpoint
21-May,36047058902,3058902,9124,83688,92812,Brooklyn,2403423.155,Greenpoint
19-Jun,36047058902,3058902,7099,61498,68597,Brooklyn,2403423.155,Greenpoint
21-Jun,36047058902,3058902,12915,103164,116079,Brooklyn,2403423.155,Greenpoint
19-Jul,36047058902,3058902,2112,80264,82376,Brooklyn,2403423.155,Greenpoint
21-Jul,36047058902,3058902,8084,46938,55022,Brooklyn,2403423.155,Greenpoint
19-Aug,36047058902,3058902,5616,147784,153400,Brooklyn,2403423.155,Greenpoint
21-Aug,36047058902,3058902,4812,69892,74704,Brooklyn,2403423.155,Greenpoint
19-May,36047059000,3059000,2027,2169,4196,Brooklyn,1704089.749,Sheepshead Bay-Manhattan Beach-Gerritsen Beach
21-May,36047059000,3059000,6801,86342,93143,Brooklyn,1704089.749,Sheepshead Bay-Manhattan Beach-Gerritsen Beach
19-Jun,36047059000,3059000,8959,51980,60939,Brooklyn,1704089.749,Sheepshead Bay-Manhattan Beach-Gerritsen Beach
21-Jun,36047059000,3059000,11287,87709,98996,Brooklyn,1704089.749,Sheepshead Bay-Manhattan Beach-Gerritsen Beach
19-Jul,36047059000,3059000,12950,121943,134893,Brooklyn,1704089.749,Sheepshead Bay-Manhattan Beach-Gerritsen Beach
21-Jul,36047059000,3059000,0,57959,57959,Brooklyn,1704089.749,Sheepshead Bay-Manhattan Beach-Gerritsen Beach
19-Aug,36047059000,3059000,20689,66470,87159,Brooklyn,1704089.749,Sheepshead Bay-Manhattan Beach-Gerritsen Beach
21-Aug,36047059000,3059000,8955,127152,136107,Brooklyn,1704089.749,Sheepshead Bay-Manhattan Beach-Gerritsen Beach
19-May,36047059100,3059100,12783,69141,81924,Brooklyn,2062727.215,Greenpoint
21-May,36047059100,3059100,11757,85939,97696,Brooklyn,2062727.215,Greenpoint
19-Jun,36047059100,3059100,15770,48393,64163,Brooklyn,2062727.215,Greenpoint
21-Jun,36047059100,3059100,7068,325,7393,Brooklyn,2062727.215,Greenpoint
19-Jul,36047059100,3059100,3701,70043,73744,Brooklyn,2062727.215,Greenpoint
21-Jul,36047059100,3059100,6085,84582,90667,Brooklyn,2062727.215,Greenpoint
19-Aug,36047059100,3059100,18137,91715,109852,Brooklyn,2062727.215,Greenpoint
21-Aug,36047059100,3059100,15572,128514,144086,Brooklyn,2062727.215,Greenpoint
19-May,36047059200,3059200,10267,119008,129275,Brooklyn,2360097.783,Sheepshead Bay-Manhattan Beach-Gerritsen Beach
21-May,36047059200,3059200,4885,48055,52940,Brooklyn,2360097.783,Sheepshead Bay-Manhattan Beach-Gerritsen Beach
19-Jun,36047059200,3059200,11680,57803,69483,Brooklyn,2360097.783,Sheepshead Bay-Manhattan Beach-Gerritsen Beach
21-Jun,36047059200,3059200,12006,3300,15306,Brooklyn,2360097.783,Sheepshead Bay-Manhattan Beach-Gerritsen Beach
19-Jul,36047059200,3059200,9308,116861,126169,Brooklyn,2360097.783,Sheepshead Bay-Manhattan Beach-Gerritsen Beach
21-Jul,36047059200,3059200,11573,179318,190891,Brooklyn,2360097.783,Sheepshead Bay-Manhattan Beach-Gerritsen Beach
19-Aug,36047059200,3059200,5447,92985,98432,Brooklyn,2360097.783,Sheepshead Bay-Manhattan Beach-Gerritsen Beach
21-Aug,36047059200,3059200,12297,125146,137443,Brooklyn,2360097.783,Sheepshead Bay-Manhattan Beach-Gerritsen Beach
19-May,36047059300,3059300,15878,39897,55775,Brooklyn,2033982.766,Greenpoint
21-May,36047059300,3059300,11436,42038,53474,Brooklyn,2033982.766,Greenpoint
19-Jun,36047059300,3059300,7220,18184,25404,Brooklyn,2033982.766,Greenpoint
21-Jun,36047059300,3059300,12350,82840,95190,Brooklyn,2033982.766,Greenpoint
19-Jul,36047059300,3059300,3103,35267,38370,Brooklyn,2033982.766,Greenpoint
21-Jul,36047059300,3059300,4155,71,4226,Brooklyn,2033982.766,Greenpoint
19-Aug,36047059300,3059300,19090,66222,85312,Brooklyn,2033982.766,Greenpoint
21-Aug,36047059300,3059300,7284,71,7355,Brooklyn,2033982.766,Greenpoint
19-May,36047059402,3059402,12930,108381,121311,Brooklyn,3470556.224,Sheepshead Bay-Manhattan Beach-Gerritsen Beach
21-May,36047059402,3059402,5252,96780,102032,Brooklyn,3470556.224,Sheepshead Bay-Manhattan Beach-Gerritsen Beach
19-Jun,36047059402,3059402,1623,47430,49053,Brooklyn,3470556.224,Sheepshead Bay-Manhattan Beach-Gerritsen Beach
21-Jun,36047059402,3059402,12233,5804,18037,Brooklyn,3470556.224,Sheepshead Bay-Manhattan Beach-Gerritsen Beach
19-Jul,36047059402,3059402,8916,53839,62755,Brooklyn,3470556.224,Sheepshead Bay-Manhattan Beach-Gerritsen Beach
21-Jul,36047059402,3059402,8528,104466,112994,Brooklyn,3470556.224,Sheepshead Bay-Manhattan Beach-Gerritsen Beach
19-Aug,36047059402,3059402,8977,90515,99492,Brooklyn,3470556.224,Sheepshead Bay-Manhattan Beach-Gerritsen Beach
21-Aug,36047059402,3059402,147,1318,1465,Brooklyn,3470556.224,Sheepshead Bay-Manhattan Beach-Gerritsen Beach
19-May,36047059403,3059403,10444,5923,16367,Brooklyn,2225484.989,Sheepshead Bay-Manhattan Beach-Gerritsen Beach
21-May,36047059403,3059403,13355,46654,60009,Brooklyn,2225484.989,Sheepshead Bay-Manhattan Beach-Gerritsen Beach
19-Jun,36047059403,3059403,11700,39867,51567,Brooklyn,2225484.989,Sheepshead Bay-Manhattan Beach-Gerritsen Beach
21-Jun,36047059403,3059403,1874,12922,14796,Brooklyn,2225484.989,Sheepshead Bay-Manhattan Beach-Gerritsen Beach
19-Jul,36047059403,3059403,5060,32154,37214,Brooklyn,2225484.989,Sheepshead Bay-Manhattan Beach-Gerritsen Beach
21-Jul,36047059403,3059403,12265,15201,27466,Brooklyn,2225484.989,Sheepshead Bay-Manhattan Beach-Gerritsen Beach
19-Aug,36047059403,3059403,4596,80807,85403,Brooklyn,2225484.989,Sheepshead Bay-Manhattan Beach-Gerritsen Beach
21-Aug,36047059403,3059403,10595,114157,124752,Brooklyn,2225484.989,Sheepshead Bay-Manhattan Beach-Gerritsen Beach
19-May,36047059404,3059404,5357,14360,19717,Brooklyn,2302530.943,Sheepshead Bay-Manhattan Beach-Gerritsen Beach
21-May,36047059404,3059404,10325,102354,112679,Brooklyn,2302530.943,Sheepshead Bay-Manhattan Beach-Gerritsen Beach
19-Jun,36047059404,3059404,9352,89188,98540,Brooklyn,2302530.943,Sheepshead Bay-Manhattan Beach-Gerritsen Beach
21-Jun,36047059404,3059404,16531,105107,121638,Brooklyn,2302530.943,Sheepshead Bay-Manhattan Beach-Gerritsen Beach
19-Jul,36047059404,3059404,14213,91962,106175,Brooklyn,2302530.943,Sheepshead Bay-Manhattan Beach-Gerritsen Beach
21-Jul,36047059404,3059404,8031,46772,54803,Brooklyn,2302530.943,Sheepshead Bay-Manhattan Beach-Gerritsen Beach
19-Aug,36047059404,3059404,5755,82587,88342,Brooklyn,2302530.943,Sheepshead Bay-Manhattan Beach-Gerritsen Beach
21-Aug,36047059404,3059404,9172,91498,100670,Brooklyn,2302530.943,Sheepshead Bay-Manhattan Beach-Gerritsen Beach
19-May,36047059600,3059600,6601,71055,77656,Brooklyn,1863185.121,Sheepshead Bay-Manhattan Beach-Gerritsen Beach
21-May,36047059600,3059600,14210,35631,49841,Brooklyn,1863185.121,Sheepshead Bay-Manhattan Beach-Gerritsen Beach
19-Jun,36047059600,3059600,1038,96231,97269,Brooklyn,1863185.121,Sheepshead Bay-Manhattan Beach-Gerritsen Beach
21-Jun,36047059600,3059600,4564,77369,81933,Brooklyn,1863185.121,Sheepshead Bay-Manhattan Beach-Gerritsen Beach
19-Jul,36047059600,3059600,6430,102917,109347,Brooklyn,1863185.121,Sheepshead Bay-Manhattan Beach-Gerritsen Beach
21-Jul,36047059600,3059600,7157,47850,55007,Brooklyn,1863185.121,Sheepshead Bay-Manhattan Beach-Gerritsen Beach
19-Aug,36047059600,3059600,1620,19752,21372,Brooklyn,1863185.121,Sheepshead Bay-Manhattan Beach-Gerritsen Beach
21-Aug,36047059600,3059600,5132,54976,60108,Brooklyn,1863185.121,Sheepshead Bay-Manhattan Beach-Gerritsen Beach
19-May,36047059800,3059800,5990,102686,108676,Brooklyn,2145271.553,Sheepshead Bay-Manhattan Beach-Gerritsen Beach
21-May,36047059800,3059800,14807,29805,44612,Brooklyn,2145271.553,Sheepshead Bay-Manhattan Beach-Gerritsen Beach
19-Jun,36047059800,3059800,12819,54386,67205,Brooklyn,2145271.553,Sheepshead Bay-Manhattan Beach-Gerritsen Beach
21-Jun,36047059800,3059800,6063,25342,31405,Brooklyn,2145271.553,Sheepshead Bay-Manhattan Beach-Gerritsen Beach
19-Jul,36047059800,3059800,14713,105353,120066,Brooklyn,2145271.553,Sheepshead Bay-Manhattan Beach-Gerritsen Beach
21-Jul,36047059800,3059800,10999,34532,45531,Brooklyn,2145271.553,Sheepshead Bay-Manhattan Beach-Gerritsen Beach
19-Aug,36047059800,3059800,10627,36878,47505,Brooklyn,2145271.553,Sheepshead Bay-Manhattan Beach-Gerritsen Beach
21-Aug,36047059800,3059800,2707,14615,17322,Brooklyn,2145271.553,Sheepshead Bay-Manhattan Beach-Gerritsen Beach
19-May,36047060000,3060000,11684,9382,21066,Brooklyn,4732242.694,Sheepshead Bay-Manhattan Beach-Gerritsen Beach
21-May,36047060000,3060000,5616,105720,111336,Brooklyn,4732242.694,Sheepshead Bay-Manhattan Beach-Gerritsen Beach
19-Jun,36047060000,3060000,3754,80842,84596,Brooklyn,4732242.694,Sheepshead Bay-Manhattan Beach-Gerritsen Beach
21-Jun,36047060000,3060000,0,107313,107313,Brooklyn,4732242.694,Sheepshead Bay-Manhattan Beach-Gerritsen Beach
19-Jul,36047060000,3060000,3638,54303,57941,Brooklyn,4732242.694,Sheepshead Bay-Manhattan Beach-Gerritsen Beach
21-Jul,36047060000,3060000,6839,72367,79206,Brooklyn,4732242.694,Sheepshead Bay-Manhattan Beach-Gerritsen Beach
19-Aug,36047060000,3060000,5982,67373,73355,Brooklyn,4732242.694,Sheepshead Bay-Manhattan Beach-Gerritsen Beach
21-Aug,36047060000,3060000,8989,134751,143740,Brooklyn,4732242.694,Sheepshead Bay-Manhattan Beach-Gerritsen Beach
19-May,36047060600,3060600,11460,119704,131164,Brooklyn,1950213.65,Sheepshead Bay-Manhattan Beach-Gerritsen Beach
21-May,36047060600,3060600,0,54979,54979,Brooklyn,1950213.65,Sheepshead Bay-Manhattan Beach-Gerritsen Beach
19-Jun,36047060600,3060600,11566,127931,139497,Brooklyn,1950213.65,Sheepshead Bay-Manhattan Beach-Gerritsen Beach
21-Jun,36047060600,3060600,14130,58969,73099,Brooklyn,1950213.65,Sheepshead Bay-Manhattan Beach-Gerritsen Beach
19-Jul,36047060600,3060600,6881,74409,81290,Brooklyn,1950213.65,Sheepshead Bay-Manhattan Beach-Gerritsen Beach
21-Jul,36047060600,3060600,0,87524,87524,Brooklyn,1950213.65,Sheepshead Bay-Manhattan Beach-Gerritsen Beach
19-Aug,36047060600,3060600,6333,81611,87944,Brooklyn,1950213.65,Sheepshead Bay-Manhattan Beach-Gerritsen Beach
21-Aug,36047060600,3060600,7008,45939,52947,Brooklyn,1950213.65,Sheepshead Bay-Manhattan Beach-Gerritsen Beach
19-May,36047060800,3060800,5178,107861,113039,Brooklyn,4306805.381,Sheepshead Bay-Manhattan Beach-Gerritsen Beach
21-May,36047060800,3060800,5914,98428,104342,Brooklyn,4306805.381,Sheepshead Bay-Manhattan Beach-Gerritsen Beach
19-Jun,36047060800,3060800,12720,71307,84027,Brooklyn,4306805.381,Sheepshead Bay-Manhattan Beach-Gerritsen Beach
21-Jun,36047060800,3060800,15253,68097,83350,Brooklyn,4306805.381,Sheepshead Bay-Manhattan Beach-Gerritsen Beach
19-Jul,36047060800,3060800,1638,56777,58415,Brooklyn,4306805.381,Sheepshead Bay-Manhattan Beach-Gerritsen Beach
21-Jul,36047060800,3060800,649,88910,89559,Brooklyn,4306805.381,Sheepshead Bay-Manhattan Beach-Gerritsen Beach
19-Aug,36047060800,3060800,4962,96982,101944,Brooklyn,4306805.381,Sheepshead Bay-Manhattan Beach-Gerritsen Beach
21-Aug,36047060800,3060800,9370,128243,137613,Brooklyn,4306805.381,Sheepshead Bay-Manhattan Beach-Gerritsen Beach
19-May,36047061002,3061002,10015,56502,66517,Brooklyn,2430445.473,Brighton Beach
21-May,36047061002,3061002,6348,55630,61978,Brooklyn,2430445.473,Brighton Beach
19-Jun,36047061002,3061002,4805,59103,63908,Brooklyn,2430445.473,Brighton Beach
21-Jun,36047061002,3061002,7770,71,7841,Brooklyn,2430445.473,Brighton Beach
19-Jul,36047061002,3061002,13730,111629,125359,Brooklyn,2430445.473,Brighton Beach
21-Jul,36047061002,3061002,6846,71388,78234,Brooklyn,2430445.473,Brighton Beach
19-Aug,36047061002,3061002,7677,79563,87240,Brooklyn,2430445.473,Brighton Beach
21-Aug,36047061002,3061002,8469,27470,35939,Brooklyn,2430445.473,Brighton Beach
19-May,36047061003,3061003,13136,83294,96430,Brooklyn,904406.9929,Brighton Beach
21-May,36047061003,3061003,7312,58310,65622,Brooklyn,904406.9929,Brighton Beach
19-Jun,36047061003,3061003,3526,85687,89213,Brooklyn,904406.9929,Brighton Beach
21-Jun,36047061003,3061003,3389,94077,97466,Brooklyn,904406.9929,Brighton Beach
19-Jul,36047061003,3061003,7174,47873,55047,Brooklyn,904406.9929,Brighton Beach
21-Jul,36047061003,3061003,9240,102388,111628,Brooklyn,904406.9929,Brighton Beach
19-Aug,36047061003,3061003,0,122348,122348,Brooklyn,904406.9929,Brighton Beach
21-Aug,36047061003,3061003,384,64928,65312,Brooklyn,904406.9929,Brighton Beach
19-May,36047061004,3061004,20773,68173,88946,Brooklyn,2384898.335,Brighton Beach
21-May,36047061004,3061004,4614,129508,134122,Brooklyn,2384898.335,Brighton Beach
19-Jun,36047061004,3061004,0,70700,70700,Brooklyn,2384898.335,Brighton Beach
21-Jun,36047061004,3061004,6946,131086,138032,Brooklyn,2384898.335,Brighton Beach
19-Jul,36047061004,3061004,6444,75132,81576,Brooklyn,2384898.335,Brighton Beach
21-Jul,36047061004,3061004,4817,18913,23730,Brooklyn,2384898.335,Brighton Beach
19-Aug,36047061004,3061004,6308,128592,134900,Brooklyn,2384898.335,Brighton Beach
21-Aug,36047061004,3061004,802,123980,124782,Brooklyn,2384898.335,Brighton Beach
19-May,36047061200,3061200,10088,56085,66173,Brooklyn,2130753.49,Sheepshead Bay-Manhattan Beach-Gerritsen Beach
21-May,36047061200,3061200,10743,26196,36939,Brooklyn,2130753.49,Sheepshead Bay-Manhattan Beach-Gerritsen Beach
19-Jun,36047061200,3061200,4793,144369,149162,Brooklyn,2130753.49,Sheepshead Bay-Manhattan Beach-Gerritsen Beach
21-Jun,36047061200,3061200,4216,48328,52544,Brooklyn,2130753.49,Sheepshead Bay-Manhattan Beach-Gerritsen Beach
19-Jul,36047061200,3061200,2894,80902,83796,Brooklyn,2130753.49,Sheepshead Bay-Manhattan Beach-Gerritsen Beach
21-Jul,36047061200,3061200,5269,126699,131968,Brooklyn,2130753.49,Sheepshead Bay-Manhattan Beach-Gerritsen Beach
19-Aug,36047061200,3061200,10918,50860,61778,Brooklyn,2130753.49,Sheepshead Bay-Manhattan Beach-Gerritsen Beach
21-Aug,36047061200,3061200,14646,57536,72182,Brooklyn,2130753.49,Sheepshead Bay-Manhattan Beach-Gerritsen Beach
19-May,36047061600,3061600,8370,134574,142944,Brooklyn,7850056.489,Sheepshead Bay-Manhattan Beach-Gerritsen Beach
21-May,36047061600,3061600,0,54122,54122,Brooklyn,7850056.489,Sheepshead Bay-Manhattan Beach-Gerritsen Beach
19-Jun,36047061600,3061600,17649,44322,61971,Brooklyn,7850056.489,Sheepshead Bay-Manhattan Beach-Gerritsen Beach
21-Jun,36047061600,3061600,6653,69923,76576,Brooklyn,7850056.489,Sheepshead Bay-Manhattan Beach-Gerritsen Beach
19-Jul,36047061600,3061600,3751,88764,92515,Brooklyn,7850056.489,Sheepshead Bay-Manhattan Beach-Gerritsen Beach
21-Jul,36047061600,3061600,3906,116668,120574,Brooklyn,7850056.489,Sheepshead Bay-Manhattan Beach-Gerritsen Beach
19-Aug,36047061600,3061600,8601,55080,63681,Brooklyn,7850056.489,Sheepshead Bay-Manhattan Beach-Gerritsen Beach
21-Aug,36047061600,3061600,13298,55883,69181,Brooklyn,7850056.489,Sheepshead Bay-Manhattan Beach-Gerritsen Beach
19-May,36047062000,3062000,13549,29715,43264,Brooklyn,3438941.255,Sheepshead Bay-Manhattan Beach-Gerritsen Beach
21-May,36047062000,3062000,6549,5892,12441,Brooklyn,3438941.255,Sheepshead Bay-Manhattan Beach-Gerritsen Beach
19-Jun,36047062000,3062000,3465,113282,116747,Brooklyn,3438941.255,Sheepshead Bay-Manhattan Beach-Gerritsen Beach
21-Jun,36047062000,3062000,14279,55236,69515,Brooklyn,3438941.255,Sheepshead Bay-Manhattan Beach-Gerritsen Beach
19-Jul,36047062000,3062000,0,108559,108559,Brooklyn,3438941.255,Sheepshead Bay-Manhattan Beach-Gerritsen Beach
21-Jul,36047062000,3062000,4389,39621,44010,Brooklyn,3438941.255,Sheepshead Bay-Manhattan Beach-Gerritsen Beach
19-Aug,36047062000,3062000,12681,90988,103669,Brooklyn,3438941.255,Sheepshead Bay-Manhattan Beach-Gerritsen Beach
21-Aug,36047062000,3062000,14826,27641,42467,Brooklyn,3438941.255,Sheepshead Bay-Manhattan Beach-Gerritsen Beach
19-May,36047062200,3062200,10607,118305,128912,Brooklyn,2689213.141,Sheepshead Bay-Manhattan Beach-Gerritsen Beach
21-May,36047062200,3062200,10590,37674,48264,Brooklyn,2689213.141,Sheepshead Bay-Manhattan Beach-Gerritsen Beach
19-Jun,36047062200,3062200,2557,126565,129122,Brooklyn,2689213.141,Sheepshead Bay-Manhattan Beach-Gerritsen Beach
21-Jun,36047062200,3062200,14733,145882,160615,Brooklyn,2689213.141,Sheepshead Bay-Manhattan Beach-Gerritsen Beach
19-Jul,36047062200,3062200,12390,97940,110330,Brooklyn,2689213.141,Sheepshead Bay-Manhattan Beach-Gerritsen Beach
21-Jul,36047062200,3062200,0,1799,1799,Brooklyn,2689213.141,Sheepshead Bay-Manhattan Beach-Gerritsen Beach
19-Aug,36047062200,3062200,9618,78918,88536,Brooklyn,2689213.141,Sheepshead Bay-Manhattan Beach-Gerritsen Beach
21-Aug,36047062200,3062200,9391,98519,107910,Brooklyn,2689213.141,Sheepshead Bay-Manhattan Beach-Gerritsen Beach
19-May,36047063200,3063200,7543,45949,53492,Brooklyn,1264075.722,Sheepshead Bay-Manhattan Beach-Gerritsen Beach
21-May,36047063200,3063200,6048,118909,124957,Brooklyn,1264075.722,Sheepshead Bay-Manhattan Beach-Gerritsen Beach
19-Jun,36047063200,3063200,11217,78615,89832,Brooklyn,1264075.722,Sheepshead Bay-Manhattan Beach-Gerritsen Beach
21-Jun,36047063200,3063200,0,11917,11917,Brooklyn,1264075.722,Sheepshead Bay-Manhattan Beach-Gerritsen Beach
19-Jul,36047063200,3063200,2288,58561,60849,Brooklyn,1264075.722,Sheepshead Bay-Manhattan Beach-Gerritsen Beach
21-Jul,36047063200,3063200,9895,33468,43363,Brooklyn,1264075.722,Sheepshead Bay-Manhattan Beach-Gerritsen Beach
19-Aug,36047063200,3063200,22120,53817,75937,Brooklyn,1264075.722,Sheepshead Bay-Manhattan Beach-Gerritsen Beach
21-Aug,36047063200,3063200,13719,68540,82259,Brooklyn,1264075.722,Sheepshead Bay-Manhattan Beach-Gerritsen Beach
19-May,36047063600,3063600,9320,83293,92613,Brooklyn,1230571.69,Marine Park-Mill Basin-Bergen Beach
21-May,36047063600,3063600,13273,116292,129565,Brooklyn,1230571.69,Marine Park-Mill Basin-Bergen Beach
19-Jun,36047063600,3063600,319,103454,103773,Brooklyn,1230571.69,Marine Park-Mill Basin-Bergen Beach
21-Jun,36047063600,3063600,21803,110865,132668,Brooklyn,1230571.69,Marine Park-Mill Basin-Bergen Beach
19-Jul,36047063600,3063600,10436,125765,136201,Brooklyn,1230571.69,Marine Park-Mill Basin-Bergen Beach
21-Jul,36047063600,3063600,15331,109849,125180,Brooklyn,1230571.69,Marine Park-Mill Basin-Bergen Beach
19-Aug,36047063600,3063600,8326,34964,43290,Brooklyn,1230571.69,Marine Park-Mill Basin-Bergen Beach
21-Aug,36047063600,3063600,1357,22003,23360,Brooklyn,1230571.69,Marine Park-Mill Basin-Bergen Beach
19-May,36047063800,3063800,9831,129313,139144,Brooklyn,1498401.145,Madison
21-May,36047063800,3063800,15747,90319,106066,Brooklyn,1498401.145,Madison
19-Jun,36047063800,3063800,11981,109207,121188,Brooklyn,1498401.145,Madison
21-Jun,36047063800,3063800,0,104838,104838,Brooklyn,1498401.145,Madison
19-Jul,36047063800,3063800,16444,112973,129417,Brooklyn,1498401.145,Madison
21-Jul,36047063800,3063800,7439,86913,94352,Brooklyn,1498401.145,Madison
19-Aug,36047063800,3063800,5672,9771,15443,Brooklyn,1498401.145,Madison
21-Aug,36047063800,3063800,4026,143983,148009,Brooklyn,1498401.145,Madison
19-May,36047064000,3064000,11995,109251,121246,Brooklyn,1651211.848,Marine Park-Mill Basin-Bergen Beach
21-May,36047064000,3064000,9561,144450,154011,Brooklyn,1651211.848,Marine Park-Mill Basin-Bergen Beach
19-Jun,36047064000,3064000,2951,62870,65821,Brooklyn,1651211.848,Marine Park-Mill Basin-Bergen Beach
21-Jun,36047064000,3064000,7663,42390,50053,Brooklyn,1651211.848,Marine Park-Mill Basin-Bergen Beach
19-Jul,36047064000,3064000,10153,117762,127915,Brooklyn,1651211.848,Marine Park-Mill Basin-Bergen Beach
21-Jul,36047064000,3064000,16547,94160,110707,Brooklyn,1651211.848,Marine Park-Mill Basin-Bergen Beach
19-Aug,36047064000,3064000,10354,160503,170857,Brooklyn,1651211.848,Marine Park-Mill Basin-Bergen Beach
21-Aug,36047064000,3064000,11441,67271,78712,Brooklyn,1651211.848,Marine Park-Mill Basin-Bergen Beach
19-May,36047064200,3064200,13179,63710,76889,Brooklyn,2530379.589,Madison
21-May,36047064200,3064200,11779,89351,101130,Brooklyn,2530379.589,Madison
19-Jun,36047064200,3064200,10454,126933,137387,Brooklyn,2530379.589,Madison
21-Jun,36047064200,3064200,0,94574,94574,Brooklyn,2530379.589,Madison
19-Jul,36047064200,3064200,12171,39166,51337,Brooklyn,2530379.589,Madison
21-Jul,36047064200,3064200,8735,100197,108932,Brooklyn,2530379.589,Madison
19-Aug,36047064200,3064200,2414,69227,71641,Brooklyn,2530379.589,Madison
21-Aug,36047064200,3064200,11793,96208,108001,Brooklyn,2530379.589,Madison
19-May,36047064400,3064400,10878,95166,106044,Brooklyn,2145902.195,Marine Park-Mill Basin-Bergen Beach
21-May,36047064400,3064400,1914,97787,99701,Brooklyn,2145902.195,Marine Park-Mill Basin-Bergen Beach
19-Jun,36047064400,3064400,12308,29437,41745,Brooklyn,2145902.195,Marine Park-Mill Basin-Bergen Beach
21-Jun,36047064400,3064400,6519,119366,125885,Brooklyn,2145902.195,Marine Park-Mill Basin-Bergen Beach
19-Jul,36047064400,3064400,16806,92517,109323,Brooklyn,2145902.195,Marine Park-Mill Basin-Bergen Beach
21-Jul,36047064400,3064400,10887,106986,117873,Brooklyn,2145902.195,Marine Park-Mill Basin-Bergen Beach
19-Aug,36047064400,3064400,10019,146395,156414,Brooklyn,2145902.195,Marine Park-Mill Basin-Bergen Beach
21-Aug,36047064400,3064400,20304,49863,70167,Brooklyn,2145902.195,Marine Park-Mill Basin-Bergen Beach
19-May,36047064600,3064600,12950,53976,66926,Brooklyn,1782721.398,Marine Park-Mill Basin-Bergen Beach
21-May,36047064600,3064600,13937,51721,65658,Brooklyn,1782721.398,Marine Park-Mill Basin-Bergen Beach
19-Jun,36047064600,3064600,12982,158475,171457,Brooklyn,1782721.398,Marine Park-Mill Basin-Bergen Beach
21-Jun,36047064600,3064600,1058,71,1129,Brooklyn,1782721.398,Marine Park-Mill Basin-Bergen Beach
19-Jul,36047064600,3064600,9956,72452,82408,Brooklyn,1782721.398,Marine Park-Mill Basin-Bergen Beach
21-Jul,36047064600,3064600,16088,62949,79037,Brooklyn,1782721.398,Marine Park-Mill Basin-Bergen Beach
19-Aug,36047064600,3064600,1351,99643,100994,Brooklyn,1782721.398,Marine Park-Mill Basin-Bergen Beach
21-Aug,36047064600,3064600,8698,87749,96447,Brooklyn,1782721.398,Marine Park-Mill Basin-Bergen Beach
19-May,36047064800,3064800,9982,41109,51091,Brooklyn,1631120.783,Marine Park-Mill Basin-Bergen Beach
21-May,36047064800,3064800,9416,151190,160606,Brooklyn,1631120.783,Marine Park-Mill Basin-Bergen Beach
19-Jun,36047064800,3064800,2282,161530,163812,Brooklyn,1631120.783,Marine Park-Mill Basin-Bergen Beach
21-Jun,36047064800,3064800,5099,106339,111438,Brooklyn,1631120.783,Marine Park-Mill Basin-Bergen Beach
19-Jul,36047064800,3064800,6945,68567,75512,Brooklyn,1631120.783,Marine Park-Mill Basin-Bergen Beach
21-Jul,36047064800,3064800,3431,87091,90522,Brooklyn,1631120.783,Marine Park-Mill Basin-Bergen Beach
19-Aug,36047064800,3064800,10026,65556,75582,Brooklyn,1631120.783,Marine Park-Mill Basin-Bergen Beach
21-Aug,36047064800,3064800,10903,109013,119916,Brooklyn,1631120.783,Marine Park-Mill Basin-Bergen Beach
19-May,36047065000,3065000,7051,29946,36997,Brooklyn,1789145.986,Flatlands
21-May,36047065000,3065000,10976,27635,38611,Brooklyn,1789145.986,Flatlands
19-Jun,36047065000,3065000,14396,103229,117625,Brooklyn,1789145.986,Flatlands
21-Jun,36047065000,3065000,16960,82953,99913,Brooklyn,1789145.986,Flatlands
19-Jul,36047065000,3065000,14550,59901,74451,Brooklyn,1789145.986,Flatlands
21-Jul,36047065000,3065000,1434,83869,85303,Brooklyn,1789145.986,Flatlands
19-Aug,36047065000,3065000,13911,15029,28940,Brooklyn,1789145.986,Flatlands
21-Aug,36047065000,3065000,0,37372,37372,Brooklyn,1789145.986,Flatlands
19-May,36047065200,3065200,5768,86306,92074,Brooklyn,1882864.451,Marine Park-Mill Basin-Bergen Beach
21-May,36047065200,3065200,6152,57252,63404,Brooklyn,1882864.451,Marine Park-Mill Basin-Bergen Beach
19-Jun,36047065200,3065200,9394,34904,44298,Brooklyn,1882864.451,Marine Park-Mill Basin-Bergen Beach
21-Jun,36047065200,3065200,10464,42588,53052,Brooklyn,1882864.451,Marine Park-Mill Basin-Bergen Beach
19-Jul,36047065200,3065200,6471,33792,40263,Brooklyn,1882864.451,Marine Park-Mill Basin-Bergen Beach
21-Jul,36047065200,3065200,7471,63533,71004,Brooklyn,1882864.451,Marine Park-Mill Basin-Bergen Beach
19-Aug,36047065200,3065200,8088,102546,110634,Brooklyn,1882864.451,Marine Park-Mill Basin-Bergen Beach
21-Aug,36047065200,3065200,14942,101499,116441,Brooklyn,1882864.451,Marine Park-Mill Basin-Bergen Beach
19-May,36047065400,3065400,3361,67144,70505,Brooklyn,1631231.624,Marine Park-Mill Basin-Bergen Beach
21-May,36047065400,3065400,14405,44976,59381,Brooklyn,1631231.624,Marine Park-Mill Basin-Bergen Beach
19-Jun,36047065400,3065400,14513,39340,53853,Brooklyn,1631231.624,Marine Park-Mill Basin-Bergen Beach
21-Jun,36047065400,3065400,7661,37124,44785,Brooklyn,1631231.624,Marine Park-Mill Basin-Bergen Beach
19-Jul,36047065400,3065400,9761,131976,141737,Brooklyn,1631231.624,Marine Park-Mill Basin-Bergen Beach
21-Jul,36047065400,3065400,10300,58974,69274,Brooklyn,1631231.624,Marine Park-Mill Basin-Bergen Beach
19-Aug,36047065400,3065400,14814,32335,47149,Brooklyn,1631231.624,Marine Park-Mill Basin-Bergen Beach
21-Aug,36047065400,3065400,7656,29623,37279,Brooklyn,1631231.624,Marine Park-Mill Basin-Bergen Beach
19-May,36047065600,3065600,11828,80907,92735,Brooklyn,1653144.013,Marine Park-Mill Basin-Bergen Beach
21-May,36047065600,3065600,7905,57260,65165,Brooklyn,1653144.013,Marine Park-Mill Basin-Bergen Beach
19-Jun,36047065600,3065600,15424,2944,18368,Brooklyn,1653144.013,Marine Park-Mill Basin-Bergen Beach
21-Jun,36047065600,3065600,18558,98870,117428,Brooklyn,1653144.013,Marine Park-Mill Basin-Bergen Beach
19-Jul,36047065600,3065600,16999,38945,55944,Brooklyn,1653144.013,Marine Park-Mill Basin-Bergen Beach
21-Jul,36047065600,3065600,5642,136460,142102,Brooklyn,1653144.013,Marine Park-Mill Basin-Bergen Beach
19-Aug,36047065600,3065600,5724,88479,94203,Brooklyn,1653144.013,Marine Park-Mill Basin-Bergen Beach
21-Aug,36047065600,3065600,4863,10194,15057,Brooklyn,1653144.013,Marine Park-Mill Basin-Bergen Beach
19-May,36047065800,3065800,9621,52072,61693,Brooklyn,1650702.373,Marine Park-Mill Basin-Bergen Beach
21-May,36047065800,3065800,6182,72385,78567,Brooklyn,1650702.373,Marine Park-Mill Basin-Bergen Beach
19-Jun,36047065800,3065800,8050,48875,56925,Brooklyn,1650702.373,Marine Park-Mill Basin-Bergen Beach
21-Jun,36047065800,3065800,12436,125363,137799,Brooklyn,1650702.373,Marine Park-Mill Basin-Bergen Beach
19-Jul,36047065800,3065800,9472,71,9543,Brooklyn,1650702.373,Marine Park-Mill Basin-Bergen Beach
21-Jul,36047065800,3065800,10663,30251,40914,Brooklyn,1650702.373,Marine Park-Mill Basin-Bergen Beach
19-Aug,36047065800,3065800,4340,57128,61468,Brooklyn,1650702.373,Marine Park-Mill Basin-Bergen Beach
21-Aug,36047065800,3065800,13860,79050,92910,Brooklyn,1650702.373,Marine Park-Mill Basin-Bergen Beach
19-May,36047066000,3066000,8,31525,31533,Brooklyn,1639605.312,Marine Park-Mill Basin-Bergen Beach
21-May,36047066000,3066000,0,48679,48679,Brooklyn,1639605.312,Marine Park-Mill Basin-Bergen Beach
19-Jun,36047066000,3066000,12319,28050,40369,Brooklyn,1639605.312,Marine Park-Mill Basin-Bergen Beach
21-Jun,36047066000,3066000,11191,71,11262,Brooklyn,1639605.312,Marine Park-Mill Basin-Bergen Beach
19-Jul,36047066000,3066000,10346,120669,131015,Brooklyn,1639605.312,Marine Park-Mill Basin-Bergen Beach
21-Jul,36047066000,3066000,10766,88855,99621,Brooklyn,1639605.312,Marine Park-Mill Basin-Bergen Beach
19-Aug,36047066000,3066000,12266,35026,47292,Brooklyn,1639605.312,Marine Park-Mill Basin-Bergen Beach
21-Aug,36047066000,3066000,6349,106159,112508,Brooklyn,1639605.312,Marine Park-Mill Basin-Bergen Beach
19-May,36047067000,3067000,17496,71,17567,Brooklyn,2243640.057,Marine Park-Mill Basin-Bergen Beach
21-May,36047067000,3067000,13097,29422,42519,Brooklyn,2243640.057,Marine Park-Mill Basin-Bergen Beach
19-Jun,36047067000,3067000,23877,89885,113762,Brooklyn,2243640.057,Marine Park-Mill Basin-Bergen Beach
21-Jun,36047067000,3067000,9359,47589,56948,Brooklyn,2243640.057,Marine Park-Mill Basin-Bergen Beach
19-Jul,36047067000,3067000,3239,63356,66595,Brooklyn,2243640.057,Marine Park-Mill Basin-Bergen Beach
21-Jul,36047067000,3067000,9755,44717,54472,Brooklyn,2243640.057,Marine Park-Mill Basin-Bergen Beach
19-Aug,36047067000,3067000,5462,105966,111428,Brooklyn,2243640.057,Marine Park-Mill Basin-Bergen Beach
21-Aug,36047067000,3067000,6397,96884,103281,Brooklyn,2243640.057,Marine Park-Mill Basin-Bergen Beach
19-May,36047067200,3067200,7103,27086,34189,Brooklyn,1869823.29,Flatlands
21-May,36047067200,3067200,14165,61658,75823,Brooklyn,1869823.29,Flatlands
19-Jun,36047067200,3067200,13343,41527,54870,Brooklyn,1869823.29,Flatlands
21-Jun,36047067200,3067200,4950,31937,36887,Brooklyn,1869823.29,Flatlands
19-Jul,36047067200,3067200,3577,32400,35977,Brooklyn,1869823.29,Flatlands
21-Jul,36047067200,3067200,8814,87565,96379,Brooklyn,1869823.29,Flatlands
19-Aug,36047067200,3067200,4354,36932,41286,Brooklyn,1869823.29,Flatlands
21-Aug,36047067200,3067200,4094,121446,125540,Brooklyn,1869823.29,Flatlands
19-May,36047067400,3067400,7076,67047,74123,Brooklyn,2039940.926,Flatlands
21-May,36047067400,3067400,15454,57520,72974,Brooklyn,2039940.926,Flatlands
19-Jun,36047067400,3067400,7525,105566,113091,Brooklyn,2039940.926,Flatlands
21-Jun,36047067400,3067400,0,129839,129839,Brooklyn,2039940.926,Flatlands
19-Jul,36047067400,3067400,6946,76306,83252,Brooklyn,2039940.926,Flatlands
21-Jul,36047067400,3067400,6910,39207,46117,Brooklyn,2039940.926,Flatlands
19-Aug,36047067400,3067400,6133,143773,149906,Brooklyn,2039940.926,Flatlands
21-Aug,36047067400,3067400,16306,67335,83641,Brooklyn,2039940.926,Flatlands
19-May,36047067600,3067600,7574,139279,146853,Brooklyn,1672665.839,Flatlands
21-May,36047067600,3067600,5273,42714,47987,Brooklyn,1672665.839,Flatlands
19-Jun,36047067600,3067600,1045,100920,101965,Brooklyn,1672665.839,Flatlands
21-Jun,36047067600,3067600,13296,49780,63076,Brooklyn,1672665.839,Flatlands
19-Jul,36047067600,3067600,8949,11115,20064,Brooklyn,1672665.839,Flatlands
21-Jul,36047067600,3067600,3316,83996,87312,Brooklyn,1672665.839,Flatlands
19-Aug,36047067600,3067600,2323,71,2394,Brooklyn,1672665.839,Flatlands
21-Aug,36047067600,3067600,2167,48516,50683,Brooklyn,1672665.839,Flatlands
19-May,36047067800,3067800,10824,48646,59470,Brooklyn,1789096.156,Flatlands
21-May,36047067800,3067800,5939,48878,54817,Brooklyn,1789096.156,Flatlands
19-Jun,36047067800,3067800,1924,70835,72759,Brooklyn,1789096.156,Flatlands
21-Jun,36047067800,3067800,7131,102175,109306,Brooklyn,1789096.156,Flatlands
19-Jul,36047067800,3067800,16970,34893,51863,Brooklyn,1789096.156,Flatlands
21-Jul,36047067800,3067800,4539,122786,127325,Brooklyn,1789096.156,Flatlands
19-Aug,36047067800,3067800,7145,12537,19682,Brooklyn,1789096.156,Flatlands
21-Aug,36047067800,3067800,3042,11074,14116,Brooklyn,1789096.156,Flatlands
19-May,36047068000,3068000,5320,50668,55988,Brooklyn,1817783.309,Flatlands
21-May,36047068000,3068000,8013,65615,73628,Brooklyn,1817783.309,Flatlands
19-Jun,36047068000,3068000,11978,19786,31764,Brooklyn,1817783.309,Flatlands
21-Jun,36047068000,3068000,2818,71,2889,Brooklyn,1817783.309,Flatlands
19-Jul,36047068000,3068000,13142,94173,107315,Brooklyn,1817783.309,Flatlands
21-Jul,36047068000,3068000,3305,101819,105124,Brooklyn,1817783.309,Flatlands
19-Aug,36047068000,3068000,4319,66309,70628,Brooklyn,1817783.309,Flatlands
21-Aug,36047068000,3068000,13578,81313,94891,Brooklyn,1817783.309,Flatlands
19-May,36047068200,3068200,8151,86644,94795,Brooklyn,2176848.694,Flatlands
21-May,36047068200,3068200,6076,92155,98231,Brooklyn,2176848.694,Flatlands
19-Jun,36047068200,3068200,1413,44563,45976,Brooklyn,2176848.694,Flatlands
21-Jun,36047068200,3068200,16338,50639,66977,Brooklyn,2176848.694,Flatlands
19-Jul,36047068200,3068200,8023,73113,81136,Brooklyn,2176848.694,Flatlands
21-Jul,36047068200,3068200,1650,55188,56838,Brooklyn,2176848.694,Flatlands
19-Aug,36047068200,3068200,10847,91341,102188,Brooklyn,2176848.694,Flatlands
21-Aug,36047068200,3068200,12019,96843,108862,Brooklyn,2176848.694,Flatlands
19-May,36047068600,3068600,4357,46719,51076,Brooklyn,1592924.361,Marine Park-Mill Basin-Bergen Beach
21-May,36047068600,3068600,15654,11730,27384,Brooklyn,1592924.361,Marine Park-Mill Basin-Bergen Beach
19-Jun,36047068600,3068600,7572,111684,119256,Brooklyn,1592924.361,Marine Park-Mill Basin-Bergen Beach
21-Jun,36047068600,3068600,12739,71626,84365,Brooklyn,1592924.361,Marine Park-Mill Basin-Bergen Beach
19-Jul,36047068600,3068600,5663,125386,131049,Brooklyn,1592924.361,Marine Park-Mill Basin-Bergen Beach
21-Jul,36047068600,3068600,5198,141433,146631,Brooklyn,1592924.361,Marine Park-Mill Basin-Bergen Beach
19-Aug,36047068600,3068600,6813,98255,105068,Brooklyn,1592924.361,Marine Park-Mill Basin-Bergen Beach
21-Aug,36047068600,3068600,867,44413,45280,Brooklyn,1592924.361,Marine Park-Mill Basin-Bergen Beach
19-May,36047068800,3068800,14859,85103,99962,Brooklyn,1686416.953,Flatlands
21-May,36047068800,3068800,11312,109251,120563,Brooklyn,1686416.953,Flatlands
19-Jun,36047068800,3068800,16060,69133,85193,Brooklyn,1686416.953,Flatlands
21-Jun,36047068800,3068800,7899,81774,89673,Brooklyn,1686416.953,Flatlands
19-Jul,36047068800,3068800,0,84626,84626,Brooklyn,1686416.953,Flatlands
21-Jul,36047068800,3068800,8631,127487,136118,Brooklyn,1686416.953,Flatlands
19-Aug,36047068800,3068800,11283,98950,110233,Brooklyn,1686416.953,Flatlands
21-Aug,36047068800,3068800,16805,61740,78545,Brooklyn,1686416.953,Flatlands
19-May,36047069000,3069000,677,40690,41367,Brooklyn,1861628.93,Flatlands
21-May,36047069000,3069000,5501,41036,46537,Brooklyn,1861628.93,Flatlands
19-Jun,36047069000,3069000,10297,87221,97518,Brooklyn,1861628.93,Flatlands
21-Jun,36047069000,3069000,1739,34162,35901,Brooklyn,1861628.93,Flatlands
19-Jul,36047069000,3069000,11781,157279,169060,Brooklyn,1861628.93,Flatlands
21-Jul,36047069000,3069000,14466,56201,70667,Brooklyn,1861628.93,Flatlands
19-Aug,36047069000,3069000,6478,84351,90829,Brooklyn,1861628.93,Flatlands
21-Aug,36047069000,3069000,10169,68215,78384,Brooklyn,1861628.93,Flatlands
19-May,36047069200,3069200,11400,732,12132,Brooklyn,1952887.637,Flatlands
21-May,36047069200,3069200,21273,80317,101590,Brooklyn,1952887.637,Flatlands
19-Jun,36047069200,3069200,0,100888,100888,Brooklyn,1952887.637,Flatlands
21-Jun,36047069200,3069200,1012,100553,101565,Brooklyn,1952887.637,Flatlands
19-Jul,36047069200,3069200,11571,94027,105598,Brooklyn,1952887.637,Flatlands
21-Jul,36047069200,3069200,12967,150313,163280,Brooklyn,1952887.637,Flatlands
19-Aug,36047069200,3069200,8832,109653,118485,Brooklyn,1952887.637,Flatlands
21-Aug,36047069200,3069200,8683,119331,128014,Brooklyn,1952887.637,Flatlands
19-May,36047069601,3069601,13216,78050,91266,Brooklyn,4532216.36,Marine Park-Mill Basin-Bergen Beach
21-May,36047069601,3069601,6157,114714,120871,Brooklyn,4532216.36,Marine Park-Mill Basin-Bergen Beach
19-Jun,36047069601,3069601,15462,48772,64234,Brooklyn,4532216.36,Marine Park-Mill Basin-Bergen Beach
21-Jun,36047069601,3069601,8032,23539,31571,Brooklyn,4532216.36,Marine Park-Mill Basin-Bergen Beach
19-Jul,36047069601,3069601,8168,123580,131748,Brooklyn,4532216.36,Marine Park-Mill Basin-Bergen Beach
21-Jul,36047069601,3069601,5146,12393,17539,Brooklyn,4532216.36,Marine Park-Mill Basin-Bergen Beach
19-Aug,36047069601,3069601,8178,59194,67372,Brooklyn,4532216.36,Marine Park-Mill Basin-Bergen Beach
21-Aug,36047069601,3069601,8330,25659,33989,Brooklyn,4532216.36,Marine Park-Mill Basin-Bergen Beach
19-May,36047069800,3069800,12190,59743,71933,Brooklyn,5428346.537,Marine Park-Mill Basin-Bergen Beach
21-May,36047069800,3069800,5524,60027,65551,Brooklyn,5428346.537,Marine Park-Mill Basin-Bergen Beach
19-Jun,36047069800,3069800,6833,65088,71921,Brooklyn,5428346.537,Marine Park-Mill Basin-Bergen Beach
21-Jun,36047069800,3069800,2786,122353,125139,Brooklyn,5428346.537,Marine Park-Mill Basin-Bergen Beach
19-Jul,36047069800,3069800,10973,103869,114842,Brooklyn,5428346.537,Marine Park-Mill Basin-Bergen Beach
21-Jul,36047069800,3069800,2599,75085,77684,Brooklyn,5428346.537,Marine Park-Mill Basin-Bergen Beach
19-Aug,36047069800,3069800,16863,42309,59172,Brooklyn,5428346.537,Marine Park-Mill Basin-Bergen Beach
21-Aug,36047069800,3069800,9088,30284,39372,Brooklyn,5428346.537,Marine Park-Mill Basin-Bergen Beach
19-May,36047070000,3070000,0,74831,74831,Brooklyn,2177086.056,Marine Park-Mill Basin-Bergen Beach
21-May,36047070000,3070000,11284,166765,178049,Brooklyn,2177086.056,Marine Park-Mill Basin-Bergen Beach
19-Jun,36047070000,3070000,5724,91363,97087,Brooklyn,2177086.056,Marine Park-Mill Basin-Bergen Beach
21-Jun,36047070000,3070000,19994,69568,89562,Brooklyn,2177086.056,Marine Park-Mill Basin-Bergen Beach
19-Jul,36047070000,3070000,0,74450,74450,Brooklyn,2177086.056,Marine Park-Mill Basin-Bergen Beach
21-Jul,36047070000,3070000,8533,121920,130453,Brooklyn,2177086.056,Marine Park-Mill Basin-Bergen Beach
19-Aug,36047070000,3070000,6774,48755,55529,Brooklyn,2177086.056,Marine Park-Mill Basin-Bergen Beach
21-Aug,36047070000,3070000,6608,46031,52639,Brooklyn,2177086.056,Marine Park-Mill Basin-Bergen Beach
19-May,36047070201,3070201,24453,53920,78373,Brooklyn,11085721.46,Marine Park-Mill Basin-Bergen Beach
21-May,36047070201,3070201,0,167257,167257,Brooklyn,11085721.46,Marine Park-Mill Basin-Bergen Beach
19-Jun,36047070201,3070201,5425,72325,77750,Brooklyn,11085721.46,Marine Park-Mill Basin-Bergen Beach
21-Jun,36047070201,3070201,8044,121463,129507,Brooklyn,11085721.46,Marine Park-Mill Basin-Bergen Beach
19-Jul,36047070201,3070201,5823,95692,101515,Brooklyn,11085721.46,Marine Park-Mill Basin-Bergen Beach
21-Jul,36047070201,3070201,6991,46455,53446,Brooklyn,11085721.46,Marine Park-Mill Basin-Bergen Beach
19-Aug,36047070201,3070201,14636,52865,67501,Brooklyn,11085721.46,Marine Park-Mill Basin-Bergen Beach
21-Aug,36047070201,3070201,14147,31478,45625,Brooklyn,11085721.46,Marine Park-Mill Basin-Bergen Beach
19-May,36047070203,3070203,6656,28061,34717,Brooklyn,39754276.89,Jamaica Bay (West)
21-May,36047070203,3070203,8064,56093,64157,Brooklyn,39754276.89,Jamaica Bay (West)
19-Jun,36047070203,3070203,7126,78092,85218,Brooklyn,39754276.89,Jamaica Bay (West)
21-Jun,36047070203,3070203,12436,64237,76673,Brooklyn,39754276.89,Jamaica Bay (West)
19-Jul,36047070203,3070203,15731,34285,50016,Brooklyn,39754276.89,Jamaica Bay (West)
21-Jul,36047070203,3070203,5414,98007,103421,Brooklyn,39754276.89,Jamaica Bay (West)
19-Aug,36047070203,3070203,13877,84300,98177,Brooklyn,39754276.89,Jamaica Bay (West)
21-Aug,36047070203,3070203,2055,101427,103482,Brooklyn,39754276.89,Jamaica Bay (West)
19-May,36047072000,3072000,1266,10810,12076,Brooklyn,1701872.01,Flatlands
21-May,36047072000,3072000,174,73397,73571,Brooklyn,1701872.01,Flatlands
19-Jun,36047072000,3072000,10665,18905,29570,Brooklyn,1701872.01,Flatlands
21-Jun,36047072000,3072000,6093,99621,105714,Brooklyn,1701872.01,Flatlands
19-Jul,36047072000,3072000,4665,40478,45143,Brooklyn,1701872.01,Flatlands
21-Jul,36047072000,3072000,5972,139216,145188,Brooklyn,1701872.01,Flatlands
19-Aug,36047072000,3072000,10517,51106,61623,Brooklyn,1701872.01,Flatlands
21-Aug,36047072000,3072000,14577,125383,139960,Brooklyn,1701872.01,Flatlands
19-May,36047072200,3072200,5452,384,5836,Brooklyn,2769417.679,Flatlands
21-May,36047072200,3072200,1155,81416,82571,Brooklyn,2769417.679,Flatlands
19-Jun,36047072200,3072200,12167,194317,206484,Brooklyn,2769417.679,Flatlands
21-Jun,36047072200,3072200,3621,78164,81785,Brooklyn,2769417.679,Flatlands
19-Jul,36047072200,3072200,5452,54739,60191,Brooklyn,2769417.679,Flatlands
21-Jul,36047072200,3072200,17301,890,18191,Brooklyn,2769417.679,Flatlands
19-Aug,36047072200,3072200,1666,88749,90415,Brooklyn,2769417.679,Flatlands
21-Aug,36047072200,3072200,0,62510,62510,Brooklyn,2769417.679,Flatlands
19-May,36047072400,3072400,11385,128092,139477,Brooklyn,2068970.226,Flatlands
21-May,36047072400,3072400,6289,78606,84895,Brooklyn,2068970.226,Flatlands
19-Jun,36047072400,3072400,16416,29296,45712,Brooklyn,2068970.226,Flatlands
21-Jun,36047072400,3072400,12740,6374,19114,Brooklyn,2068970.226,Flatlands
19-Jul,36047072400,3072400,9258,43458,52716,Brooklyn,2068970.226,Flatlands
21-Jul,36047072400,3072400,14085,33471,47556,Brooklyn,2068970.226,Flatlands
19-Aug,36047072400,3072400,5560,99481,105041,Brooklyn,2068970.226,Flatlands
21-Aug,36047072400,3072400,3806,56538,60344,Brooklyn,2068970.226,Flatlands
19-May,36047072600,3072600,16507,47504,64011,Brooklyn,2962944.125,Flatlands
21-May,36047072600,3072600,12074,75380,87454,Brooklyn,2962944.125,Flatlands
19-Jun,36047072600,3072600,9587,37528,47115,Brooklyn,2962944.125,Flatlands
21-Jun,36047072600,3072600,15943,48444,64387,Brooklyn,2962944.125,Flatlands
19-Jul,36047072600,3072600,6432,82690,89122,Brooklyn,2962944.125,Flatlands
21-Jul,36047072600,3072600,8797,72326,81123,Brooklyn,2962944.125,Flatlands
19-Aug,36047072600,3072600,3934,117469,121403,Brooklyn,2962944.125,Flatlands
21-Aug,36047072600,3072600,1525,37961,39486,Brooklyn,2962944.125,Flatlands
19-May,36047072800,3072800,10728,127847,138575,Brooklyn,2282665.41,Flatlands
21-May,36047072800,3072800,12653,106984,119637,Brooklyn,2282665.41,Flatlands
19-Jun,36047072800,3072800,3329,40434,43763,Brooklyn,2282665.41,Flatlands
21-Jun,36047072800,3072800,12713,9123,21836,Brooklyn,2282665.41,Flatlands
19-Jul,36047072800,3072800,4978,58525,63503,Brooklyn,2282665.41,Flatlands
21-Jul,36047072800,3072800,12987,99482,112469,Brooklyn,2282665.41,Flatlands
19-Aug,36047072800,3072800,6436,36975,43411,Brooklyn,2282665.41,Flatlands
21-Aug,36047072800,3072800,6807,25128,31935,Brooklyn,2282665.41,Flatlands
19-May,36047073000,3073000,12712,68422,81134,Brooklyn,1991258.006,Flatlands
21-May,36047073000,3073000,246,40184,40430,Brooklyn,1991258.006,Flatlands
19-Jun,36047073000,3073000,11087,21435,32522,Brooklyn,1991258.006,Flatlands
21-Jun,36047073000,3073000,3576,84823,88399,Brooklyn,1991258.006,Flatlands
19-Jul,36047073000,3073000,4786,75452,80238,Brooklyn,1991258.006,Flatlands
21-Jul,36047073000,3073000,10048,54940,64988,Brooklyn,1991258.006,Flatlands
19-Aug,36047073000,3073000,10160,74607,84767,Brooklyn,1991258.006,Flatlands
21-Aug,36047073000,3073000,4587,47694,52281,Brooklyn,1991258.006,Flatlands
19-May,36047073200,3073200,10570,96877,107447,Brooklyn,1722429.165,Flatlands
21-May,36047073200,3073200,6111,79663,85774,Brooklyn,1722429.165,Flatlands
19-Jun,36047073200,3073200,8280,28750,37030,Brooklyn,1722429.165,Flatlands
21-Jun,36047073200,3073200,13194,20701,33895,Brooklyn,1722429.165,Flatlands
19-Jul,36047073200,3073200,4258,25863,30121,Brooklyn,1722429.165,Flatlands
21-Jul,36047073200,3073200,9945,14294,24239,Brooklyn,1722429.165,Flatlands
19-Aug,36047073200,3073200,8737,97750,106487,Brooklyn,1722429.165,Flatlands
21-Aug,36047073200,3073200,11683,114155,125838,Brooklyn,1722429.165,Flatlands
19-May,36047073400,3073400,18189,12679,30868,Brooklyn,1626697.964,Flatlands
21-May,36047073400,3073400,9912,54846,64758,Brooklyn,1626697.964,Flatlands
19-Jun,36047073400,3073400,16896,30788,47684,Brooklyn,1626697.964,Flatlands
21-Jun,36047073400,3073400,5873,97254,103127,Brooklyn,1626697.964,Flatlands
19-Jul,36047073400,3073400,7744,37777,45521,Brooklyn,1626697.964,Flatlands
21-Jul,36047073400,3073400,2760,91889,94649,Brooklyn,1626697.964,Flatlands
19-Aug,36047073400,3073400,13001,88435,101436,Brooklyn,1626697.964,Flatlands
21-Aug,36047073400,3073400,5093,63890,68983,Brooklyn,1626697.964,Flatlands
19-May,36047073600,3073600,756,87917,88673,Brooklyn,1915690.5,Flatlands
21-May,36047073600,3073600,1528,30345,31873,Brooklyn,1915690.5,Flatlands
19-Jun,36047073600,3073600,1506,71,1577,Brooklyn,1915690.5,Flatlands
21-Jun,36047073600,3073600,6113,119755,125868,Brooklyn,1915690.5,Flatlands
19-Jul,36047073600,3073600,9072,160785,169857,Brooklyn,1915690.5,Flatlands
21-Jul,36047073600,3073600,6612,62444,69056,Brooklyn,1915690.5,Flatlands
19-Aug,36047073600,3073600,8147,112994,121141,Brooklyn,1915690.5,Flatlands
21-Aug,36047073600,3073600,11703,48263,59966,Brooklyn,1915690.5,Flatlands
19-May,36047073800,3073800,10289,63441,73730,Brooklyn,1941782.305,Flatlands
21-May,36047073800,3073800,4926,110500,115426,Brooklyn,1941782.305,Flatlands
19-Jun,36047073800,3073800,16545,115007,131552,Brooklyn,1941782.305,Flatlands
21-Jun,36047073800,3073800,6920,67916,74836,Brooklyn,1941782.305,Flatlands
19-Jul,36047073800,3073800,2402,64399,66801,Brooklyn,1941782.305,Flatlands
21-Jul,36047073800,3073800,1483,13665,15148,Brooklyn,1941782.305,Flatlands
19-Aug,36047073800,3073800,3440,60872,64312,Brooklyn,1941782.305,Flatlands
21-Aug,36047073800,3073800,2379,70087,72466,Brooklyn,1941782.305,Flatlands
19-May,36047074000,3074000,10410,65995,76405,Brooklyn,1747894.42,Flatlands
21-May,36047074000,3074000,11712,98782,110494,Brooklyn,1747894.42,Flatlands
19-Jun,36047074000,3074000,670,82222,82892,Brooklyn,1747894.42,Flatlands
21-Jun,36047074000,3074000,10681,61455,72136,Brooklyn,1747894.42,Flatlands
19-Jul,36047074000,3074000,8353,53090,61443,Brooklyn,1747894.42,Flatlands
21-Jul,36047074000,3074000,15746,83990,99736,Brooklyn,1747894.42,Flatlands
19-Aug,36047074000,3074000,6632,77995,84627,Brooklyn,1747894.42,Flatlands
21-Aug,36047074000,3074000,8772,104488,113260,Brooklyn,1747894.42,Flatlands
19-May,36047074200,3074200,3767,50159,53926,Brooklyn,1876115.696,Flatlands
21-May,36047074200,3074200,8350,42887,51237,Brooklyn,1876115.696,Flatlands
19-Jun,36047074200,3074200,7448,57865,65313,Brooklyn,1876115.696,Flatlands
21-Jun,36047074200,3074200,12672,113557,126229,Brooklyn,1876115.696,Flatlands
19-Jul,36047074200,3074200,9607,54497,64104,Brooklyn,1876115.696,Flatlands
21-Jul,36047074200,3074200,7724,79457,87181,Brooklyn,1876115.696,Flatlands
19-Aug,36047074200,3074200,10011,124620,134631,Brooklyn,1876115.696,Flatlands
21-Aug,36047074200,3074200,11475,93708,105183,Brooklyn,1876115.696,Flatlands
19-May,36047074400,3074400,5182,43474,48656,Brooklyn,1836193.762,Flatlands
21-May,36047074400,3074400,4512,33443,37955,Brooklyn,1836193.762,Flatlands
19-Jun,36047074400,3074400,13289,76261,89550,Brooklyn,1836193.762,Flatlands
21-Jun,36047074400,3074400,12203,62028,74231,Brooklyn,1836193.762,Flatlands
19-Jul,36047074400,3074400,8069,79440,87509,Brooklyn,1836193.762,Flatlands
21-Jul,36047074400,3074400,3310,105513,108823,Brooklyn,1836193.762,Flatlands
19-Aug,36047074400,3074400,7249,40191,47440,Brooklyn,1836193.762,Flatlands
21-Aug,36047074400,3074400,4697,77266,81963,Brooklyn,1836193.762,Flatlands
19-May,36047074600,3074600,8416,103011,111427,Brooklyn,2171151.291,Flatlands
21-May,36047074600,3074600,3192,78763,81955,Brooklyn,2171151.291,Flatlands
19-Jun,36047074600,3074600,514,22897,23411,Brooklyn,2171151.291,Flatlands
21-Jun,36047074600,3074600,5848,115760,121608,Brooklyn,2171151.291,Flatlands
19-Jul,36047074600,3074600,8335,73631,81966,Brooklyn,2171151.291,Flatlands
21-Jul,36047074600,3074600,10858,119497,130355,Brooklyn,2171151.291,Flatlands
19-Aug,36047074600,3074600,7985,133706,141691,Brooklyn,2171151.291,Flatlands
21-Aug,36047074600,3074600,12844,108869,121713,Brooklyn,2171151.291,Flatlands
19-May,36047074800,3074800,16267,74911,91178,Brooklyn,1900352.045,Midwood
21-May,36047074800,3074800,14481,24476,38957,Brooklyn,1900352.045,Midwood
19-Jun,36047074800,3074800,19535,98297,117832,Brooklyn,1900352.045,Midwood
21-Jun,36047074800,3074800,3860,60180,64040,Brooklyn,1900352.045,Midwood
19-Jul,36047074800,3074800,9559,91255,100814,Brooklyn,1900352.045,Midwood
21-Jul,36047074800,3074800,4204,81374,85578,Brooklyn,1900352.045,Midwood
19-Aug,36047074800,3074800,4502,63761,68263,Brooklyn,1900352.045,Midwood
21-Aug,36047074800,3074800,7145,19788,26933,Brooklyn,1900352.045,Midwood
19-May,36047075000,3075000,14087,61366,75453,Brooklyn,1866699.221,Midwood
21-May,36047075000,3075000,10691,31988,42679,Brooklyn,1866699.221,Midwood
19-Jun,36047075000,3075000,7149,69464,76613,Brooklyn,1866699.221,Midwood
21-Jun,36047075000,3075000,14744,169385,184129,Brooklyn,1866699.221,Midwood
19-Jul,36047075000,3075000,7057,131919,138976,Brooklyn,1866699.221,Midwood
21-Jul,36047075000,3075000,6785,22669,29454,Brooklyn,1866699.221,Midwood
19-Aug,36047075000,3075000,13279,55827,69106,Brooklyn,1866699.221,Midwood
21-Aug,36047075000,3075000,4432,71,4503,Brooklyn,1866699.221,Midwood
19-May,36047075200,3075200,8743,34907,43650,Brooklyn,1864085.142,Midwood
21-May,36047075200,3075200,6562,87634,94196,Brooklyn,1864085.142,Midwood
19-Jun,36047075200,3075200,4922,28991,33913,Brooklyn,1864085.142,Midwood
21-Jun,36047075200,3075200,11579,142297,153876,Brooklyn,1864085.142,Midwood
19-Jul,36047075200,3075200,5640,62176,67816,Brooklyn,1864085.142,Midwood
21-Jul,36047075200,3075200,8592,71,8663,Brooklyn,1864085.142,Midwood
19-Aug,36047075200,3075200,6994,72162,79156,Brooklyn,1864085.142,Midwood
21-Aug,36047075200,3075200,7547,104850,112397,Brooklyn,1864085.142,Midwood
19-May,36047075400,3075400,5219,44564,49783,Brooklyn,1867167.879,Midwood
21-May,36047075400,3075400,10890,68271,79161,Brooklyn,1867167.879,Midwood
19-Jun,36047075400,3075400,0,97382,97382,Brooklyn,1867167.879,Midwood
21-Jun,36047075400,3075400,12998,49472,62470,Brooklyn,1867167.879,Midwood
19-Jul,36047075400,3075400,5394,43956,49350,Brooklyn,1867167.879,Midwood
21-Jul,36047075400,3075400,10058,39097,49155,Brooklyn,1867167.879,Midwood
19-Aug,36047075400,3075400,7908,110988,118896,Brooklyn,1867167.879,Midwood
21-Aug,36047075400,3075400,0,130743,130743,Brooklyn,1867167.879,Midwood
19-May,36047075600,3075600,6582,29536,36118,Brooklyn,1867819.329,Midwood
21-May,36047075600,3075600,7986,84780,92766,Brooklyn,1867819.329,Midwood
19-Jun,36047075600,3075600,8314,135389,143703,Brooklyn,1867819.329,Midwood
21-Jun,36047075600,3075600,18367,109043,127410,Brooklyn,1867819.329,Midwood
19-Jul,36047075600,3075600,6274,26989,33263,Brooklyn,1867819.329,Midwood
21-Jul,36047075600,3075600,2869,62775,65644,Brooklyn,1867819.329,Midwood
19-Aug,36047075600,3075600,8092,40063,48155,Brooklyn,1867819.329,Midwood
21-Aug,36047075600,3075600,8885,36204,45089,Brooklyn,1867819.329,Midwood
19-May,36047075800,3075800,12366,109308,121674,Brooklyn,2209765.795,Midwood
21-May,36047075800,3075800,13037,125401,138438,Brooklyn,2209765.795,Midwood
19-Jun,36047075800,3075800,1351,93437,94788,Brooklyn,2209765.795,Midwood
21-Jun,36047075800,3075800,7949,115087,123036,Brooklyn,2209765.795,Midwood
19-Jul,36047075800,3075800,6182,106118,112300,Brooklyn,2209765.795,Midwood
21-Jul,36047075800,3075800,10132,130037,140169,Brooklyn,2209765.795,Midwood
19-Aug,36047075800,3075800,8073,140272,148345,Brooklyn,2209765.795,Midwood
21-Aug,36047075800,3075800,9622,63235,72857,Brooklyn,2209765.795,Midwood
19-May,36047076000,3076000,30,85258,85288,Brooklyn,1954536.456,Midwood
21-May,36047076000,3076000,3453,31894,35347,Brooklyn,1954536.456,Midwood
19-Jun,36047076000,3076000,17307,95983,113290,Brooklyn,1954536.456,Midwood
21-Jun,36047076000,3076000,3124,94675,97799,Brooklyn,1954536.456,Midwood
19-Jul,36047076000,3076000,10909,130992,141901,Brooklyn,1954536.456,Midwood
21-Jul,36047076000,3076000,7527,26524,34051,Brooklyn,1954536.456,Midwood
19-Aug,36047076000,3076000,4830,52125,56955,Brooklyn,1954536.456,Midwood
21-Aug,36047076000,3076000,20115,103815,123930,Brooklyn,1954536.456,Midwood
19-May,36047076200,3076200,11041,81501,92542,Brooklyn,2024074.578,Midwood
21-May,36047076200,3076200,335,74193,74528,Brooklyn,2024074.578,Midwood
19-Jun,36047076200,3076200,10979,26681,37660,Brooklyn,2024074.578,Midwood
21-Jun,36047076200,3076200,3811,28506,32317,Brooklyn,2024074.578,Midwood
19-Jul,36047076200,3076200,13417,128865,142282,Brooklyn,2024074.578,Midwood
21-Jul,36047076200,3076200,12012,97206,109218,Brooklyn,2024074.578,Midwood
19-Aug,36047076200,3076200,10570,95479,106049,Brooklyn,2024074.578,Midwood
21-Aug,36047076200,3076200,12272,92568,104840,Brooklyn,2024074.578,Midwood
19-May,36047076400,3076400,2725,71142,73867,Brooklyn,1740194.716,Flatbush (West)-Ditmas Park-Parkville
21-May,36047076400,3076400,16951,95385,112336,Brooklyn,1740194.716,Flatbush (West)-Ditmas Park-Parkville
19-Jun,36047076400,3076400,9731,86503,96234,Brooklyn,1740194.716,Flatbush (West)-Ditmas Park-Parkville
21-Jun,36047076400,3076400,8872,71478,80350,Brooklyn,1740194.716,Flatbush (West)-Ditmas Park-Parkville
19-Jul,36047076400,3076400,15630,71,15701,Brooklyn,1740194.716,Flatbush (West)-Ditmas Park-Parkville
21-Jul,36047076400,3076400,16335,74457,90792,Brooklyn,1740194.716,Flatbush (West)-Ditmas Park-Parkville
19-Aug,36047076400,3076400,5559,46161,51720,Brooklyn,1740194.716,Flatbush (West)-Ditmas Park-Parkville
21-Aug,36047076400,3076400,9907,48595,58502,Brooklyn,1740194.716,Flatbush (West)-Ditmas Park-Parkville
19-May,36047076600,3076600,7710,133041,140751,Brooklyn,887313.7948,Flatbush
21-May,36047076600,3076600,10133,133940,144073,Brooklyn,887313.7948,Flatbush
19-Jun,36047076600,3076600,11735,51096,62831,Brooklyn,887313.7948,Flatbush
21-Jun,36047076600,3076600,3881,92599,96480,Brooklyn,887313.7948,Flatbush
19-Jul,36047076600,3076600,14480,71389,85869,Brooklyn,887313.7948,Flatbush
21-Jul,36047076600,3076600,4683,98426,103109,Brooklyn,887313.7948,Flatbush
19-Aug,36047076600,3076600,4189,105638,109827,Brooklyn,887313.7948,Flatbush
21-Aug,36047076600,3076600,6235,94124,100359,Brooklyn,887313.7948,Flatbush
19-May,36047076800,3076800,7843,86513,94356,Brooklyn,3265655.403,Midwood
21-May,36047076800,3076800,0,92751,92751,Brooklyn,3265655.403,Midwood
19-Jun,36047076800,3076800,8850,16747,25597,Brooklyn,3265655.403,Midwood
21-Jun,36047076800,3076800,0,70387,70387,Brooklyn,3265655.403,Midwood
19-Jul,36047076800,3076800,4077,68284,72361,Brooklyn,3265655.403,Midwood
21-Jul,36047076800,3076800,6107,70092,76199,Brooklyn,3265655.403,Midwood
19-Aug,36047076800,3076800,13843,71300,85143,Brooklyn,3265655.403,Midwood
21-Aug,36047076800,3076800,7341,71184,78525,Brooklyn,3265655.403,Midwood
19-May,36047077000,3077000,10280,48628,58908,Brooklyn,1760973.021,Flatbush
21-May,36047077000,3077000,0,110354,110354,Brooklyn,1760973.021,Flatbush
19-Jun,36047077000,3077000,8550,124365,132915,Brooklyn,1760973.021,Flatbush
21-Jun,36047077000,3077000,4836,99821,104657,Brooklyn,1760973.021,Flatbush
19-Jul,36047077000,3077000,7552,47370,54922,Brooklyn,1760973.021,Flatbush
21-Jul,36047077000,3077000,9591,56298,65889,Brooklyn,1760973.021,Flatbush
19-Aug,36047077000,3077000,6804,91619,98423,Brooklyn,1760973.021,Flatbush
21-Aug,36047077000,3077000,7307,29627,36934,Brooklyn,1760973.021,Flatbush
19-May,36047077200,3077200,6524,60220,66744,Brooklyn,4351946.221,Flatbush
21-May,36047077200,3077200,0,40119,40119,Brooklyn,4351946.221,Flatbush
19-Jun,36047077200,3077200,17144,63937,81081,Brooklyn,4351946.221,Flatbush
21-Jun,36047077200,3077200,15352,55004,70356,Brooklyn,4351946.221,Flatbush
19-Jul,36047077200,3077200,14630,40458,55088,Brooklyn,4351946.221,Flatbush
21-Jul,36047077200,3077200,12405,135834,148239,Brooklyn,4351946.221,Flatbush
19-Aug,36047077200,3077200,6395,46560,52955,Brooklyn,4351946.221,Flatbush
21-Aug,36047077200,3077200,18518,89094,107612,Brooklyn,4351946.221,Flatbush
19-May,36047077400,3077400,7009,70498,77507,Brooklyn,1596845.402,Flatbush
21-May,36047077400,3077400,10807,29188,39995,Brooklyn,1596845.402,Flatbush
19-Jun,36047077400,3077400,10795,88426,99221,Brooklyn,1596845.402,Flatbush
21-Jun,36047077400,3077400,6505,88692,95197,Brooklyn,1596845.402,Flatbush
19-Jul,36047077400,3077400,6039,75262,81301,Brooklyn,1596845.402,Flatbush
21-Jul,36047077400,3077400,17201,44823,62024,Brooklyn,1596845.402,Flatbush
19-Aug,36047077400,3077400,4293,76260,80553,Brooklyn,1596845.402,Flatbush
21-Aug,36047077400,3077400,2498,48720,51218,Brooklyn,1596845.402,Flatbush
19-May,36047077600,3077600,6378,66447,72825,Brooklyn,2008023.15,Flatlands
21-May,36047077600,3077600,22527,94624,117151,Brooklyn,2008023.15,Flatlands
19-Jun,36047077600,3077600,1400,62779,64179,Brooklyn,2008023.15,Flatlands
21-Jun,36047077600,3077600,3570,63637,67207,Brooklyn,2008023.15,Flatlands
19-Jul,36047077600,3077600,3211,62943,66154,Brooklyn,2008023.15,Flatlands
21-Jul,36047077600,3077600,1689,100409,102098,Brooklyn,2008023.15,Flatlands
19-Aug,36047077600,3077600,11655,138794,150449,Brooklyn,2008023.15,Flatlands
21-Aug,36047077600,3077600,10595,108920,119515,Brooklyn,2008023.15,Flatlands
19-May,36047078000,3078000,9525,34858,44383,Brooklyn,1770932.968,East Flatbush-Farragut
21-May,36047078000,3078000,13972,30983,44955,Brooklyn,1770932.968,East Flatbush-Farragut
19-Jun,36047078000,3078000,16986,108655,125641,Brooklyn,1770932.968,East Flatbush-Farragut
21-Jun,36047078000,3078000,9075,70380,79455,Brooklyn,1770932.968,East Flatbush-Farragut
19-Jul,36047078000,3078000,3771,104667,108438,Brooklyn,1770932.968,East Flatbush-Farragut
21-Jul,36047078000,3078000,8684,70859,79543,Brooklyn,1770932.968,East Flatbush-Farragut
19-Aug,36047078000,3078000,1868,144958,146826,Brooklyn,1770932.968,East Flatbush-Farragut
21-Aug,36047078000,3078000,8167,43710,51877,Brooklyn,1770932.968,East Flatbush-Farragut
19-May,36047078200,3078200,7888,580,8468,Brooklyn,1811374.376,East Flatbush-Farragut
21-May,36047078200,3078200,0,23972,23972,Brooklyn,1811374.376,East Flatbush-Farragut
19-Jun,36047078200,3078200,4298,71,4369,Brooklyn,1811374.376,East Flatbush-Farragut
21-Jun,36047078200,3078200,9442,113689,123131,Brooklyn,1811374.376,East Flatbush-Farragut
19-Jul,36047078200,3078200,13064,120118,133182,Brooklyn,1811374.376,East Flatbush-Farragut
21-Jul,36047078200,3078200,551,67420,67971,Brooklyn,1811374.376,East Flatbush-Farragut
19-Aug,36047078200,3078200,6390,60047,66437,Brooklyn,1811374.376,East Flatbush-Farragut
21-Aug,36047078200,3078200,11002,83910,94912,Brooklyn,1811374.376,East Flatbush-Farragut
19-May,36047078400,3078400,7942,28505,36447,Brooklyn,1801875.887,East Flatbush-Farragut
21-May,36047078400,3078400,8206,76105,84311,Brooklyn,1801875.887,East Flatbush-Farragut
19-Jun,36047078400,3078400,9515,119412,128927,Brooklyn,1801875.887,East Flatbush-Farragut
21-Jun,36047078400,3078400,7874,110658,118532,Brooklyn,1801875.887,East Flatbush-Farragut
19-Jul,36047078400,3078400,12764,61677,74441,Brooklyn,1801875.887,East Flatbush-Farragut
21-Jul,36047078400,3078400,4833,71757,76590,Brooklyn,1801875.887,East Flatbush-Farragut
19-Aug,36047078400,3078400,12211,6853,19064,Brooklyn,1801875.887,East Flatbush-Farragut
21-Aug,36047078400,3078400,9718,15216,24934,Brooklyn,1801875.887,East Flatbush-Farragut
19-May,36047078601,3078601,11193,26019,37212,Brooklyn,930777.274,Flatbush
21-May,36047078601,3078601,19945,49373,69318,Brooklyn,930777.274,Flatbush
19-Jun,36047078601,3078601,6535,72889,79424,Brooklyn,930777.274,Flatbush
21-Jun,36047078601,3078601,16118,113732,129850,Brooklyn,930777.274,Flatbush
19-Jul,36047078601,3078601,9177,68438,77615,Brooklyn,930777.274,Flatbush
21-Jul,36047078601,3078601,7352,59720,67072,Brooklyn,930777.274,Flatbush
19-Aug,36047078601,3078601,4534,32987,37521,Brooklyn,930777.274,Flatbush
21-Aug,36047078601,3078601,3574,38018,41592,Brooklyn,930777.274,Flatbush
19-May,36047078602,3078602,705,37435,38140,Brooklyn,903520.4853,East Flatbush-Farragut
21-May,36047078602,3078602,6095,124228,130323,Brooklyn,903520.4853,East Flatbush-Farragut
19-Jun,36047078602,3078602,6964,41554,48518,Brooklyn,903520.4853,East Flatbush-Farragut
21-Jun,36047078602,3078602,8651,84002,92653,Brooklyn,903520.4853,East Flatbush-Farragut
19-Jul,36047078602,3078602,9252,91643,100895,Brooklyn,903520.4853,East Flatbush-Farragut
21-Jul,36047078602,3078602,9237,121973,131210,Brooklyn,903520.4853,East Flatbush-Farragut
19-Aug,36047078602,3078602,1391,55315,56706,Brooklyn,903520.4853,East Flatbush-Farragut
21-Aug,36047078602,3078602,7708,123122,130830,Brooklyn,903520.4853,East Flatbush-Farragut
19-May,36047078801,3078801,4576,19620,24196,Brooklyn,1000835.176,Flatbush
21-May,36047078801,3078801,12840,46800,59640,Brooklyn,1000835.176,Flatbush
19-Jun,36047078801,3078801,7378,75721,83099,Brooklyn,1000835.176,Flatbush
21-Jun,36047078801,3078801,11585,83192,94777,Brooklyn,1000835.176,Flatbush
19-Jul,36047078801,3078801,2662,85000,87662,Brooklyn,1000835.176,Flatbush
21-Jul,36047078801,3078801,9314,21364,30678,Brooklyn,1000835.176,Flatbush
19-Aug,36047078801,3078801,14990,96629,111619,Brooklyn,1000835.176,Flatbush
21-Aug,36047078801,3078801,8157,74918,83075,Brooklyn,1000835.176,Flatbush
19-May,36047078802,3078802,6523,96826,103349,Brooklyn,688601.5534,East Flatbush-Farragut
21-May,36047078802,3078802,11194,112050,123244,Brooklyn,688601.5534,East Flatbush-Farragut
19-Jun,36047078802,3078802,5002,71,5073,Brooklyn,688601.5534,East Flatbush-Farragut
21-Jun,36047078802,3078802,6295,82219,88514,Brooklyn,688601.5534,East Flatbush-Farragut
19-Jul,36047078802,3078802,12847,116479,129326,Brooklyn,688601.5534,East Flatbush-Farragut
21-Jul,36047078802,3078802,6429,58871,65300,Brooklyn,688601.5534,East Flatbush-Farragut
19-Aug,36047078802,3078802,17464,36668,54132,Brooklyn,688601.5534,East Flatbush-Farragut
21-Aug,36047078802,3078802,13699,60216,73915,Brooklyn,688601.5534,East Flatbush-Farragut
19-May,36047079001,3079001,15718,88870,104588,Brooklyn,651088.477,Flatbush
21-May,36047079001,3079001,8222,25978,34200,Brooklyn,651088.477,Flatbush
19-Jun,36047079001,3079001,700,32088,32788,Brooklyn,651088.477,Flatbush
21-Jun,36047079001,3079001,8694,83686,92380,Brooklyn,651088.477,Flatbush
19-Jul,36047079001,3079001,6362,114996,121358,Brooklyn,651088.477,Flatbush
21-Jul,36047079001,3079001,11848,72053,83901,Brooklyn,651088.477,Flatbush
19-Aug,36047079001,3079001,18121,2759,20880,Brooklyn,651088.477,Flatbush
21-Aug,36047079001,3079001,6067,103130,109197,Brooklyn,651088.477,Flatbush
19-May,36047079002,3079002,5602,89185,94787,Brooklyn,1318503.265,East Flatbush-Erasmus
21-May,36047079002,3079002,5124,50432,55556,Brooklyn,1318503.265,East Flatbush-Erasmus
19-Jun,36047079002,3079002,3852,84290,88142,Brooklyn,1318503.265,East Flatbush-Erasmus
21-Jun,36047079002,3079002,16106,8533,24639,Brooklyn,1318503.265,East Flatbush-Erasmus
19-Jul,36047079002,3079002,15580,84883,100463,Brooklyn,1318503.265,East Flatbush-Erasmus
21-Jul,36047079002,3079002,0,87594,87594,Brooklyn,1318503.265,East Flatbush-Erasmus
19-Aug,36047079002,3079002,1614,98779,100393,Brooklyn,1318503.265,East Flatbush-Erasmus
21-Aug,36047079002,3079002,14045,71,14116,Brooklyn,1318503.265,East Flatbush-Erasmus
19-May,36047079201,3079201,8977,79912,88889,Brooklyn,1170145.873,Flatbush
21-May,36047079201,3079201,10670,110510,121180,Brooklyn,1170145.873,Flatbush
19-Jun,36047079201,3079201,1686,66534,68220,Brooklyn,1170145.873,Flatbush
21-Jun,36047079201,3079201,2817,27866,30683,Brooklyn,1170145.873,Flatbush
19-Jul,36047079201,3079201,1209,120269,121478,Brooklyn,1170145.873,Flatbush
21-Jul,36047079201,3079201,14341,161637,175978,Brooklyn,1170145.873,Flatbush
19-Aug,36047079201,3079201,17035,99765,116800,Brooklyn,1170145.873,Flatbush
21-Aug,36047079201,3079201,2907,21366,24273,Brooklyn,1170145.873,Flatbush
19-May,36047079202,3079202,8723,117197,125920,Brooklyn,1162117.945,East Flatbush-Erasmus
21-May,36047079202,3079202,5262,2275,7537,Brooklyn,1162117.945,East Flatbush-Erasmus
19-Jun,36047079202,3079202,2713,136768,139481,Brooklyn,1162117.945,East Flatbush-Erasmus
21-Jun,36047079202,3079202,6553,54094,60647,Brooklyn,1162117.945,East Flatbush-Erasmus
19-Jul,36047079202,3079202,11256,73920,85176,Brooklyn,1162117.945,East Flatbush-Erasmus
21-Jul,36047079202,3079202,3329,21445,24774,Brooklyn,1162117.945,East Flatbush-Erasmus
19-Aug,36047079202,3079202,7336,92668,100004,Brooklyn,1162117.945,East Flatbush-Erasmus
21-Aug,36047079202,3079202,3881,106859,110740,Brooklyn,1162117.945,East Flatbush-Erasmus
19-May,36047079400,3079400,5506,44914,50420,Brooklyn,2391961.763,East Flatbush-Erasmus
21-May,36047079400,3079400,11579,113687,125266,Brooklyn,2391961.763,East Flatbush-Erasmus
19-Jun,36047079400,3079400,1000,145520,146520,Brooklyn,2391961.763,East Flatbush-Erasmus
21-Jun,36047079400,3079400,5553,102251,107804,Brooklyn,2391961.763,East Flatbush-Erasmus
19-Jul,36047079400,3079400,6244,86832,93076,Brooklyn,2391961.763,East Flatbush-Erasmus
21-Jul,36047079400,3079400,14036,104832,118868,Brooklyn,2391961.763,East Flatbush-Erasmus
19-Aug,36047079400,3079400,10403,81385,91788,Brooklyn,2391961.763,East Flatbush-Erasmus
21-Aug,36047079400,3079400,9744,79963,89707,Brooklyn,2391961.763,East Flatbush-Erasmus
19-May,36047079601,3079601,8833,174959,183792,Brooklyn,1188358.591,Prospect Lefferts Gardens-Wingate
21-May,36047079601,3079601,3672,62835,66507,Brooklyn,1188358.591,Prospect Lefferts Gardens-Wingate
19-Jun,36047079601,3079601,4974,78746,83720,Brooklyn,1188358.591,Prospect Lefferts Gardens-Wingate
21-Jun,36047079601,3079601,10530,34527,45057,Brooklyn,1188358.591,Prospect Lefferts Gardens-Wingate
19-Jul,36047079601,3079601,8223,90305,98528,Brooklyn,1188358.591,Prospect Lefferts Gardens-Wingate
21-Jul,36047079601,3079601,7090,109600,116690,Brooklyn,1188358.591,Prospect Lefferts Gardens-Wingate
19-Aug,36047079601,3079601,1925,86979,88904,Brooklyn,1188358.591,Prospect Lefferts Gardens-Wingate
21-Aug,36047079601,3079601,17214,28108,45322,Brooklyn,1188358.591,Prospect Lefferts Gardens-Wingate
19-May,36047079602,3079602,1352,96408,97760,Brooklyn,1453524.691,Flatbush
21-May,36047079602,3079602,0,63558,63558,Brooklyn,1453524.691,Flatbush
19-Jun,36047079602,3079602,5842,101477,107319,Brooklyn,1453524.691,Flatbush
21-Jun,36047079602,3079602,3145,57427,60572,Brooklyn,1453524.691,Flatbush
19-Jul,36047079602,3079602,11810,83661,95471,Brooklyn,1453524.691,Flatbush
21-Jul,36047079602,3079602,12273,60327,72600,Brooklyn,1453524.691,Flatbush
19-Aug,36047079602,3079602,10632,64417,75049,Brooklyn,1453524.691,Flatbush
21-Aug,36047079602,3079602,8251,36863,45114,Brooklyn,1453524.691,Flatbush
19-May,36047079801,3079801,7100,83457,90557,Brooklyn,1397208.543,Prospect Lefferts Gardens-Wingate
21-May,36047079801,3079801,14273,73845,88118,Brooklyn,1397208.543,Prospect Lefferts Gardens-Wingate
19-Jun,36047079801,3079801,0,64759,64759,Brooklyn,1397208.543,Prospect Lefferts Gardens-Wingate
21-Jun,36047079801,3079801,8323,89334,97657,Brooklyn,1397208.543,Prospect Lefferts Gardens-Wingate
19-Jul,36047079801,3079801,13389,73190,86579,Brooklyn,1397208.543,Prospect Lefferts Gardens-Wingate
21-Jul,36047079801,3079801,4915,37014,41929,Brooklyn,1397208.543,Prospect Lefferts Gardens-Wingate
19-Aug,36047079801,3079801,7817,102851,110668,Brooklyn,1397208.543,Prospect Lefferts Gardens-Wingate
21-Aug,36047079801,3079801,10923,71,10994,Brooklyn,1397208.543,Prospect Lefferts Gardens-Wingate
19-May,36047080000,3080000,6883,90561,97444,Brooklyn,1869357.416,Prospect Lefferts Gardens-Wingate
21-May,36047080000,3080000,0,82725,82725,Brooklyn,1869357.416,Prospect Lefferts Gardens-Wingate
19-Jun,36047080000,3080000,10124,28527,38651,Brooklyn,1869357.416,Prospect Lefferts Gardens-Wingate
21-Jun,36047080000,3080000,5837,114884,120721,Brooklyn,1869357.416,Prospect Lefferts Gardens-Wingate
19-Jul,36047080000,3080000,10967,179143,190110,Brooklyn,1869357.416,Prospect Lefferts Gardens-Wingate
21-Jul,36047080000,3080000,17063,62877,79940,Brooklyn,1869357.416,Prospect Lefferts Gardens-Wingate
19-Aug,36047080000,3080000,6233,114622,120855,Brooklyn,1869357.416,Prospect Lefferts Gardens-Wingate
21-Aug,36047080000,3080000,9123,85134,94257,Brooklyn,1869357.416,Prospect Lefferts Gardens-Wingate
19-May,36047080200,3080200,10497,23072,33569,Brooklyn,1994115.473,Prospect Lefferts Gardens-Wingate
21-May,36047080200,3080200,3780,102613,106393,Brooklyn,1994115.473,Prospect Lefferts Gardens-Wingate
19-Jun,36047080200,3080200,7730,71,7801,Brooklyn,1994115.473,Prospect Lefferts Gardens-Wingate
21-Jun,36047080200,3080200,5705,37138,42843,Brooklyn,1994115.473,Prospect Lefferts Gardens-Wingate
19-Jul,36047080200,3080200,12117,107065,119182,Brooklyn,1994115.473,Prospect Lefferts Gardens-Wingate
21-Jul,36047080200,3080200,9988,99158,109146,Brooklyn,1994115.473,Prospect Lefferts Gardens-Wingate
19-Aug,36047080200,3080200,16820,142694,159514,Brooklyn,1994115.473,Prospect Lefferts Gardens-Wingate
21-Aug,36047080200,3080200,6194,68615,74809,Brooklyn,1994115.473,Prospect Lefferts Gardens-Wingate
19-May,36047080400,3080400,10452,36320,46772,Brooklyn,2042543.179,Prospect Lefferts Gardens-Wingate
21-May,36047080400,3080400,16278,72123,88401,Brooklyn,2042543.179,Prospect Lefferts Gardens-Wingate
19-Jun,36047080400,3080400,1987,71,2058,Brooklyn,2042543.179,Prospect Lefferts Gardens-Wingate
21-Jun,36047080400,3080400,12348,77430,89778,Brooklyn,2042543.179,Prospect Lefferts Gardens-Wingate
19-Jul,36047080400,3080400,16852,46946,63798,Brooklyn,2042543.179,Prospect Lefferts Gardens-Wingate
21-Jul,36047080400,3080400,15495,59186,74681,Brooklyn,2042543.179,Prospect Lefferts Gardens-Wingate
19-Aug,36047080400,3080400,8675,90169,98844,Brooklyn,2042543.179,Prospect Lefferts Gardens-Wingate
21-Aug,36047080400,3080400,6100,78316,84416,Brooklyn,2042543.179,Prospect Lefferts Gardens-Wingate
19-May,36047080600,3080600,20850,79076,99926,Brooklyn,1790169.552,Prospect Lefferts Gardens-Wingate
21-May,36047080600,3080600,15525,101124,116649,Brooklyn,1790169.552,Prospect Lefferts Gardens-Wingate
19-Jun,36047080600,3080600,12979,62857,75836,Brooklyn,1790169.552,Prospect Lefferts Gardens-Wingate
21-Jun,36047080600,3080600,5628,54369,59997,Brooklyn,1790169.552,Prospect Lefferts Gardens-Wingate
19-Jul,36047080600,3080600,12680,27253,39933,Brooklyn,1790169.552,Prospect Lefferts Gardens-Wingate
21-Jul,36047080600,3080600,10477,32576,43053,Brooklyn,1790169.552,Prospect Lefferts Gardens-Wingate
19-Aug,36047080600,3080600,5622,40430,46052,Brooklyn,1790169.552,Prospect Lefferts Gardens-Wingate
21-Aug,36047080600,3080600,4031,63575,67606,Brooklyn,1790169.552,Prospect Lefferts Gardens-Wingate
19-May,36047080800,3080800,10386,108693,119079,Brooklyn,3465286.508,Prospect Lefferts Gardens-Wingate
21-May,36047080800,3080800,10540,80655,91195,Brooklyn,3465286.508,Prospect Lefferts Gardens-Wingate
19-Jun,36047080800,3080800,7438,78692,86130,Brooklyn,3465286.508,Prospect Lefferts Gardens-Wingate
21-Jun,36047080800,3080800,9885,27379,37264,Brooklyn,3465286.508,Prospect Lefferts Gardens-Wingate
19-Jul,36047080800,3080800,16927,70270,87197,Brooklyn,3465286.508,Prospect Lefferts Gardens-Wingate
21-Jul,36047080800,3080800,7524,19474,26998,Brooklyn,3465286.508,Prospect Lefferts Gardens-Wingate
19-Aug,36047080800,3080800,8526,63305,71831,Brooklyn,3465286.508,Prospect Lefferts Gardens-Wingate
21-Aug,36047080800,3080800,4925,65669,70594,Brooklyn,3465286.508,Prospect Lefferts Gardens-Wingate
19-May,36047081000,3081000,18636,95817,114453,Brooklyn,1748271.962,Prospect Lefferts Gardens-Wingate
21-May,36047081000,3081000,12951,63858,76809,Brooklyn,1748271.962,Prospect Lefferts Gardens-Wingate
19-Jun,36047081000,3081000,18870,85081,103951,Brooklyn,1748271.962,Prospect Lefferts Gardens-Wingate
21-Jun,36047081000,3081000,9327,31627,40954,Brooklyn,1748271.962,Prospect Lefferts Gardens-Wingate
19-Jul,36047081000,3081000,5711,17357,23068,Brooklyn,1748271.962,Prospect Lefferts Gardens-Wingate
21-Jul,36047081000,3081000,4450,34684,39134,Brooklyn,1748271.962,Prospect Lefferts Gardens-Wingate
19-Aug,36047081000,3081000,3435,133044,136479,Brooklyn,1748271.962,Prospect Lefferts Gardens-Wingate
21-Aug,36047081000,3081000,10602,71,10673,Brooklyn,1748271.962,Prospect Lefferts Gardens-Wingate
19-May,36047081400,3081400,7773,3216,10989,Brooklyn,1831958.658,East Flatbush-Rugby
21-May,36047081400,3081400,4065,43707,47772,Brooklyn,1831958.658,East Flatbush-Rugby
19-Jun,36047081400,3081400,12794,53498,66292,Brooklyn,1831958.658,East Flatbush-Rugby
21-Jun,36047081400,3081400,5587,90188,95775,Brooklyn,1831958.658,East Flatbush-Rugby
19-Jul,36047081400,3081400,7075,145274,152349,Brooklyn,1831958.658,East Flatbush-Rugby
21-Jul,36047081400,3081400,8906,48353,57259,Brooklyn,1831958.658,East Flatbush-Rugby
19-Aug,36047081400,3081400,9770,40191,49961,Brooklyn,1831958.658,East Flatbush-Rugby
21-Aug,36047081400,3081400,8324,46369,54693,Brooklyn,1831958.658,East Flatbush-Rugby
19-May,36047081600,3081600,7447,104022,111469,Brooklyn,1933154.566,East Flatbush-Erasmus
21-May,36047081600,3081600,12287,43588,55875,Brooklyn,1933154.566,East Flatbush-Erasmus
19-Jun,36047081600,3081600,4267,112197,116464,Brooklyn,1933154.566,East Flatbush-Erasmus
21-Jun,36047081600,3081600,7801,101264,109065,Brooklyn,1933154.566,East Flatbush-Erasmus
19-Jul,36047081600,3081600,8131,69200,77331,Brooklyn,1933154.566,East Flatbush-Erasmus
21-Jul,36047081600,3081600,11780,40330,52110,Brooklyn,1933154.566,East Flatbush-Erasmus
19-Aug,36047081600,3081600,9604,72106,81710,Brooklyn,1933154.566,East Flatbush-Erasmus
21-Aug,36047081600,3081600,4218,126411,130629,Brooklyn,1933154.566,East Flatbush-Erasmus
19-May,36047081800,3081800,6272,75616,81888,Brooklyn,1699560.075,East Flatbush-Erasmus
21-May,36047081800,3081800,9758,46703,56461,Brooklyn,1699560.075,East Flatbush-Erasmus
19-Jun,36047081800,3081800,12102,42208,54310,Brooklyn,1699560.075,East Flatbush-Erasmus
21-Jun,36047081800,3081800,2631,129669,132300,Brooklyn,1699560.075,East Flatbush-Erasmus
19-Jul,36047081800,3081800,6693,75430,82123,Brooklyn,1699560.075,East Flatbush-Erasmus
21-Jul,36047081800,3081800,9179,92880,102059,Brooklyn,1699560.075,East Flatbush-Erasmus
19-Aug,36047081800,3081800,12955,135137,148092,Brooklyn,1699560.075,East Flatbush-Erasmus
21-Aug,36047081800,3081800,5136,44806,49942,Brooklyn,1699560.075,East Flatbush-Erasmus
19-May,36047082000,3082000,10490,89944,100434,Brooklyn,1599913.462,East Flatbush-Erasmus
21-May,36047082000,3082000,0,41379,41379,Brooklyn,1599913.462,East Flatbush-Erasmus
19-Jun,36047082000,3082000,18057,60764,78821,Brooklyn,1599913.462,East Flatbush-Erasmus
21-Jun,36047082000,3082000,12318,75986,88304,Brooklyn,1599913.462,East Flatbush-Erasmus
19-Jul,36047082000,3082000,3228,67015,70243,Brooklyn,1599913.462,East Flatbush-Erasmus
21-Jul,36047082000,3082000,14293,96672,110965,Brooklyn,1599913.462,East Flatbush-Erasmus
19-Aug,36047082000,3082000,4749,117893,122642,Brooklyn,1599913.462,East Flatbush-Erasmus
21-Aug,36047082000,3082000,10199,117133,127332,Brooklyn,1599913.462,East Flatbush-Erasmus
19-May,36047082200,3082200,17838,23374,41212,Brooklyn,1827422.907,East Flatbush-Erasmus
21-May,36047082200,3082200,5969,95768,101737,Brooklyn,1827422.907,East Flatbush-Erasmus
19-Jun,36047082200,3082200,10826,114288,125114,Brooklyn,1827422.907,East Flatbush-Erasmus
21-Jun,36047082200,3082200,7817,71,7888,Brooklyn,1827422.907,East Flatbush-Erasmus
19-Jul,36047082200,3082200,0,108158,108158,Brooklyn,1827422.907,East Flatbush-Erasmus
21-Jul,36047082200,3082200,13183,65933,79116,Brooklyn,1827422.907,East Flatbush-Erasmus
19-Aug,36047082200,3082200,8586,75503,84089,Brooklyn,1827422.907,East Flatbush-Erasmus
21-Aug,36047082200,3082200,15558,23011,38569,Brooklyn,1827422.907,East Flatbush-Erasmus
19-May,36047082400,3082400,8099,67357,75456,Brooklyn,2307258.58,East Flatbush-Erasmus
21-May,36047082400,3082400,868,18647,19515,Brooklyn,2307258.58,East Flatbush-Erasmus
19-Jun,36047082400,3082400,6899,79444,86343,Brooklyn,2307258.58,East Flatbush-Erasmus
21-Jun,36047082400,3082400,7258,92979,100237,Brooklyn,2307258.58,East Flatbush-Erasmus
19-Jul,36047082400,3082400,6977,93723,100700,Brooklyn,2307258.58,East Flatbush-Erasmus
21-Jul,36047082400,3082400,10485,93553,104038,Brooklyn,2307258.58,East Flatbush-Erasmus
19-Aug,36047082400,3082400,20894,155613,176507,Brooklyn,2307258.58,East Flatbush-Erasmus
21-Aug,36047082400,3082400,4390,97268,101658,Brooklyn,2307258.58,East Flatbush-Erasmus
19-May,36047082600,3082600,10423,10038,20461,Brooklyn,2142838.856,East Flatbush-Erasmus
21-May,36047082600,3082600,0,79518,79518,Brooklyn,2142838.856,East Flatbush-Erasmus
19-Jun,36047082600,3082600,0,69536,69536,Brooklyn,2142838.856,East Flatbush-Erasmus
21-Jun,36047082600,3082600,8326,103924,112250,Brooklyn,2142838.856,East Flatbush-Erasmus
19-Jul,36047082600,3082600,16373,17682,34055,Brooklyn,2142838.856,East Flatbush-Erasmus
21-Jul,36047082600,3082600,3693,132557,136250,Brooklyn,2142838.856,East Flatbush-Erasmus
19-Aug,36047082600,3082600,8052,51026,59078,Brooklyn,2142838.856,East Flatbush-Erasmus
21-Aug,36047082600,3082600,0,18132,18132,Brooklyn,2142838.856,East Flatbush-Erasmus
19-May,36047082800,3082800,1626,150162,151788,Brooklyn,1687712.476,East Flatbush-Erasmus
21-May,36047082800,3082800,4100,54335,58435,Brooklyn,1687712.476,East Flatbush-Erasmus
19-Jun,36047082800,3082800,6052,87365,93417,Brooklyn,1687712.476,East Flatbush-Erasmus
21-Jun,36047082800,3082800,3491,61766,65257,Brooklyn,1687712.476,East Flatbush-Erasmus
19-Jul,36047082800,3082800,8838,14637,23475,Brooklyn,1687712.476,East Flatbush-Erasmus
21-Jul,36047082800,3082800,7576,111747,119323,Brooklyn,1687712.476,East Flatbush-Erasmus
19-Aug,36047082800,3082800,3760,86680,90440,Brooklyn,1687712.476,East Flatbush-Erasmus
21-Aug,36047082800,3082800,5740,107110,112850,Brooklyn,1687712.476,East Flatbush-Erasmus
19-May,36047083000,3083000,5929,70629,76558,Brooklyn,2171914.953,East Flatbush-Farragut
21-May,36047083000,3083000,6431,58362,64793,Brooklyn,2171914.953,East Flatbush-Farragut
19-Jun,36047083000,3083000,7501,59638,67139,Brooklyn,2171914.953,East Flatbush-Farragut
21-Jun,36047083000,3083000,11687,81665,93352,Brooklyn,2171914.953,East Flatbush-Farragut
19-Jul,36047083000,3083000,3775,26756,30531,Brooklyn,2171914.953,East Flatbush-Farragut
21-Jul,36047083000,3083000,10737,70267,81004,Brooklyn,2171914.953,East Flatbush-Farragut
19-Aug,36047083000,3083000,4761,169220,173981,Brooklyn,2171914.953,East Flatbush-Farragut
21-Aug,36047083000,3083000,3340,64275,67615,Brooklyn,2171914.953,East Flatbush-Farragut
19-May,36047083200,3083200,7747,107575,115322,Brooklyn,1566888.491,East Flatbush-Farragut
21-May,36047083200,3083200,13083,61391,74474,Brooklyn,1566888.491,East Flatbush-Farragut
19-Jun,36047083200,3083200,8282,55243,63525,Brooklyn,1566888.491,East Flatbush-Farragut
21-Jun,36047083200,3083200,10182,94142,104324,Brooklyn,1566888.491,East Flatbush-Farragut
19-Jul,36047083200,3083200,1570,89645,91215,Brooklyn,1566888.491,East Flatbush-Farragut
21-Jul,36047083200,3083200,10277,109135,119412,Brooklyn,1566888.491,East Flatbush-Farragut
19-Aug,36047083200,3083200,4269,61485,65754,Brooklyn,1566888.491,East Flatbush-Farragut
21-Aug,36047083200,3083200,5562,30462,36024,Brooklyn,1566888.491,East Flatbush-Farragut
19-May,36047083400,3083400,11407,72919,84326,Brooklyn,1355748.334,East Flatbush-Farragut
21-May,36047083400,3083400,8703,20967,29670,Brooklyn,1355748.334,East Flatbush-Farragut
19-Jun,36047083400,3083400,12881,98431,111312,Brooklyn,1355748.334,East Flatbush-Farragut
21-Jun,36047083400,3083400,12573,46216,58789,Brooklyn,1355748.334,East Flatbush-Farragut
19-Jul,36047083400,3083400,0,37332,37332,Brooklyn,1355748.334,East Flatbush-Farragut
21-Jul,36047083400,3083400,8090,105863,113953,Brooklyn,1355748.334,East Flatbush-Farragut
19-Aug,36047083400,3083400,17437,93297,110734,Brooklyn,1355748.334,East Flatbush-Farragut
21-Aug,36047083400,3083400,3561,58467,62028,Brooklyn,1355748.334,East Flatbush-Farragut
19-May,36047083600,3083600,15671,66202,81873,Brooklyn,2240975.579,East Flatbush-Farragut
21-May,36047083600,3083600,12653,67863,80516,Brooklyn,2240975.579,East Flatbush-Farragut
19-Jun,36047083600,3083600,13032,18004,31036,Brooklyn,2240975.579,East Flatbush-Farragut
21-Jun,36047083600,3083600,4315,84405,88720,Brooklyn,2240975.579,East Flatbush-Farragut
19-Jul,36047083600,3083600,11209,82758,93967,Brooklyn,2240975.579,East Flatbush-Farragut
21-Jul,36047083600,3083600,19841,13167,33008,Brooklyn,2240975.579,East Flatbush-Farragut
19-Aug,36047083600,3083600,3550,73207,76757,Brooklyn,2240975.579,East Flatbush-Farragut
21-Aug,36047083600,3083600,9917,16281,26198,Brooklyn,2240975.579,East Flatbush-Farragut
19-May,36047083800,3083800,2996,145314,148310,Brooklyn,1796855.844,East Flatbush-Farragut
21-May,36047083800,3083800,1071,56924,57995,Brooklyn,1796855.844,East Flatbush-Farragut
19-Jun,36047083800,3083800,3942,114389,118331,Brooklyn,1796855.844,East Flatbush-Farragut
21-Jun,36047083800,3083800,16674,83934,100608,Brooklyn,1796855.844,East Flatbush-Farragut
19-Jul,36047083800,3083800,5614,46593,52207,Brooklyn,1796855.844,East Flatbush-Farragut
21-Jul,36047083800,3083800,15005,48274,63279,Brooklyn,1796855.844,East Flatbush-Farragut
19-Aug,36047083800,3083800,6845,140724,147569,Brooklyn,1796855.844,East Flatbush-Farragut
21-Aug,36047083800,3083800,10265,102511,112776,Brooklyn,1796855.844,East Flatbush-Farragut
19-May,36047084000,3084000,5188,147777,152965,Brooklyn,1830663.253,East Flatbush-Farragut
21-May,36047084000,3084000,12381,122375,134756,Brooklyn,1830663.253,East Flatbush-Farragut
19-Jun,36047084000,3084000,10023,76857,86880,Brooklyn,1830663.253,East Flatbush-Farragut
21-Jun,36047084000,3084000,9484,109547,119031,Brooklyn,1830663.253,East Flatbush-Farragut
19-Jul,36047084000,3084000,1693,71604,73297,Brooklyn,1830663.253,East Flatbush-Farragut
21-Jul,36047084000,3084000,15869,85902,101771,Brooklyn,1830663.253,East Flatbush-Farragut
19-Aug,36047084000,3084000,608,62784,63392,Brooklyn,1830663.253,East Flatbush-Farragut
21-Aug,36047084000,3084000,14390,87647,102037,Brooklyn,1830663.253,East Flatbush-Farragut
19-May,36047084600,3084600,4864,20317,25181,Brooklyn,1778307.479,East Flatbush-Farragut
21-May,36047084600,3084600,8903,53332,62235,Brooklyn,1778307.479,East Flatbush-Farragut
19-Jun,36047084600,3084600,16163,71,16234,Brooklyn,1778307.479,East Flatbush-Farragut
21-Jun,36047084600,3084600,13929,58209,72138,Brooklyn,1778307.479,East Flatbush-Farragut
19-Jul,36047084600,3084600,0,63856,63856,Brooklyn,1778307.479,East Flatbush-Farragut
21-Jul,36047084600,3084600,8011,77346,85357,Brooklyn,1778307.479,East Flatbush-Farragut
19-Aug,36047084600,3084600,7873,127980,135853,Brooklyn,1778307.479,East Flatbush-Farragut
21-Aug,36047084600,3084600,5937,88074,94011,Brooklyn,1778307.479,East Flatbush-Farragut
19-May,36047084800,3084800,13707,46884,60591,Brooklyn,1479845.491,East Flatbush-Rugby
21-May,36047084800,3084800,6974,56964,63938,Brooklyn,1479845.491,East Flatbush-Rugby
19-Jun,36047084800,3084800,0,35919,35919,Brooklyn,1479845.491,East Flatbush-Rugby
21-Jun,36047084800,3084800,8099,34627,42726,Brooklyn,1479845.491,East Flatbush-Rugby
19-Jul,36047084800,3084800,1227,54074,55301,Brooklyn,1479845.491,East Flatbush-Rugby
21-Jul,36047084800,3084800,12198,16702,28900,Brooklyn,1479845.491,East Flatbush-Rugby
19-Aug,36047084800,3084800,11804,82131,93935,Brooklyn,1479845.491,East Flatbush-Rugby
21-Aug,36047084800,3084800,10428,71,10499,Brooklyn,1479845.491,East Flatbush-Rugby
19-May,36047085000,3085000,11122,88933,100055,Brooklyn,1556707.682,East Flatbush-Rugby
21-May,36047085000,3085000,8769,117281,126050,Brooklyn,1556707.682,East Flatbush-Rugby
19-Jun,36047085000,3085000,245,103826,104071,Brooklyn,1556707.682,East Flatbush-Rugby
21-Jun,36047085000,3085000,3827,60967,64794,Brooklyn,1556707.682,East Flatbush-Rugby
19-Jul,36047085000,3085000,344,48327,48671,Brooklyn,1556707.682,East Flatbush-Rugby
21-Jul,36047085000,3085000,5287,114267,119554,Brooklyn,1556707.682,East Flatbush-Rugby
19-Aug,36047085000,3085000,2369,32341,34710,Brooklyn,1556707.682,East Flatbush-Rugby
21-Aug,36047085000,3085000,18742,140394,159136,Brooklyn,1556707.682,East Flatbush-Rugby
19-May,36047085200,3085200,13491,77891,91382,Brooklyn,4276575.309,Holy Cross Cemetery
21-May,36047085200,3085200,6858,69597,76455,Brooklyn,4276575.309,Holy Cross Cemetery
19-Jun,36047085200,3085200,3265,54015,57280,Brooklyn,4276575.309,Holy Cross Cemetery
21-Jun,36047085200,3085200,771,157179,157950,Brooklyn,4276575.309,Holy Cross Cemetery
19-Jul,36047085200,3085200,9671,101996,111667,Brooklyn,4276575.309,Holy Cross Cemetery
21-Jul,36047085200,3085200,7383,140427,147810,Brooklyn,4276575.309,Holy Cross Cemetery
19-Aug,36047085200,3085200,12791,64401,77192,Brooklyn,4276575.309,Holy Cross Cemetery
21-Aug,36047085200,3085200,5287,153234,158521,Brooklyn,4276575.309,Holy Cross Cemetery
19-May,36047085400,3085400,14190,55069,69259,Brooklyn,1385790.118,East Flatbush-Farragut
21-May,36047085400,3085400,137,89916,90053,Brooklyn,1385790.118,East Flatbush-Farragut
19-Jun,36047085400,3085400,9688,104343,114031,Brooklyn,1385790.118,East Flatbush-Farragut
21-Jun,36047085400,3085400,0,72874,72874,Brooklyn,1385790.118,East Flatbush-Farragut
19-Jul,36047085400,3085400,11738,91095,102833,Brooklyn,1385790.118,East Flatbush-Farragut
21-Jul,36047085400,3085400,15533,145319,160852,Brooklyn,1385790.118,East Flatbush-Farragut
19-Aug,36047085400,3085400,3593,61937,65530,Brooklyn,1385790.118,East Flatbush-Farragut
21-Aug,36047085400,3085400,15142,81317,96459,Brooklyn,1385790.118,East Flatbush-Farragut
19-May,36047085600,3085600,6988,52232,59220,Brooklyn,1700511.635,East Flatbush-Erasmus
21-May,36047085600,3085600,2635,66268,68903,Brooklyn,1700511.635,East Flatbush-Erasmus
19-Jun,36047085600,3085600,7307,13898,21205,Brooklyn,1700511.635,East Flatbush-Erasmus
21-Jun,36047085600,3085600,10769,108559,119328,Brooklyn,1700511.635,East Flatbush-Erasmus
19-Jul,36047085600,3085600,13183,27151,40334,Brooklyn,1700511.635,East Flatbush-Erasmus
21-Jul,36047085600,3085600,0,53865,53865,Brooklyn,1700511.635,East Flatbush-Erasmus
19-Aug,36047085600,3085600,4170,52909,57079,Brooklyn,1700511.635,East Flatbush-Erasmus
21-Aug,36047085600,3085600,4777,97304,102081,Brooklyn,1700511.635,East Flatbush-Erasmus
19-May,36047085800,3085800,5182,89826,95008,Brooklyn,1488957.956,East Flatbush-Rugby
21-May,36047085800,3085800,12564,29961,42525,Brooklyn,1488957.956,East Flatbush-Rugby
19-Jun,36047085800,3085800,1781,38228,40009,Brooklyn,1488957.956,East Flatbush-Rugby
21-Jun,36047085800,3085800,6875,43337,50212,Brooklyn,1488957.956,East Flatbush-Rugby
19-Jul,36047085800,3085800,3512,30006,33518,Brooklyn,1488957.956,East Flatbush-Rugby
21-Jul,36047085800,3085800,9526,85598,95124,Brooklyn,1488957.956,East Flatbush-Rugby
19-Aug,36047085800,3085800,14791,40662,55453,Brooklyn,1488957.956,East Flatbush-Rugby
21-Aug,36047085800,3085800,9798,152315,162113,Brooklyn,1488957.956,East Flatbush-Rugby
19-May,36047086000,3086000,8222,88598,96820,Brooklyn,1879565.355,East Flatbush-Rugby
21-May,36047086000,3086000,15930,162382,178312,Brooklyn,1879565.355,East Flatbush-Rugby
19-Jun,36047086000,3086000,3244,53200,56444,Brooklyn,1879565.355,East Flatbush-Rugby
21-Jun,36047086000,3086000,11886,27602,39488,Brooklyn,1879565.355,East Flatbush-Rugby
19-Jul,36047086000,3086000,14486,66998,81484,Brooklyn,1879565.355,East Flatbush-Rugby
21-Jul,36047086000,3086000,7427,55967,63394,Brooklyn,1879565.355,East Flatbush-Rugby
19-Aug,36047086000,3086000,6246,61883,68129,Brooklyn,1879565.355,East Flatbush-Rugby
21-Aug,36047086000,3086000,2796,8376,11172,Brooklyn,1879565.355,East Flatbush-Rugby
19-May,36047086200,3086200,7793,40218,48011,Brooklyn,1508724.472,East Flatbush-Rugby
21-May,36047086200,3086200,0,85749,85749,Brooklyn,1508724.472,East Flatbush-Rugby
19-Jun,36047086200,3086200,17016,69094,86110,Brooklyn,1508724.472,East Flatbush-Rugby
21-Jun,36047086200,3086200,5917,94792,100709,Brooklyn,1508724.472,East Flatbush-Rugby
19-Jul,36047086200,3086200,4836,54934,59770,Brooklyn,1508724.472,East Flatbush-Rugby
21-Jul,36047086200,3086200,8571,71,8642,Brooklyn,1508724.472,East Flatbush-Rugby
19-Aug,36047086200,3086200,10450,76975,87425,Brooklyn,1508724.472,East Flatbush-Rugby
21-Aug,36047086200,3086200,2231,12248,14479,Brooklyn,1508724.472,East Flatbush-Rugby
19-May,36047086600,3086600,13704,107697,121401,Brooklyn,1684237.052,East Flatbush-Rugby
21-May,36047086600,3086600,2231,122849,125080,Brooklyn,1684237.052,East Flatbush-Rugby
19-Jun,36047086600,3086600,1130,66114,67244,Brooklyn,1684237.052,East Flatbush-Rugby
21-Jun,36047086600,3086600,16746,115893,132639,Brooklyn,1684237.052,East Flatbush-Rugby
19-Jul,36047086600,3086600,16019,71,16090,Brooklyn,1684237.052,East Flatbush-Rugby
21-Jul,36047086600,3086600,6993,108241,115234,Brooklyn,1684237.052,East Flatbush-Rugby
19-Aug,36047086600,3086600,4356,77423,81779,Brooklyn,1684237.052,East Flatbush-Rugby
21-Aug,36047086600,3086600,5712,84147,89859,Brooklyn,1684237.052,East Flatbush-Rugby
19-May,36047086800,3086800,24728,23970,48698,Brooklyn,1879388.152,East Flatbush-Rugby
21-May,36047086800,3086800,14996,102703,117699,Brooklyn,1879388.152,East Flatbush-Rugby
19-Jun,36047086800,3086800,11402,91241,102643,Brooklyn,1879388.152,East Flatbush-Rugby
21-Jun,36047086800,3086800,9199,118844,128043,Brooklyn,1879388.152,East Flatbush-Rugby
19-Jul,36047086800,3086800,2790,61497,64287,Brooklyn,1879388.152,East Flatbush-Rugby
21-Jul,36047086800,3086800,13931,45409,59340,Brooklyn,1879388.152,East Flatbush-Rugby
19-Aug,36047086800,3086800,11286,65730,77016,Brooklyn,1879388.152,East Flatbush-Rugby
21-Aug,36047086800,3086800,8225,127310,135535,Brooklyn,1879388.152,East Flatbush-Rugby
19-May,36047087000,3087000,11896,74890,86786,Brooklyn,1676352.351,East Flatbush-Rugby
21-May,36047087000,3087000,4136,94501,98637,Brooklyn,1676352.351,East Flatbush-Rugby
19-Jun,36047087000,3087000,6777,59676,66453,Brooklyn,1676352.351,East Flatbush-Rugby
21-Jun,36047087000,3087000,7341,80004,87345,Brooklyn,1676352.351,East Flatbush-Rugby
19-Jul,36047087000,3087000,7682,32086,39768,Brooklyn,1676352.351,East Flatbush-Rugby
21-Jul,36047087000,3087000,15090,90067,105157,Brooklyn,1676352.351,East Flatbush-Rugby
19-Aug,36047087000,3087000,10233,106054,116287,Brooklyn,1676352.351,East Flatbush-Rugby
21-Aug,36047087000,3087000,12937,51179,64116,Brooklyn,1676352.351,East Flatbush-Rugby
19-May,36047087200,3087200,10124,125405,135529,Brooklyn,1583318.148,East Flatbush-Rugby
21-May,36047087200,3087200,11218,35262,46480,Brooklyn,1583318.148,East Flatbush-Rugby
19-Jun,36047087200,3087200,3433,98243,101676,Brooklyn,1583318.148,East Flatbush-Rugby
21-Jun,36047087200,3087200,0,103652,103652,Brooklyn,1583318.148,East Flatbush-Rugby
19-Jul,36047087200,3087200,12072,117643,129715,Brooklyn,1583318.148,East Flatbush-Rugby
21-Jul,36047087200,3087200,8374,71161,79535,Brooklyn,1583318.148,East Flatbush-Rugby
19-Aug,36047087200,3087200,4085,133840,137925,Brooklyn,1583318.148,East Flatbush-Rugby
21-Aug,36047087200,3087200,7855,121495,129350,Brooklyn,1583318.148,East Flatbush-Rugby
19-May,36047087401,3087401,6764,144199,150963,Brooklyn,1405622.883,Prospect Lefferts Gardens-Wingate
21-May,36047087401,3087401,6652,113165,119817,Brooklyn,1405622.883,Prospect Lefferts Gardens-Wingate
19-Jun,36047087401,3087401,8412,44977,53389,Brooklyn,1405622.883,Prospect Lefferts Gardens-Wingate
21-Jun,36047087401,3087401,0,99701,99701,Brooklyn,1405622.883,Prospect Lefferts Gardens-Wingate
19-Jul,36047087401,3087401,0,35381,35381,Brooklyn,1405622.883,Prospect Lefferts Gardens-Wingate
21-Jul,36047087401,3087401,4551,28533,33084,Brooklyn,1405622.883,Prospect Lefferts Gardens-Wingate
19-Aug,36047087401,3087401,8177,47829,56006,Brooklyn,1405622.883,Prospect Lefferts Gardens-Wingate
21-Aug,36047087401,3087401,9802,120282,130084,Brooklyn,1405622.883,Prospect Lefferts Gardens-Wingate
19-May,36047087600,3087600,11724,69888,81612,Brooklyn,1530933.262,Prospect Lefferts Gardens-Wingate
21-May,36047087600,3087600,13767,94821,108588,Brooklyn,1530933.262,Prospect Lefferts Gardens-Wingate
19-Jun,36047087600,3087600,10605,67387,77992,Brooklyn,1530933.262,Prospect Lefferts Gardens-Wingate
21-Jun,36047087600,3087600,9156,117036,126192,Brooklyn,1530933.262,Prospect Lefferts Gardens-Wingate
19-Jul,36047087600,3087600,11753,101185,112938,Brooklyn,1530933.262,Prospect Lefferts Gardens-Wingate
21-Jul,36047087600,3087600,13166,81940,95106,Brooklyn,1530933.262,Prospect Lefferts Gardens-Wingate
19-Aug,36047087600,3087600,7848,54215,62063,Brooklyn,1530933.262,Prospect Lefferts Gardens-Wingate
21-Aug,36047087600,3087600,9143,60210,69353,Brooklyn,1530933.262,Prospect Lefferts Gardens-Wingate
19-May,36047087800,3087800,5998,140521,146519,Brooklyn,1629553.124,East Flatbush-Rugby
21-May,36047087800,3087800,11084,81269,92353,Brooklyn,1629553.124,East Flatbush-Rugby
19-Jun,36047087800,3087800,11475,136673,148148,Brooklyn,1629553.124,East Flatbush-Rugby
21-Jun,36047087800,3087800,5003,4079,9082,Brooklyn,1629553.124,East Flatbush-Rugby
19-Jul,36047087800,3087800,2091,34271,36362,Brooklyn,1629553.124,East Flatbush-Rugby
21-Jul,36047087800,3087800,8934,62289,71223,Brooklyn,1629553.124,East Flatbush-Rugby
19-Aug,36047087800,3087800,5397,60105,65502,Brooklyn,1629553.124,East Flatbush-Rugby
21-Aug,36047087800,3087800,6962,56233,63195,Brooklyn,1629553.124,East Flatbush-Rugby
19-May,36047088001,3088001,2764,73376,76140,Brooklyn,874304.8133,Prospect Lefferts Gardens-Wingate
21-May,36047088001,3088001,1064,51248,52312,Brooklyn,874304.8133,Prospect Lefferts Gardens-Wingate
19-Jun,36047088001,3088001,6492,57413,63905,Brooklyn,874304.8133,Prospect Lefferts Gardens-Wingate
21-Jun,36047088001,3088001,8984,94040,103024,Brooklyn,874304.8133,Prospect Lefferts Gardens-Wingate
19-Jul,36047088001,3088001,12904,3476,16380,Brooklyn,874304.8133,Prospect Lefferts Gardens-Wingate
21-Jul,36047088001,3088001,0,148568,148568,Brooklyn,874304.8133,Prospect Lefferts Gardens-Wingate
19-Aug,36047088001,3088001,156,180435,180591,Brooklyn,874304.8133,Prospect Lefferts Gardens-Wingate
21-Aug,36047088001,3088001,12216,37225,49441,Brooklyn,874304.8133,Prospect Lefferts Gardens-Wingate
19-May,36047088002,3088002,7357,82409,89766,Brooklyn,1088856.503,East Flatbush-Rugby
21-May,36047088002,3088002,10296,114512,124808,Brooklyn,1088856.503,East Flatbush-Rugby
19-Jun,36047088002,3088002,16395,139840,156235,Brooklyn,1088856.503,East Flatbush-Rugby
21-Jun,36047088002,3088002,17608,72134,89742,Brooklyn,1088856.503,East Flatbush-Rugby
19-Jul,36047088002,3088002,2936,101879,104815,Brooklyn,1088856.503,East Flatbush-Rugby
21-Jul,36047088002,3088002,13082,138269,151351,Brooklyn,1088856.503,East Flatbush-Rugby
19-Aug,36047088002,3088002,11116,116602,127718,Brooklyn,1088856.503,East Flatbush-Rugby
21-Aug,36047088002,3088002,12059,100656,112715,Brooklyn,1088856.503,East Flatbush-Rugby
19-May,36047088200,3088200,0,53251,53251,Brooklyn,2188028.204,East Flatbush-Remsen Village
21-May,36047088200,3088200,11932,32436,44368,Brooklyn,2188028.204,East Flatbush-Remsen Village
19-Jun,36047088200,3088200,11626,55197,66823,Brooklyn,2188028.204,East Flatbush-Remsen Village
21-Jun,36047088200,3088200,9675,114304,123979,Brooklyn,2188028.204,East Flatbush-Remsen Village
19-Jul,36047088200,3088200,10039,45658,55697,Brooklyn,2188028.204,East Flatbush-Remsen Village
21-Jul,36047088200,3088200,23861,51262,75123,Brooklyn,2188028.204,East Flatbush-Remsen Village
19-Aug,36047088200,3088200,16830,71732,88562,Brooklyn,2188028.204,East Flatbush-Remsen Village
21-Aug,36047088200,3088200,13253,33792,47045,Brooklyn,2188028.204,East Flatbush-Remsen Village
19-May,36047088400,3088400,3188,115315,118503,Brooklyn,1797772.887,East Flatbush-Remsen Village
21-May,36047088400,3088400,7115,99658,106773,Brooklyn,1797772.887,East Flatbush-Remsen Village
19-Jun,36047088400,3088400,9489,118346,127835,Brooklyn,1797772.887,East Flatbush-Remsen Village
21-Jun,36047088400,3088400,6628,109698,116326,Brooklyn,1797772.887,East Flatbush-Remsen Village
19-Jul,36047088400,3088400,9616,91628,101244,Brooklyn,1797772.887,East Flatbush-Remsen Village
21-Jul,36047088400,3088400,9063,49275,58338,Brooklyn,1797772.887,East Flatbush-Remsen Village
19-Aug,36047088400,3088400,7790,136767,144557,Brooklyn,1797772.887,East Flatbush-Remsen Village
21-Aug,36047088400,3088400,7491,90446,97937,Brooklyn,1797772.887,East Flatbush-Remsen Village
19-May,36047088800,3088800,5720,13934,19654,Brooklyn,2166355.63,East Flatbush-Remsen Village
21-May,36047088800,3088800,12919,105227,118146,Brooklyn,2166355.63,East Flatbush-Remsen Village
19-Jun,36047088800,3088800,10337,18652,28989,Brooklyn,2166355.63,East Flatbush-Remsen Village
21-Jun,36047088800,3088800,3732,80637,84369,Brooklyn,2166355.63,East Flatbush-Remsen Village
19-Jul,36047088800,3088800,14540,83259,97799,Brooklyn,2166355.63,East Flatbush-Remsen Village
21-Jul,36047088800,3088800,8206,120492,128698,Brooklyn,2166355.63,East Flatbush-Remsen Village
19-Aug,36047088800,3088800,1697,117092,118789,Brooklyn,2166355.63,East Flatbush-Remsen Village
21-Aug,36047088800,3088800,7963,100383,108346,Brooklyn,2166355.63,East Flatbush-Remsen Village
19-May,36047089000,3089000,16766,136789,153555,Brooklyn,2672111.438,East Flatbush-Remsen Village
21-May,36047089000,3089000,669,142836,143505,Brooklyn,2672111.438,East Flatbush-Remsen Village
19-Jun,36047089000,3089000,7599,52596,60195,Brooklyn,2672111.438,East Flatbush-Remsen Village
21-Jun,36047089000,3089000,5624,120509,126133,Brooklyn,2672111.438,East Flatbush-Remsen Village
19-Jul,36047089000,3089000,11942,68087,80029,Brooklyn,2672111.438,East Flatbush-Remsen Village
21-Jul,36047089000,3089000,4172,30559,34731,Brooklyn,2672111.438,East Flatbush-Remsen Village
19-Aug,36047089000,3089000,4175,47826,52001,Brooklyn,2672111.438,East Flatbush-Remsen Village
21-Aug,36047089000,3089000,12353,63977,76330,Brooklyn,2672111.438,East Flatbush-Remsen Village
19-May,36047089200,3089200,1575,56857,58432,Brooklyn,1932402.813,East Flatbush-Remsen Village
21-May,36047089200,3089200,9847,116928,126775,Brooklyn,1932402.813,East Flatbush-Remsen Village
19-Jun,36047089200,3089200,14638,80753,95391,Brooklyn,1932402.813,East Flatbush-Remsen Village
21-Jun,36047089200,3089200,14428,73419,87847,Brooklyn,1932402.813,East Flatbush-Remsen Village
19-Jul,36047089200,3089200,6340,71,6411,Brooklyn,1932402.813,East Flatbush-Remsen Village
21-Jul,36047089200,3089200,6911,98603,105514,Brooklyn,1932402.813,East Flatbush-Remsen Village
19-Aug,36047089200,3089200,8616,61931,70547,Brooklyn,1932402.813,East Flatbush-Remsen Village
21-Aug,36047089200,3089200,6546,21470,28016,Brooklyn,1932402.813,East Flatbush-Remsen Village
19-May,36047089400,3089400,5327,31074,36401,Brooklyn,1853454.074,Brownsville
21-May,36047089400,3089400,83,53856,53939,Brooklyn,1853454.074,Brownsville
19-Jun,36047089400,3089400,8347,65842,74189,Brooklyn,1853454.074,Brownsville
21-Jun,36047089400,3089400,6470,166342,172812,Brooklyn,1853454.074,Brownsville
19-Jul,36047089400,3089400,5826,76701,82527,Brooklyn,1853454.074,Brownsville
21-Jul,36047089400,3089400,3540,71,3611,Brooklyn,1853454.074,Brownsville
19-Aug,36047089400,3089400,5777,131400,137177,Brooklyn,1853454.074,Brownsville
21-Aug,36047089400,3089400,0,73911,73911,Brooklyn,1853454.074,Brownsville
19-May,36047089600,3089600,4375,108942,113317,Brooklyn,1605933.794,Brownsville
21-May,36047089600,3089600,5919,75933,81852,Brooklyn,1605933.794,Brownsville
19-Jun,36047089600,3089600,15503,53274,68777,Brooklyn,1605933.794,Brownsville
21-Jun,36047089600,3089600,9107,100057,109164,Brooklyn,1605933.794,Brownsville
19-Jul,36047089600,3089600,11230,101606,112836,Brooklyn,1605933.794,Brownsville
21-Jul,36047089600,3089600,6526,73977,80503,Brooklyn,1605933.794,Brownsville
19-Aug,36047089600,3089600,5831,1380,7211,Brooklyn,1605933.794,Brownsville
21-Aug,36047089600,3089600,11927,33950,45877,Brooklyn,1605933.794,Brownsville
19-May,36047089800,3089800,20409,65911,86320,Brooklyn,1661400.059,Brownsville
21-May,36047089800,3089800,2099,40481,42580,Brooklyn,1661400.059,Brownsville
19-Jun,36047089800,3089800,1737,80725,82462,Brooklyn,1661400.059,Brownsville
21-Jun,36047089800,3089800,2387,63083,65470,Brooklyn,1661400.059,Brownsville
19-Jul,36047089800,3089800,10558,141907,152465,Brooklyn,1661400.059,Brownsville
21-Jul,36047089800,3089800,5955,80046,86001,Brooklyn,1661400.059,Brownsville
19-Aug,36047089800,3089800,15768,71697,87465,Brooklyn,1661400.059,Brownsville
21-Aug,36047089800,3089800,7470,93606,101076,Brooklyn,1661400.059,Brownsville
19-May,36047090000,3090000,0,108639,108639,Brooklyn,2645361.117,Brownsville
21-May,36047090000,3090000,17065,35344,52409,Brooklyn,2645361.117,Brownsville
19-Jun,36047090000,3090000,12651,61177,73828,Brooklyn,2645361.117,Brownsville
21-Jun,36047090000,3090000,11525,64537,76062,Brooklyn,2645361.117,Brownsville
19-Jul,36047090000,3090000,10,73300,73310,Brooklyn,2645361.117,Brownsville
21-Jul,36047090000,3090000,9351,117807,127158,Brooklyn,2645361.117,Brownsville
19-Aug,36047090000,3090000,12561,61782,74343,Brooklyn,2645361.117,Brownsville
21-Aug,36047090000,3090000,13163,39665,52828,Brooklyn,2645361.117,Brownsville
19-May,36047090200,3090200,7620,112503,120123,Brooklyn,2051102.854,Brownsville
21-May,36047090200,3090200,12735,58281,71016,Brooklyn,2051102.854,Brownsville
19-Jun,36047090200,3090200,6327,71180,77507,Brooklyn,2051102.854,Brownsville
21-Jun,36047090200,3090200,18828,100896,119724,Brooklyn,2051102.854,Brownsville
19-Jul,36047090200,3090200,2941,70325,73266,Brooklyn,2051102.854,Brownsville
21-Jul,36047090200,3090200,3006,101507,104513,Brooklyn,2051102.854,Brownsville
19-Aug,36047090200,3090200,6757,113108,119865,Brooklyn,2051102.854,Brownsville
21-Aug,36047090200,3090200,17533,17362,34895,Brooklyn,2051102.854,Brownsville
19-May,36047090600,3090600,9794,126227,136021,Brooklyn,2107750.767,Brownsville
21-May,36047090600,3090600,754,110496,111250,Brooklyn,2107750.767,Brownsville
19-Jun,36047090600,3090600,5131,63252,68383,Brooklyn,2107750.767,Brownsville
21-Jun,36047090600,3090600,5029,71,5100,Brooklyn,2107750.767,Brownsville
19-Jul,36047090600,3090600,12512,52776,65288,Brooklyn,2107750.767,Brownsville
21-Jul,36047090600,3090600,0,28957,28957,Brooklyn,2107750.767,Brownsville
19-Aug,36047090600,3090600,9519,47958,57477,Brooklyn,2107750.767,Brownsville
21-Aug,36047090600,3090600,18449,111708,130157,Brooklyn,2107750.767,Brownsville
19-May,36047091000,3091000,7045,105108,112153,Brooklyn,2281443.73,Brownsville
21-May,36047091000,3091000,10666,90673,101339,Brooklyn,2281443.73,Brownsville
19-Jun,36047091000,3091000,11337,97069,108406,Brooklyn,2281443.73,Brownsville
21-Jun,36047091000,3091000,13226,115239,128465,Brooklyn,2281443.73,Brownsville
19-Jul,36047091000,3091000,2501,21410,23911,Brooklyn,2281443.73,Brownsville
21-Jul,36047091000,3091000,3758,69150,72908,Brooklyn,2281443.73,Brownsville
19-Aug,36047091000,3091000,10727,67022,77749,Brooklyn,2281443.73,Brownsville
21-Aug,36047091000,3091000,0,128088,128088,Brooklyn,2281443.73,Brownsville
19-May,36047091200,3091200,8793,70802,79595,Brooklyn,1800466.624,Brownsville
21-May,36047091200,3091200,9773,105319,115092,Brooklyn,1800466.624,Brownsville
19-Jun,36047091200,3091200,4267,101908,106175,Brooklyn,1800466.624,Brownsville
21-Jun,36047091200,3091200,15756,34694,50450,Brooklyn,1800466.624,Brownsville
19-Jul,36047091200,3091200,11072,60537,71609,Brooklyn,1800466.624,Brownsville
21-Jul,36047091200,3091200,13093,122953,136046,Brooklyn,1800466.624,Brownsville
19-Aug,36047091200,3091200,12484,75857,88341,Brooklyn,1800466.624,Brownsville
21-Aug,36047091200,3091200,8081,43065,51146,Brooklyn,1800466.624,Brownsville
19-May,36047091600,3091600,2979,94597,97576,Brooklyn,2321085.56,Brownsville
21-May,36047091600,3091600,14590,73845,88435,Brooklyn,2321085.56,Brownsville
19-Jun,36047091600,3091600,19089,71422,90511,Brooklyn,2321085.56,Brownsville
21-Jun,36047091600,3091600,2220,74050,76270,Brooklyn,2321085.56,Brownsville
19-Jul,36047091600,3091600,8743,71651,80394,Brooklyn,2321085.56,Brownsville
21-Jul,36047091600,3091600,3129,15094,18223,Brooklyn,2321085.56,Brownsville
19-Aug,36047091600,3091600,8802,63203,72005,Brooklyn,2321085.56,Brownsville
21-Aug,36047091600,3091600,4177,35610,39787,Brooklyn,2321085.56,Brownsville
19-May,36047091800,3091800,7991,32723,40714,Brooklyn,2256021.201,Brownsville
21-May,36047091800,3091800,4722,37947,42669,Brooklyn,2256021.201,Brownsville
19-Jun,36047091800,3091800,7413,115531,122944,Brooklyn,2256021.201,Brownsville
21-Jun,36047091800,3091800,15218,133746,148964,Brooklyn,2256021.201,Brownsville
19-Jul,36047091800,3091800,1550,155030,156580,Brooklyn,2256021.201,Brownsville
21-Jul,36047091800,3091800,12726,3879,16605,Brooklyn,2256021.201,Brownsville
19-Aug,36047091800,3091800,2706,26566,29272,Brooklyn,2256021.201,Brownsville
21-Aug,36047091800,3091800,7171,73098,80269,Brooklyn,2256021.201,Brownsville
19-May,36047092000,3092000,16386,106211,122597,Brooklyn,2554843.415,Brownsville
21-May,36047092000,3092000,21410,20574,41984,Brooklyn,2554843.415,Brownsville
19-Jun,36047092000,3092000,12538,152685,165223,Brooklyn,2554843.415,Brownsville
21-Jun,36047092000,3092000,20697,19735,40432,Brooklyn,2554843.415,Brownsville
19-Jul,36047092000,3092000,2151,66484,68635,Brooklyn,2554843.415,Brownsville
21-Jul,36047092000,3092000,15090,94257,109347,Brooklyn,2554843.415,Brownsville
19-Aug,36047092000,3092000,5042,77338,82380,Brooklyn,2554843.415,Brownsville
21-Aug,36047092000,3092000,7426,18900,26326,Brooklyn,2554843.415,Brownsville
19-May,36047092400,3092400,16676,18636,35312,Brooklyn,2709111.041,Brownsville
21-May,36047092400,3092400,3615,29862,33477,Brooklyn,2709111.041,Brownsville
19-Jun,36047092400,3092400,8342,11658,20000,Brooklyn,2709111.041,Brownsville
21-Jun,36047092400,3092400,6553,93485,100038,Brooklyn,2709111.041,Brownsville
19-Jul,36047092400,3092400,15930,64083,80013,Brooklyn,2709111.041,Brownsville
21-Jul,36047092400,3092400,10673,95204,105877,Brooklyn,2709111.041,Brownsville
19-Aug,36047092400,3092400,7586,135006,142592,Brooklyn,2709111.041,Brownsville
21-Aug,36047092400,3092400,5427,56666,62093,Brooklyn,2709111.041,Brownsville
19-May,36047093000,3093000,5162,73529,78691,Brooklyn,2090418.864,East Flatbush-Remsen Village
21-May,36047093000,3093000,0,77195,77195,Brooklyn,2090418.864,East Flatbush-Remsen Village
19-Jun,36047093000,3093000,13352,115334,128686,Brooklyn,2090418.864,East Flatbush-Remsen Village
21-Jun,36047093000,3093000,5843,32554,38397,Brooklyn,2090418.864,East Flatbush-Remsen Village
19-Jul,36047093000,3093000,3106,71,3177,Brooklyn,2090418.864,East Flatbush-Remsen Village
21-Jul,36047093000,3093000,15707,86315,102022,Brooklyn,2090418.864,East Flatbush-Remsen Village
19-Aug,36047093000,3093000,14626,39175,53801,Brooklyn,2090418.864,East Flatbush-Remsen Village
21-Aug,36047093000,3093000,10057,86090,96147,Brooklyn,2090418.864,East Flatbush-Remsen Village
19-May,36047093200,3093200,12383,45112,57495,Brooklyn,3018449.494,East Flatbush-Farragut
21-May,36047093200,3093200,3402,71,3473,Brooklyn,3018449.494,East Flatbush-Farragut
19-Jun,36047093200,3093200,10977,30882,41859,Brooklyn,3018449.494,East Flatbush-Farragut
21-Jun,36047093200,3093200,18358,55447,73805,Brooklyn,3018449.494,East Flatbush-Farragut
19-Jul,36047093200,3093200,7753,160461,168214,Brooklyn,3018449.494,East Flatbush-Farragut
21-Jul,36047093200,3093200,0,79552,79552,Brooklyn,3018449.494,East Flatbush-Farragut
19-Aug,36047093200,3093200,7611,60429,68040,Brooklyn,3018449.494,East Flatbush-Farragut
21-Aug,36047093200,3093200,2325,19838,22163,Brooklyn,3018449.494,East Flatbush-Farragut
19-May,36047093800,3093800,6410,54413,60823,Brooklyn,1411409.931,East Flatbush-Rugby
21-May,36047093800,3093800,7007,91048,98055,Brooklyn,1411409.931,East Flatbush-Rugby
19-Jun,36047093800,3093800,6611,27642,34253,Brooklyn,1411409.931,East Flatbush-Rugby
21-Jun,36047093800,3093800,1810,71,1881,Brooklyn,1411409.931,East Flatbush-Rugby
19-Jul,36047093800,3093800,12901,80009,92910,Brooklyn,1411409.931,East Flatbush-Rugby
21-Jul,36047093800,3093800,15984,23262,39246,Brooklyn,1411409.931,East Flatbush-Rugby
19-Aug,36047093800,3093800,9048,121248,130296,Brooklyn,1411409.931,East Flatbush-Rugby
21-Aug,36047093800,3093800,8475,91993,100468,Brooklyn,1411409.931,East Flatbush-Rugby
19-May,36047094401,3094401,6457,126525,132982,Brooklyn,3906963.059,Flatlands
21-May,36047094401,3094401,0,33632,33632,Brooklyn,3906963.059,Flatlands
19-Jun,36047094401,3094401,9286,57167,66453,Brooklyn,3906963.059,Flatlands
21-Jun,36047094401,3094401,6313,70522,76835,Brooklyn,3906963.059,Flatlands
19-Jul,36047094401,3094401,2777,69000,71777,Brooklyn,3906963.059,Flatlands
21-Jul,36047094401,3094401,3247,92869,96116,Brooklyn,3906963.059,Flatlands
19-Aug,36047094401,3094401,4601,91259,95860,Brooklyn,3906963.059,Flatlands
21-Aug,36047094401,3094401,11396,59312,70708,Brooklyn,3906963.059,Flatlands
19-May,36047094402,3094402,6600,134035,140635,Brooklyn,1150874.286,Flatlands
21-May,36047094402,3094402,11817,124273,136090,Brooklyn,1150874.286,Flatlands
19-Jun,36047094402,3094402,0,71,71,Brooklyn,1150874.286,Flatlands
21-Jun,36047094402,3094402,11389,28583,39972,Brooklyn,1150874.286,Flatlands
19-Jul,36047094402,3094402,4817,75605,80422,Brooklyn,1150874.286,Flatlands
21-Jul,36047094402,3094402,12981,84581,97562,Brooklyn,1150874.286,Flatlands
19-Aug,36047094402,3094402,9427,73624,83051,Brooklyn,1150874.286,Flatlands
21-Aug,36047094402,3094402,4301,43862,48163,Brooklyn,1150874.286,Flatlands
19-May,36047094600,3094600,4164,71,4235,Brooklyn,3110120.374,East Flatbush-Rugby
21-May,36047094600,3094600,6701,76372,83073,Brooklyn,3110120.374,East Flatbush-Rugby
19-Jun,36047094600,3094600,13343,92320,105663,Brooklyn,3110120.374,East Flatbush-Rugby
21-Jun,36047094600,3094600,10189,71,10260,Brooklyn,3110120.374,East Flatbush-Rugby
19-Jul,36047094600,3094600,11196,54163,65359,Brooklyn,3110120.374,East Flatbush-Rugby
21-Jul,36047094600,3094600,9032,97068,106100,Brooklyn,3110120.374,East Flatbush-Rugby
19-Aug,36047094600,3094600,12483,82905,95388,Brooklyn,3110120.374,East Flatbush-Rugby
21-Aug,36047094600,3094600,2592,34626,37218,Brooklyn,3110120.374,East Flatbush-Rugby
19-May,36047095000,3095000,13723,43085,56808,Brooklyn,2612150.906,Canarsie
21-May,36047095000,3095000,3872,86677,90549,Brooklyn,2612150.906,Canarsie
19-Jun,36047095000,3095000,11645,75577,87222,Brooklyn,2612150.906,Canarsie
21-Jun,36047095000,3095000,4827,64270,69097,Brooklyn,2612150.906,Canarsie
19-Jul,36047095000,3095000,13905,122386,136291,Brooklyn,2612150.906,Canarsie
21-Jul,36047095000,3095000,17083,64019,81102,Brooklyn,2612150.906,Canarsie
19-Aug,36047095000,3095000,17566,64982,82548,Brooklyn,2612150.906,Canarsie
21-Aug,36047095000,3095000,12318,119270,131588,Brooklyn,2612150.906,Canarsie
19-May,36047095600,3095600,5435,101876,107311,Brooklyn,2557814.049,Canarsie
21-May,36047095600,3095600,2843,65958,68801,Brooklyn,2557814.049,Canarsie
19-Jun,36047095600,3095600,4323,76037,80360,Brooklyn,2557814.049,Canarsie
21-Jun,36047095600,3095600,12045,29674,41719,Brooklyn,2557814.049,Canarsie
19-Jul,36047095600,3095600,13438,50566,64004,Brooklyn,2557814.049,Canarsie
21-Jul,36047095600,3095600,2183,49312,51495,Brooklyn,2557814.049,Canarsie
19-Aug,36047095600,3095600,9250,13747,22997,Brooklyn,2557814.049,Canarsie
21-Aug,36047095600,3095600,11768,24320,36088,Brooklyn,2557814.049,Canarsie
19-May,36047095800,3095800,6640,130644,137284,Brooklyn,2523362.206,Canarsie
21-May,36047095800,3095800,3434,42902,46336,Brooklyn,2523362.206,Canarsie
19-Jun,36047095800,3095800,14851,101277,116128,Brooklyn,2523362.206,Canarsie
21-Jun,36047095800,3095800,0,41484,41484,Brooklyn,2523362.206,Canarsie
19-Jul,36047095800,3095800,3053,96831,99884,Brooklyn,2523362.206,Canarsie
21-Jul,36047095800,3095800,0,49433,49433,Brooklyn,2523362.206,Canarsie
19-Aug,36047095800,3095800,0,169762,169762,Brooklyn,2523362.206,Canarsie
21-Aug,36047095800,3095800,15511,77072,92583,Brooklyn,2523362.206,Canarsie
19-May,36047096200,3096200,8965,84678,93643,Brooklyn,1920772.18,Canarsie
21-May,36047096200,3096200,6740,62100,68840,Brooklyn,1920772.18,Canarsie
19-Jun,36047096200,3096200,1481,54746,56227,Brooklyn,1920772.18,Canarsie
21-Jun,36047096200,3096200,10871,19225,30096,Brooklyn,1920772.18,Canarsie
19-Jul,36047096200,3096200,13101,82856,95957,Brooklyn,1920772.18,Canarsie
21-Jul,36047096200,3096200,3055,59698,62753,Brooklyn,1920772.18,Canarsie
19-Aug,36047096200,3096200,6087,92857,98944,Brooklyn,1920772.18,Canarsie
21-Aug,36047096200,3096200,0,47882,47882,Brooklyn,1920772.18,Canarsie
19-May,36047096400,3096400,10920,36456,47376,Brooklyn,1900792.389,Canarsie
21-May,36047096400,3096400,12800,49547,62347,Brooklyn,1900792.389,Canarsie
19-Jun,36047096400,3096400,6039,87773,93812,Brooklyn,1900792.389,Canarsie
21-Jun,36047096400,3096400,8829,12886,21715,Brooklyn,1900792.389,Canarsie
19-Jul,36047096400,3096400,9764,110461,120225,Brooklyn,1900792.389,Canarsie
21-Jul,36047096400,3096400,14044,100036,114080,Brooklyn,1900792.389,Canarsie
19-Aug,36047096400,3096400,12511,113076,125587,Brooklyn,1900792.389,Canarsie
21-Aug,36047096400,3096400,10838,36169,47007,Brooklyn,1900792.389,Canarsie
19-May,36047096600,3096600,7747,109702,117449,Brooklyn,1950813.588,Canarsie
21-May,36047096600,3096600,14738,74141,88879,Brooklyn,1950813.588,Canarsie
19-Jun,36047096600,3096600,14054,37263,51317,Brooklyn,1950813.588,Canarsie
21-Jun,36047096600,3096600,3818,112546,116364,Brooklyn,1950813.588,Canarsie
19-Jul,36047096600,3096600,0,107759,107759,Brooklyn,1950813.588,Canarsie
21-Jul,36047096600,3096600,7562,70729,78291,Brooklyn,1950813.588,Canarsie
19-Aug,36047096600,3096600,12173,59020,71193,Brooklyn,1950813.588,Canarsie
21-Aug,36047096600,3096600,10892,44933,55825,Brooklyn,1950813.588,Canarsie
19-May,36047096800,3096800,13810,61333,75143,Brooklyn,1603786.874,Canarsie
21-May,36047096800,3096800,11813,70661,82474,Brooklyn,1603786.874,Canarsie
19-Jun,36047096800,3096800,13453,7498,20951,Brooklyn,1603786.874,Canarsie
21-Jun,36047096800,3096800,13176,72525,85701,Brooklyn,1603786.874,Canarsie
19-Jul,36047096800,3096800,7839,82972,90811,Brooklyn,1603786.874,Canarsie
21-Jul,36047096800,3096800,10614,54389,65003,Brooklyn,1603786.874,Canarsie
19-Aug,36047096800,3096800,12934,96984,109918,Brooklyn,1603786.874,Canarsie
21-Aug,36047096800,3096800,10636,55775,66411,Brooklyn,1603786.874,Canarsie
19-May,36047097000,3097000,6561,83821,90382,Brooklyn,1759315.569,Canarsie
21-May,36047097000,3097000,12973,84119,97092,Brooklyn,1759315.569,Canarsie
19-Jun,36047097000,3097000,15775,29620,45395,Brooklyn,1759315.569,Canarsie
21-Jun,36047097000,3097000,5940,71,6011,Brooklyn,1759315.569,Canarsie
19-Jul,36047097000,3097000,2464,46619,49083,Brooklyn,1759315.569,Canarsie
21-Jul,36047097000,3097000,8823,68174,76997,Brooklyn,1759315.569,Canarsie
19-Aug,36047097000,3097000,12570,21718,34288,Brooklyn,1759315.569,Canarsie
21-Aug,36047097000,3097000,3555,47813,51368,Brooklyn,1759315.569,Canarsie
19-May,36047097400,3097400,8569,39433,48002,Brooklyn,2712076.613,Canarsie
21-May,36047097400,3097400,7006,55039,62045,Brooklyn,2712076.613,Canarsie
19-Jun,36047097400,3097400,1708,99748,101456,Brooklyn,2712076.613,Canarsie
21-Jun,36047097400,3097400,8218,110710,118928,Brooklyn,2712076.613,Canarsie
19-Jul,36047097400,3097400,8010,53034,61044,Brooklyn,2712076.613,Canarsie
21-Jul,36047097400,3097400,7786,57968,65754,Brooklyn,2712076.613,Canarsie
19-Aug,36047097400,3097400,14372,18557,32929,Brooklyn,2712076.613,Canarsie
21-Aug,36047097400,3097400,12753,69937,82690,Brooklyn,2712076.613,Canarsie
19-May,36047098200,3098200,1493,79854,81347,Brooklyn,3723765.596,Canarsie
21-May,36047098200,3098200,0,75584,75584,Brooklyn,3723765.596,Canarsie
19-Jun,36047098200,3098200,12863,82646,95509,Brooklyn,3723765.596,Canarsie
21-Jun,36047098200,3098200,6252,15537,21789,Brooklyn,3723765.596,Canarsie
19-Jul,36047098200,3098200,5674,125682,131356,Brooklyn,3723765.596,Canarsie
21-Jul,36047098200,3098200,12698,1768,14466,Brooklyn,3723765.596,Canarsie
19-Aug,36047098200,3098200,6473,71,6544,Brooklyn,3723765.596,Canarsie
21-Aug,36047098200,3098200,3954,48353,52307,Brooklyn,3723765.596,Canarsie
19-May,36047098400,3098400,7934,23033,30967,Brooklyn,1214786.596,Canarsie
21-May,36047098400,3098400,0,114742,114742,Brooklyn,1214786.596,Canarsie
19-Jun,36047098400,3098400,16036,143509,159545,Brooklyn,1214786.596,Canarsie
21-Jun,36047098400,3098400,4808,121618,126426,Brooklyn,1214786.596,Canarsie
19-Jul,36047098400,3098400,4555,57794,62349,Brooklyn,1214786.596,Canarsie
21-Jul,36047098400,3098400,3103,426,3529,Brooklyn,1214786.596,Canarsie
19-Aug,36047098400,3098400,13452,71803,85255,Brooklyn,1214786.596,Canarsie
21-Aug,36047098400,3098400,7612,132740,140352,Brooklyn,1214786.596,Canarsie
19-May,36047098600,3098600,3256,63761,67017,Brooklyn,1677791.731,Canarsie
21-May,36047098600,3098600,17850,66409,84259,Brooklyn,1677791.731,Canarsie
19-Jun,36047098600,3098600,14635,3193,17828,Brooklyn,1677791.731,Canarsie
21-Jun,36047098600,3098600,8727,122032,130759,Brooklyn,1677791.731,Canarsie
19-Jul,36047098600,3098600,12448,75337,87785,Brooklyn,1677791.731,Canarsie
21-Jul,36047098600,3098600,7603,95773,103376,Brooklyn,1677791.731,Canarsie
19-Aug,36047098600,3098600,5484,184907,190391,Brooklyn,1677791.731,Canarsie
21-Aug,36047098600,3098600,9482,106710,116192,Brooklyn,1677791.731,Canarsie
19-May,36047098800,3098800,11192,39586,50778,Brooklyn,1743233.075,Canarsie
21-May,36047098800,3098800,12637,16507,29144,Brooklyn,1743233.075,Canarsie
19-Jun,36047098800,3098800,5166,97532,102698,Brooklyn,1743233.075,Canarsie
21-Jun,36047098800,3098800,11803,84312,96115,Brooklyn,1743233.075,Canarsie
19-Jul,36047098800,3098800,5103,148696,153799,Brooklyn,1743233.075,Canarsie
21-Jul,36047098800,3098800,11414,102942,114356,Brooklyn,1743233.075,Canarsie
19-Aug,36047098800,3098800,7361,71,7432,Brooklyn,1743233.075,Canarsie
21-Aug,36047098800,3098800,9259,61242,70501,Brooklyn,1743233.075,Canarsie
19-May,36047099000,3099000,4584,71,4655,Brooklyn,1762100.755,Canarsie
21-May,36047099000,3099000,17723,132532,150255,Brooklyn,1762100.755,Canarsie
19-Jun,36047099000,3099000,0,30947,30947,Brooklyn,1762100.755,Canarsie
21-Jun,36047099000,3099000,10740,57725,68465,Brooklyn,1762100.755,Canarsie
19-Jul,36047099000,3099000,13513,35839,49352,Brooklyn,1762100.755,Canarsie
21-Jul,36047099000,3099000,13522,72773,86295,Brooklyn,1762100.755,Canarsie
19-Aug,36047099000,3099000,14059,137513,151572,Brooklyn,1762100.755,Canarsie
21-Aug,36047099000,3099000,7749,83368,91117,Brooklyn,1762100.755,Canarsie
19-May,36047099200,3099200,17100,137265,154365,Brooklyn,1448961.152,Canarsie
21-May,36047099200,3099200,12268,33848,46116,Brooklyn,1448961.152,Canarsie
19-Jun,36047099200,3099200,3852,125719,129571,Brooklyn,1448961.152,Canarsie
21-Jun,36047099200,3099200,10653,98778,109431,Brooklyn,1448961.152,Canarsie
19-Jul,36047099200,3099200,3574,80265,83839,Brooklyn,1448961.152,Canarsie
21-Jul,36047099200,3099200,5553,46890,52443,Brooklyn,1448961.152,Canarsie
19-Aug,36047099200,3099200,245,136628,136873,Brooklyn,1448961.152,Canarsie
21-Aug,36047099200,3099200,8792,56178,64970,Brooklyn,1448961.152,Canarsie
19-May,36047099400,3099400,2562,131358,133920,Brooklyn,1872516.842,Canarsie
21-May,36047099400,3099400,5706,72938,78644,Brooklyn,1872516.842,Canarsie
19-Jun,36047099400,3099400,0,30505,30505,Brooklyn,1872516.842,Canarsie
21-Jun,36047099400,3099400,5435,91236,96671,Brooklyn,1872516.842,Canarsie
19-Jul,36047099400,3099400,13223,68641,81864,Brooklyn,1872516.842,Canarsie
21-Jul,36047099400,3099400,6213,53400,59613,Brooklyn,1872516.842,Canarsie
19-Aug,36047099400,3099400,12007,39376,51383,Brooklyn,1872516.842,Canarsie
21-Aug,36047099400,3099400,8326,111688,120014,Brooklyn,1872516.842,Canarsie
19-May,36047100400,3100400,0,13525,13525,Brooklyn,1421504.282,Canarsie
21-May,36047100400,3100400,10319,113088,123407,Brooklyn,1421504.282,Canarsie
19-Jun,36047100400,3100400,8208,74103,82311,Brooklyn,1421504.282,Canarsie
21-Jun,36047100400,3100400,7861,106494,114355,Brooklyn,1421504.282,Canarsie
19-Jul,36047100400,3100400,8260,70298,78558,Brooklyn,1421504.282,Canarsie
21-Jul,36047100400,3100400,8475,104918,113393,Brooklyn,1421504.282,Canarsie
19-Aug,36047100400,3100400,7751,14152,21903,Brooklyn,1421504.282,Canarsie
21-Aug,36047100400,3100400,1482,103164,104646,Brooklyn,1421504.282,Canarsie
19-May,36047100600,3100600,8821,99010,107831,Brooklyn,1637144.027,Canarsie
21-May,36047100600,3100600,6279,168369,174648,Brooklyn,1637144.027,Canarsie
19-Jun,36047100600,3100600,14208,46647,60855,Brooklyn,1637144.027,Canarsie
21-Jun,36047100600,3100600,7267,102356,109623,Brooklyn,1637144.027,Canarsie
19-Jul,36047100600,3100600,1048,2814,3862,Brooklyn,1637144.027,Canarsie
21-Jul,36047100600,3100600,847,121640,122487,Brooklyn,1637144.027,Canarsie
19-Aug,36047100600,3100600,4316,61562,65878,Brooklyn,1637144.027,Canarsie
21-Aug,36047100600,3100600,12058,72024,84082,Brooklyn,1637144.027,Canarsie
19-May,36047100800,3100800,0,55033,55033,Brooklyn,1602833.09,Canarsie
21-May,36047100800,3100800,10764,28468,39232,Brooklyn,1602833.09,Canarsie
19-Jun,36047100800,3100800,9667,61070,70737,Brooklyn,1602833.09,Canarsie
21-Jun,36047100800,3100800,0,53624,53624,Brooklyn,1602833.09,Canarsie
19-Jul,36047100800,3100800,8676,87858,96534,Brooklyn,1602833.09,Canarsie
21-Jul,36047100800,3100800,10359,152415,162774,Brooklyn,1602833.09,Canarsie
19-Aug,36047100800,3100800,2796,95550,98346,Brooklyn,1602833.09,Canarsie
21-Aug,36047100800,3100800,15411,21546,36957,Brooklyn,1602833.09,Canarsie
19-May,36047101000,3101000,5365,20664,26029,Brooklyn,1844400.804,Canarsie
21-May,36047101000,3101000,2286,112324,114610,Brooklyn,1844400.804,Canarsie
19-Jun,36047101000,3101000,4747,52963,57710,Brooklyn,1844400.804,Canarsie
21-Jun,36047101000,3101000,4125,71,4196,Brooklyn,1844400.804,Canarsie
19-Jul,36047101000,3101000,3692,10703,14395,Brooklyn,1844400.804,Canarsie
21-Jul,36047101000,3101000,7094,79621,86715,Brooklyn,1844400.804,Canarsie
19-Aug,36047101000,3101000,3585,64456,68041,Brooklyn,1844400.804,Canarsie
21-Aug,36047101000,3101000,4030,79628,83658,Brooklyn,1844400.804,Canarsie
19-May,36047101200,3101200,5136,126902,132038,Brooklyn,1730658.08,Canarsie
21-May,36047101200,3101200,6034,91580,97614,Brooklyn,1730658.08,Canarsie
19-Jun,36047101200,3101200,12676,92042,104718,Brooklyn,1730658.08,Canarsie
21-Jun,36047101200,3101200,3479,85137,88616,Brooklyn,1730658.08,Canarsie
19-Jul,36047101200,3101200,4651,35164,39815,Brooklyn,1730658.08,Canarsie
21-Jul,36047101200,3101200,7641,155282,162923,Brooklyn,1730658.08,Canarsie
19-Aug,36047101200,3101200,0,127427,127427,Brooklyn,1730658.08,Canarsie
21-Aug,36047101200,3101200,3047,90549,93596,Brooklyn,1730658.08,Canarsie
19-May,36047101400,3101400,12581,58106,70687,Brooklyn,1668038.392,Canarsie
21-May,36047101400,3101400,2446,65896,68342,Brooklyn,1668038.392,Canarsie
19-Jun,36047101400,3101400,6037,63131,69168,Brooklyn,1668038.392,Canarsie
21-Jun,36047101400,3101400,5821,14917,20738,Brooklyn,1668038.392,Canarsie
19-Jul,36047101400,3101400,4919,95994,100913,Brooklyn,1668038.392,Canarsie
21-Jul,36047101400,3101400,7940,150206,158146,Brooklyn,1668038.392,Canarsie
19-Aug,36047101400,3101400,5943,31935,37878,Brooklyn,1668038.392,Canarsie
21-Aug,36047101400,3101400,8431,9430,17861,Brooklyn,1668038.392,Canarsie
19-May,36047101600,3101600,14866,111474,126340,Brooklyn,1210060.236,Canarsie
21-May,36047101600,3101600,4696,136947,141643,Brooklyn,1210060.236,Canarsie
19-Jun,36047101600,3101600,9933,85918,95851,Brooklyn,1210060.236,Canarsie
21-Jun,36047101600,3101600,7069,107990,115059,Brooklyn,1210060.236,Canarsie
19-Jul,36047101600,3101600,10959,31116,42075,Brooklyn,1210060.236,Canarsie
21-Jul,36047101600,3101600,7954,77676,85630,Brooklyn,1210060.236,Canarsie
19-Aug,36047101600,3101600,2407,104299,106706,Brooklyn,1210060.236,Canarsie
21-Aug,36047101600,3101600,8493,68768,77261,Brooklyn,1210060.236,Canarsie
19-May,36047101800,3101800,9485,87686,97171,Brooklyn,2623263.458,Canarsie
21-May,36047101800,3101800,14772,61619,76391,Brooklyn,2623263.458,Canarsie
19-Jun,36047101800,3101800,12399,78533,90932,Brooklyn,2623263.458,Canarsie
21-Jun,36047101800,3101800,9230,65639,74869,Brooklyn,2623263.458,Canarsie
19-Jul,36047101800,3101800,22262,121959,144221,Brooklyn,2623263.458,Canarsie
21-Jul,36047101800,3101800,10490,93338,103828,Brooklyn,2623263.458,Canarsie
19-Aug,36047101800,3101800,6902,137571,144473,Brooklyn,2623263.458,Canarsie
21-Aug,36047101800,3101800,11598,60974,72572,Brooklyn,2623263.458,Canarsie
19-May,36047102000,3102000,5563,31348,36911,Brooklyn,1690995.009,Canarsie
21-May,36047102000,3102000,0,63930,63930,Brooklyn,1690995.009,Canarsie
19-Jun,36047102000,3102000,14999,58517,73516,Brooklyn,1690995.009,Canarsie
21-Jun,36047102000,3102000,8329,9386,17715,Brooklyn,1690995.009,Canarsie
19-Jul,36047102000,3102000,12141,112153,124294,Brooklyn,1690995.009,Canarsie
21-Jul,36047102000,3102000,10175,52403,62578,Brooklyn,1690995.009,Canarsie
19-Aug,36047102000,3102000,8506,65921,74427,Brooklyn,1690995.009,Canarsie
21-Aug,36047102000,3102000,7118,50619,57737,Brooklyn,1690995.009,Canarsie
19-May,36047102200,3102200,11073,93067,104140,Brooklyn,1752586.493,Canarsie
21-May,36047102200,3102200,6853,38187,45040,Brooklyn,1752586.493,Canarsie
19-Jun,36047102200,3102200,11749,115681,127430,Brooklyn,1752586.493,Canarsie
21-Jun,36047102200,3102200,7719,71,7790,Brooklyn,1752586.493,Canarsie
19-Jul,36047102200,3102200,7631,106106,113737,Brooklyn,1752586.493,Canarsie
21-Jul,36047102200,3102200,8780,12727,21507,Brooklyn,1752586.493,Canarsie
19-Aug,36047102200,3102200,4883,79567,84450,Brooklyn,1752586.493,Canarsie
21-Aug,36047102200,3102200,14722,29488,44210,Brooklyn,1752586.493,Canarsie
19-May,36047102400,3102400,11223,48598,59821,Brooklyn,1540219.308,Canarsie
21-May,36047102400,3102400,10501,126469,136970,Brooklyn,1540219.308,Canarsie
19-Jun,36047102400,3102400,17787,55870,73657,Brooklyn,1540219.308,Canarsie
21-Jun,36047102400,3102400,8872,55458,64330,Brooklyn,1540219.308,Canarsie
19-Jul,36047102400,3102400,7120,70536,77656,Brooklyn,1540219.308,Canarsie
21-Jul,36047102400,3102400,3658,28628,32286,Brooklyn,1540219.308,Canarsie
19-Aug,36047102400,3102400,87,26347,26434,Brooklyn,1540219.308,Canarsie
21-Aug,36047102400,3102400,14684,7665,22349,Brooklyn,1540219.308,Canarsie
19-May,36047102600,3102600,6762,89688,96450,Brooklyn,1462012.276,Canarsie
21-May,36047102600,3102600,7346,59433,66779,Brooklyn,1462012.276,Canarsie
19-Jun,36047102600,3102600,5813,50240,56053,Brooklyn,1462012.276,Canarsie
21-Jun,36047102600,3102600,3887,95708,99595,Brooklyn,1462012.276,Canarsie
19-Jul,36047102600,3102600,7987,104597,112584,Brooklyn,1462012.276,Canarsie
21-Jul,36047102600,3102600,4831,115188,120019,Brooklyn,1462012.276,Canarsie
19-Aug,36047102600,3102600,7055,50308,57363,Brooklyn,1462012.276,Canarsie
21-Aug,36047102600,3102600,5358,29937,35295,Brooklyn,1462012.276,Canarsie
19-May,36047102801,3102801,114,131243,131357,Brooklyn,1660819.648,Canarsie
21-May,36047102801,3102801,4580,33701,38281,Brooklyn,1660819.648,Canarsie
19-Jun,36047102801,3102801,11512,121892,133404,Brooklyn,1660819.648,Canarsie
21-Jun,36047102801,3102801,4235,53944,58179,Brooklyn,1660819.648,Canarsie
19-Jul,36047102801,3102801,3347,87101,90448,Brooklyn,1660819.648,Canarsie
21-Jul,36047102801,3102801,13700,114499,128199,Brooklyn,1660819.648,Canarsie
19-Aug,36047102801,3102801,10699,71,10770,Brooklyn,1660819.648,Canarsie
21-Aug,36047102801,3102801,6269,40956,47225,Brooklyn,1660819.648,Canarsie
19-May,36047102802,3102802,0,85048,85048,Brooklyn,7231547.665,Canarsie Park & Pier
21-May,36047102802,3102802,0,71,71,Brooklyn,7231547.665,Canarsie Park & Pier
19-Jun,36047102802,3102802,6642,26421,33063,Brooklyn,7231547.665,Canarsie Park & Pier
21-Jun,36047102802,3102802,9290,158025,167315,Brooklyn,7231547.665,Canarsie Park & Pier
19-Jul,36047102802,3102802,7162,71,7233,Brooklyn,7231547.665,Canarsie Park & Pier
21-Jul,36047102802,3102802,4162,98533,102695,Brooklyn,7231547.665,Canarsie Park & Pier
19-Aug,36047102802,3102802,17072,62971,80043,Brooklyn,7231547.665,Canarsie Park & Pier
21-Aug,36047102802,3102802,13429,60819,74248,Brooklyn,7231547.665,Canarsie Park & Pier
19-May,36047103401,3103401,16453,102918,119371,Brooklyn,1895802.649,Canarsie
21-May,36047103401,3103401,2771,53509,56280,Brooklyn,1895802.649,Canarsie
19-Jun,36047103401,3103401,10235,45366,55601,Brooklyn,1895802.649,Canarsie
21-Jun,36047103401,3103401,0,64859,64859,Brooklyn,1895802.649,Canarsie
19-Jul,36047103401,3103401,9005,90235,99240,Brooklyn,1895802.649,Canarsie
21-Jul,36047103401,3103401,7776,43097,50873,Brooklyn,1895802.649,Canarsie
19-Aug,36047103401,3103401,8852,71,8923,Brooklyn,1895802.649,Canarsie
21-Aug,36047103401,3103401,10364,56104,66468,Brooklyn,1895802.649,Canarsie
19-May,36047103402,3103402,17045,56826,73871,Brooklyn,4320501.524,Canarsie Park & Pier
21-May,36047103402,3103402,5984,104156,110140,Brooklyn,4320501.524,Canarsie Park & Pier
19-Jun,36047103402,3103402,10340,51673,62013,Brooklyn,4320501.524,Canarsie Park & Pier
21-Jun,36047103402,3103402,2429,123913,126342,Brooklyn,4320501.524,Canarsie Park & Pier
19-Jul,36047103402,3103402,15696,77183,92879,Brooklyn,4320501.524,Canarsie Park & Pier
21-Jul,36047103402,3103402,13033,71,13104,Brooklyn,4320501.524,Canarsie Park & Pier
19-Aug,36047103402,3103402,12146,73878,86024,Brooklyn,4320501.524,Canarsie Park & Pier
21-Aug,36047103402,3103402,6536,74349,80885,Brooklyn,4320501.524,Canarsie Park & Pier
19-May,36047105801,3105801,973,45533,46506,Brooklyn,4481506.733,Spring Creek-Starrett City
21-May,36047105801,3105801,6547,42162,48709,Brooklyn,4481506.733,Spring Creek-Starrett City
19-Jun,36047105801,3105801,10136,91019,101155,Brooklyn,4481506.733,Spring Creek-Starrett City
21-Jun,36047105801,3105801,9679,62712,72391,Brooklyn,4481506.733,Spring Creek-Starrett City
19-Jul,36047105801,3105801,14310,102938,117248,Brooklyn,4481506.733,Spring Creek-Starrett City
21-Jul,36047105801,3105801,8951,97761,106712,Brooklyn,4481506.733,Spring Creek-Starrett City
19-Aug,36047105801,3105801,8248,14158,22406,Brooklyn,4481506.733,Spring Creek-Starrett City
21-Aug,36047105801,3105801,0,106895,106895,Brooklyn,4481506.733,Spring Creek-Starrett City
19-May,36047107001,3107001,5287,66105,71392,Brooklyn,13115505.99,Spring Creek-Starrett City
21-May,36047107001,3107001,15894,120611,136505,Brooklyn,13115505.99,Spring Creek-Starrett City
19-Jun,36047107001,3107001,8494,82234,90728,Brooklyn,13115505.99,Spring Creek-Starrett City
21-Jun,36047107001,3107001,10455,103287,113742,Brooklyn,13115505.99,Spring Creek-Starrett City
19-Jul,36047107001,3107001,11364,37092,48456,Brooklyn,13115505.99,Spring Creek-Starrett City
21-Jul,36047107001,3107001,4369,96323,100692,Brooklyn,13115505.99,Spring Creek-Starrett City
19-Aug,36047107001,3107001,10981,36802,47783,Brooklyn,13115505.99,Spring Creek-Starrett City
21-Aug,36047107001,3107001,2153,14396,16549,Brooklyn,13115505.99,Spring Creek-Starrett City
19-May,36047107003,3107003,9405,115610,125015,Brooklyn,2363049.495,Spring Creek-Starrett City
21-May,36047107003,3107003,10519,50059,60578,Brooklyn,2363049.495,Spring Creek-Starrett City
19-Jun,36047107003,3107003,6549,74825,81374,Brooklyn,2363049.495,Spring Creek-Starrett City
21-Jun,36047107003,3107003,9598,38047,47645,Brooklyn,2363049.495,Spring Creek-Starrett City
19-Jul,36047107003,3107003,1530,21842,23372,Brooklyn,2363049.495,Spring Creek-Starrett City
21-Jul,36047107003,3107003,3445,2732,6177,Brooklyn,2363049.495,Spring Creek-Starrett City
19-Aug,36047107003,3107003,22924,151962,174886,Brooklyn,2363049.495,Spring Creek-Starrett City
21-Aug,36047107003,3107003,15931,90426,106357,Brooklyn,2363049.495,Spring Creek-Starrett City
19-May,36047107800,3107800,7962,64856,72818,Brooklyn,5449475.79,East New York-New Lots
21-May,36047107800,3107800,6437,66924,73361,Brooklyn,5449475.79,East New York-New Lots
19-Jun,36047107800,3107800,13672,88666,102338,Brooklyn,5449475.79,East New York-New Lots
21-Jun,36047107800,3107800,8315,66081,74396,Brooklyn,5449475.79,East New York-New Lots
19-Jul,36047107800,3107800,8620,63530,72150,Brooklyn,5449475.79,East New York-New Lots
21-Jul,36047107800,3107800,6142,1840,7982,Brooklyn,5449475.79,East New York-New Lots
19-Aug,36047107800,3107800,3378,93614,96992,Brooklyn,5449475.79,East New York-New Lots
21-Aug,36047107800,3107800,9816,31786,41602,Brooklyn,5449475.79,East New York-New Lots
19-May,36047109800,3109800,5406,114656,120062,Brooklyn,9191378.325,East New York-New Lots
21-May,36047109800,3109800,5642,73373,79015,Brooklyn,9191378.325,East New York-New Lots
19-Jun,36047109800,3109800,4309,28415,32724,Brooklyn,9191378.325,East New York-New Lots
21-Jun,36047109800,3109800,10559,92677,103236,Brooklyn,9191378.325,East New York-New Lots
19-Jul,36047109800,3109800,12992,132453,145445,Brooklyn,9191378.325,East New York-New Lots
21-Jul,36047109800,3109800,10170,94038,104208,Brooklyn,9191378.325,East New York-New Lots
19-Aug,36047109800,3109800,648,56255,56903,Brooklyn,9191378.325,East New York-New Lots
21-Aug,36047109800,3109800,3593,113345,116938,Brooklyn,9191378.325,East New York-New Lots
19-May,36047110400,3110400,2178,116952,119130,Brooklyn,7985790.255,East New York-New Lots
21-May,36047110400,3110400,5207,113934,119141,Brooklyn,7985790.255,East New York-New Lots
19-Jun,36047110400,3110400,7867,101467,109334,Brooklyn,7985790.255,East New York-New Lots
21-Jun,36047110400,3110400,6574,81457,88031,Brooklyn,7985790.255,East New York-New Lots
19-Jul,36047110400,3110400,11096,88548,99644,Brooklyn,7985790.255,East New York-New Lots
21-Jul,36047110400,3110400,11519,62287,73806,Brooklyn,7985790.255,East New York-New Lots
19-Aug,36047110400,3110400,11321,34026,45347,Brooklyn,7985790.255,East New York-New Lots
21-Aug,36047110400,3110400,10932,53695,64627,Brooklyn,7985790.255,East New York-New Lots
19-May,36047110600,3110600,4047,119236,123283,Brooklyn,1841331.876,East New York-New Lots
21-May,36047110600,3110600,5598,9407,15005,Brooklyn,1841331.876,East New York-New Lots
19-Jun,36047110600,3110600,16980,109584,126564,Brooklyn,1841331.876,East New York-New Lots
21-Jun,36047110600,3110600,7622,62022,69644,Brooklyn,1841331.876,East New York-New Lots
19-Jul,36047110600,3110600,20022,108743,128765,Brooklyn,1841331.876,East New York-New Lots
21-Jul,36047110600,3110600,0,45014,45014,Brooklyn,1841331.876,East New York-New Lots
19-Aug,36047110600,3110600,15435,73879,89314,Brooklyn,1841331.876,East New York-New Lots
21-Aug,36047110600,3110600,10090,140830,150920,Brooklyn,1841331.876,East New York-New Lots
19-May,36047111000,3111000,7893,88986,96879,Brooklyn,1348388.773,East New York-New Lots
21-May,36047111000,3111000,4076,86599,90675,Brooklyn,1348388.773,East New York-New Lots
19-Jun,36047111000,3111000,15300,104034,119334,Brooklyn,1348388.773,East New York-New Lots
21-Jun,36047111000,3111000,4705,80420,85125,Brooklyn,1348388.773,East New York-New Lots
19-Jul,36047111000,3111000,4933,67848,72781,Brooklyn,1348388.773,East New York-New Lots
21-Jul,36047111000,3111000,0,115641,115641,Brooklyn,1348388.773,East New York-New Lots
19-Aug,36047111000,3111000,0,111068,111068,Brooklyn,1348388.773,East New York-New Lots
21-Aug,36047111000,3111000,2834,82392,85226,Brooklyn,1348388.773,East New York-New Lots
19-May,36047111600,3111600,4385,67664,72049,Brooklyn,5375937.071,East New York-New Lots
21-May,36047111600,3111600,10242,23907,34149,Brooklyn,5375937.071,East New York-New Lots
19-Jun,36047111600,3111600,9810,76638,86448,Brooklyn,5375937.071,East New York-New Lots
21-Jun,36047111600,3111600,15118,55098,70216,Brooklyn,5375937.071,East New York-New Lots
19-Jul,36047111600,3111600,13922,10993,24915,Brooklyn,5375937.071,East New York-New Lots
21-Jul,36047111600,3111600,18511,20214,38725,Brooklyn,5375937.071,East New York-New Lots
19-Aug,36047111600,3111600,10193,106276,116469,Brooklyn,5375937.071,East New York-New Lots
21-Aug,36047111600,3111600,5091,87646,92737,Brooklyn,5375937.071,East New York-New Lots
19-May,36047112200,3112200,6917,95137,102054,Brooklyn,1747124.227,East New York-New Lots
21-May,36047112200,3112200,4691,93156,97847,Brooklyn,1747124.227,East New York-New Lots
19-Jun,36047112200,3112200,9052,98207,107259,Brooklyn,1747124.227,East New York-New Lots
21-Jun,36047112200,3112200,13719,96943,110662,Brooklyn,1747124.227,East New York-New Lots
19-Jul,36047112200,3112200,8431,35771,44202,Brooklyn,1747124.227,East New York-New Lots
21-Jul,36047112200,3112200,12177,47104,59281,Brooklyn,1747124.227,East New York-New Lots
19-Aug,36047112200,3112200,16296,78359,94655,Brooklyn,1747124.227,East New York-New Lots
21-Aug,36047112200,3112200,11031,92502,103533,Brooklyn,1747124.227,East New York-New Lots
19-May,36047112400,3112400,9624,54554,64178,Brooklyn,1914338.802,East New York-New Lots
21-May,36047112400,3112400,2264,72789,75053,Brooklyn,1914338.802,East New York-New Lots
19-Jun,36047112400,3112400,4771,27149,31920,Brooklyn,1914338.802,East New York-New Lots
21-Jun,36047112400,3112400,6643,73461,80104,Brooklyn,1914338.802,East New York-New Lots
19-Jul,36047112400,3112400,6143,34112,40255,Brooklyn,1914338.802,East New York-New Lots
21-Jul,36047112400,3112400,11638,69044,80682,Brooklyn,1914338.802,East New York-New Lots
19-Aug,36047112400,3112400,6663,18052,24715,Brooklyn,1914338.802,East New York-New Lots
21-Aug,36047112400,3112400,9842,49295,59137,Brooklyn,1914338.802,East New York-New Lots
19-May,36047112600,3112600,11678,75455,87133,Brooklyn,1813472.034,East New York-New Lots
21-May,36047112600,3112600,3543,127922,131465,Brooklyn,1813472.034,East New York-New Lots
19-Jun,36047112600,3112600,10519,96166,106685,Brooklyn,1813472.034,East New York-New Lots
21-Jun,36047112600,3112600,8780,115323,124103,Brooklyn,1813472.034,East New York-New Lots
19-Jul,36047112600,3112600,16661,4595,21256,Brooklyn,1813472.034,East New York-New Lots
21-Jul,36047112600,3112600,7145,128084,135229,Brooklyn,1813472.034,East New York-New Lots
19-Aug,36047112600,3112600,17538,40963,58501,Brooklyn,1813472.034,East New York-New Lots
21-Aug,36047112600,3112600,8968,80503,89471,Brooklyn,1813472.034,East New York-New Lots
19-May,36047112800,3112800,9600,42633,52233,Brooklyn,1982798.031,East New York-New Lots
21-May,36047112800,3112800,9371,36324,45695,Brooklyn,1982798.031,East New York-New Lots
19-Jun,36047112800,3112800,828,116353,117181,Brooklyn,1982798.031,East New York-New Lots
21-Jun,36047112800,3112800,5212,86988,92200,Brooklyn,1982798.031,East New York-New Lots
19-Jul,36047112800,3112800,17564,95617,113181,Brooklyn,1982798.031,East New York-New Lots
21-Jul,36047112800,3112800,14060,42591,56651,Brooklyn,1982798.031,East New York-New Lots
19-Aug,36047112800,3112800,4837,74104,78941,Brooklyn,1982798.031,East New York-New Lots
21-Aug,36047112800,3112800,8934,108484,117418,Brooklyn,1982798.031,East New York-New Lots
19-May,36047113000,3113000,14042,201160,215202,Brooklyn,2086280.698,East New York-New Lots
21-May,36047113000,3113000,14350,87949,102299,Brooklyn,2086280.698,East New York-New Lots
19-Jun,36047113000,3113000,10225,42775,53000,Brooklyn,2086280.698,East New York-New Lots
21-Jun,36047113000,3113000,7788,54554,62342,Brooklyn,2086280.698,East New York-New Lots
19-Jul,36047113000,3113000,8844,83889,92733,Brooklyn,2086280.698,East New York-New Lots
21-Jul,36047113000,3113000,8974,97980,106954,Brooklyn,2086280.698,East New York-New Lots
19-Aug,36047113000,3113000,14656,57471,72127,Brooklyn,2086280.698,East New York-New Lots
21-Aug,36047113000,3113000,2504,110726,113230,Brooklyn,2086280.698,East New York-New Lots
19-May,36047113200,3113200,9951,38506,48457,Brooklyn,2109760.029,East New York-New Lots
21-May,36047113200,3113200,4306,75881,80187,Brooklyn,2109760.029,East New York-New Lots
19-Jun,36047113200,3113200,8369,46858,55227,Brooklyn,2109760.029,East New York-New Lots
21-Jun,36047113200,3113200,468,37668,38136,Brooklyn,2109760.029,East New York-New Lots
19-Jul,36047113200,3113200,25412,80642,106054,Brooklyn,2109760.029,East New York-New Lots
21-Jul,36047113200,3113200,3761,69477,73238,Brooklyn,2109760.029,East New York-New Lots
19-Aug,36047113200,3113200,11238,58814,70052,Brooklyn,2109760.029,East New York-New Lots
21-Aug,36047113200,3113200,6915,126095,133010,Brooklyn,2109760.029,East New York-New Lots
19-May,36047113400,3113400,9763,66642,76405,Brooklyn,1651198.131,East New York (North)
21-May,36047113400,3113400,8155,42099,50254,Brooklyn,1651198.131,East New York (North)
19-Jun,36047113400,3113400,6901,8571,15472,Brooklyn,1651198.131,East New York (North)
21-Jun,36047113400,3113400,12980,99716,112696,Brooklyn,1651198.131,East New York (North)
19-Jul,36047113400,3113400,9432,107871,117303,Brooklyn,1651198.131,East New York (North)
21-Jul,36047113400,3113400,5681,55745,61426,Brooklyn,1651198.131,East New York (North)
19-Aug,36047113400,3113400,4012,98142,102154,Brooklyn,1651198.131,East New York (North)
21-Aug,36047113400,3113400,14817,62951,77768,Brooklyn,1651198.131,East New York (North)
19-May,36047114202,3114202,15325,50337,65662,Brooklyn,1286732.42,Cypress Hills
21-May,36047114202,3114202,15147,104862,120009,Brooklyn,1286732.42,Cypress Hills
19-Jun,36047114202,3114202,12415,68607,81022,Brooklyn,1286732.42,Cypress Hills
21-Jun,36047114202,3114202,1048,100076,101124,Brooklyn,1286732.42,Cypress Hills
19-Jul,36047114202,3114202,13293,63181,76474,Brooklyn,1286732.42,Cypress Hills
21-Jul,36047114202,3114202,2719,91809,94528,Brooklyn,1286732.42,Cypress Hills
19-Aug,36047114202,3114202,7696,70205,77901,Brooklyn,1286732.42,Cypress Hills
21-Aug,36047114202,3114202,8619,73154,81773,Brooklyn,1286732.42,Cypress Hills
19-May,36047115000,3115000,10029,20133,30162,Brooklyn,1703334.401,East New York (North)
21-May,36047115000,3115000,4460,119576,124036,Brooklyn,1703334.401,East New York (North)
19-Jun,36047115000,3115000,10809,69814,80623,Brooklyn,1703334.401,East New York (North)
21-Jun,36047115000,3115000,6208,71184,77392,Brooklyn,1703334.401,East New York (North)
19-Jul,36047115000,3115000,10874,54728,65602,Brooklyn,1703334.401,East New York (North)
21-Jul,36047115000,3115000,1358,110589,111947,Brooklyn,1703334.401,East New York (North)
19-Aug,36047115000,3115000,10678,149168,159846,Brooklyn,1703334.401,East New York (North)
21-Aug,36047115000,3115000,13927,45442,59369,Brooklyn,1703334.401,East New York (North)
19-May,36047115200,3115200,778,45607,46385,Brooklyn,1788251.781,East New York (North)
21-May,36047115200,3115200,9570,13255,22825,Brooklyn,1788251.781,East New York (North)
19-Jun,36047115200,3115200,14766,124677,139443,Brooklyn,1788251.781,East New York (North)
21-Jun,36047115200,3115200,7334,93180,100514,Brooklyn,1788251.781,East New York (North)
19-Jul,36047115200,3115200,4186,73182,77368,Brooklyn,1788251.781,East New York (North)
21-Jul,36047115200,3115200,18806,53691,72497,Brooklyn,1788251.781,East New York (North)
19-Aug,36047115200,3115200,11812,51023,62835,Brooklyn,1788251.781,East New York (North)
21-Aug,36047115200,3115200,12850,140321,153171,Brooklyn,1788251.781,East New York (North)
19-May,36047115600,3115600,8752,76312,85064,Brooklyn,1720940.157,East New York (North)
21-May,36047115600,3115600,7358,69902,77260,Brooklyn,1720940.157,East New York (North)
19-Jun,36047115600,3115600,7939,82181,90120,Brooklyn,1720940.157,East New York (North)
21-Jun,36047115600,3115600,188,122552,122740,Brooklyn,1720940.157,East New York (North)
19-Jul,36047115600,3115600,6464,131848,138312,Brooklyn,1720940.157,East New York (North)
21-Jul,36047115600,3115600,17923,100669,118592,Brooklyn,1720940.157,East New York (North)
19-Aug,36047115600,3115600,9981,26541,36522,Brooklyn,1720940.157,East New York (North)
21-Aug,36047115600,3115600,5937,159807,165744,Brooklyn,1720940.157,East New York (North)
19-May,36047115800,3115800,11443,71,11514,Brooklyn,1668175.877,East New York (North)
21-May,36047115800,3115800,10521,44303,54824,Brooklyn,1668175.877,East New York (North)
19-Jun,36047115800,3115800,1500,18203,19703,Brooklyn,1668175.877,East New York (North)
21-Jun,36047115800,3115800,0,95604,95604,Brooklyn,1668175.877,East New York (North)
19-Jul,36047115800,3115800,11160,22892,34052,Brooklyn,1668175.877,East New York (North)
21-Jul,36047115800,3115800,1234,54746,55980,Brooklyn,1668175.877,East New York (North)
19-Aug,36047115800,3115800,0,108079,108079,Brooklyn,1668175.877,East New York (North)
21-Aug,36047115800,3115800,3596,95692,99288,Brooklyn,1668175.877,East New York (North)
19-May,36047116000,3116000,8825,74561,83386,Brooklyn,1629832.626,East New York (North)
21-May,36047116000,3116000,8254,53788,62042,Brooklyn,1629832.626,East New York (North)
19-Jun,36047116000,3116000,8856,66679,75535,Brooklyn,1629832.626,East New York (North)
21-Jun,36047116000,3116000,14239,168084,182323,Brooklyn,1629832.626,East New York (North)
19-Jul,36047116000,3116000,3174,171680,174854,Brooklyn,1629832.626,East New York (North)
21-Jul,36047116000,3116000,5942,46154,52096,Brooklyn,1629832.626,East New York (North)
19-Aug,36047116000,3116000,6131,122677,128808,Brooklyn,1629832.626,East New York (North)
21-Aug,36047116000,3116000,6228,38810,45038,Brooklyn,1629832.626,East New York (North)
19-May,36047116200,3116200,10740,77241,87981,Brooklyn,1543810.125,East New York (North)
21-May,36047116200,3116200,8341,48046,56387,Brooklyn,1543810.125,East New York (North)
19-Jun,36047116200,3116200,10020,77513,87533,Brooklyn,1543810.125,East New York (North)
21-Jun,36047116200,3116200,14125,108439,122564,Brooklyn,1543810.125,East New York (North)
19-Jul,36047116200,3116200,11307,74429,85736,Brooklyn,1543810.125,East New York (North)
21-Jul,36047116200,3116200,7357,104288,111645,Brooklyn,1543810.125,East New York (North)
19-Aug,36047116200,3116200,5280,40580,45860,Brooklyn,1543810.125,East New York (North)
21-Aug,36047116200,3116200,8418,42387,50805,Brooklyn,1543810.125,East New York (North)
19-May,36047116400,3116400,17348,186852,204200,Brooklyn,1954432.437,East New York (North)
21-May,36047116400,3116400,13795,67651,81446,Brooklyn,1954432.437,East New York (North)
19-Jun,36047116400,3116400,6743,200093,206836,Brooklyn,1954432.437,East New York (North)
21-Jun,36047116400,3116400,16392,80763,97155,Brooklyn,1954432.437,East New York (North)
19-Jul,36047116400,3116400,0,42738,42738,Brooklyn,1954432.437,East New York (North)
21-Jul,36047116400,3116400,10603,82271,92874,Brooklyn,1954432.437,East New York (North)
19-Aug,36047116400,3116400,7254,59315,66569,Brooklyn,1954432.437,East New York (North)
21-Aug,36047116400,3116400,11201,44667,55868,Brooklyn,1954432.437,East New York (North)
19-May,36047116600,3116600,0,102823,102823,Brooklyn,1715753.161,East New York (North)
21-May,36047116600,3116600,16963,70758,87721,Brooklyn,1715753.161,East New York (North)
19-Jun,36047116600,3116600,4930,18311,23241,Brooklyn,1715753.161,East New York (North)
21-Jun,36047116600,3116600,17165,57488,74653,Brooklyn,1715753.161,East New York (North)
19-Jul,36047116600,3116600,11410,11468,22878,Brooklyn,1715753.161,East New York (North)
21-Jul,36047116600,3116600,7641,53205,60846,Brooklyn,1715753.161,East New York (North)
19-Aug,36047116600,3116600,7533,66673,74206,Brooklyn,1715753.161,East New York (North)
21-Aug,36047116600,3116600,7307,82969,90276,Brooklyn,1715753.161,East New York (North)
19-May,36047116800,3116800,6226,63165,69391,Brooklyn,1549247.993,Cypress Hills
21-May,36047116800,3116800,6159,80437,86596,Brooklyn,1549247.993,Cypress Hills
19-Jun,36047116800,3116800,5712,24975,30687,Brooklyn,1549247.993,Cypress Hills
21-Jun,36047116800,3116800,20331,43195,63526,Brooklyn,1549247.993,Cypress Hills
19-Jul,36047116800,3116800,2088,129631,131719,Brooklyn,1549247.993,Cypress Hills
21-Jul,36047116800,3116800,11137,84986,96123,Brooklyn,1549247.993,Cypress Hills
19-Aug,36047116800,3116800,8543,56268,64811,Brooklyn,1549247.993,Cypress Hills
21-Aug,36047116800,3116800,13270,79159,92429,Brooklyn,1549247.993,Cypress Hills
19-May,36047117000,3117000,11357,98612,109969,Brooklyn,1653944.132,Cypress Hills
21-May,36047117000,3117000,10249,100427,110676,Brooklyn,1653944.132,Cypress Hills
19-Jun,36047117000,3117000,10958,107659,118617,Brooklyn,1653944.132,Cypress Hills
21-Jun,36047117000,3117000,1705,57877,59582,Brooklyn,1653944.132,Cypress Hills
19-Jul,36047117000,3117000,5666,88127,93793,Brooklyn,1653944.132,Cypress Hills
21-Jul,36047117000,3117000,7489,133846,141335,Brooklyn,1653944.132,Cypress Hills
19-Aug,36047117000,3117000,2858,37421,40279,Brooklyn,1653944.132,Cypress Hills
21-Aug,36047117000,3117000,5141,59727,64868,Brooklyn,1653944.132,Cypress Hills
19-May,36047117201,3117201,14457,55615,70072,Brooklyn,1390018.217,Cypress Hills
21-May,36047117201,3117201,0,49031,49031,Brooklyn,1390018.217,Cypress Hills
19-Jun,36047117201,3117201,11445,92220,103665,Brooklyn,1390018.217,Cypress Hills
21-Jun,36047117201,3117201,11988,63022,75010,Brooklyn,1390018.217,Cypress Hills
19-Jul,36047117201,3117201,4307,68006,72313,Brooklyn,1390018.217,Cypress Hills
21-Jul,36047117201,3117201,7505,79407,86912,Brooklyn,1390018.217,Cypress Hills
19-Aug,36047117201,3117201,12306,69970,82276,Brooklyn,1390018.217,Cypress Hills
21-Aug,36047117201,3117201,6361,36775,43136,Brooklyn,1390018.217,Cypress Hills
19-May,36047117202,3117202,11935,29879,41814,Brooklyn,1634622.195,Cypress Hills
21-May,36047117202,3117202,7216,101925,109141,Brooklyn,1634622.195,Cypress Hills
19-Jun,36047117202,3117202,11170,74796,85966,Brooklyn,1634622.195,Cypress Hills
21-Jun,36047117202,3117202,15869,40653,56522,Brooklyn,1634622.195,Cypress Hills
19-Jul,36047117202,3117202,11164,5245,16409,Brooklyn,1634622.195,Cypress Hills
21-Jul,36047117202,3117202,3179,92825,96004,Brooklyn,1634622.195,Cypress Hills
19-Aug,36047117202,3117202,14452,57323,71775,Brooklyn,1634622.195,Cypress Hills
21-Aug,36047117202,3117202,6721,31280,38001,Brooklyn,1634622.195,Cypress Hills
19-May,36047117400,3117400,10249,21871,32120,Brooklyn,2295155.292,Cypress Hills
21-May,36047117400,3117400,11096,64494,75590,Brooklyn,2295155.292,Cypress Hills
19-Jun,36047117400,3117400,5665,94192,99857,Brooklyn,2295155.292,Cypress Hills
21-Jun,36047117400,3117400,8005,44927,52932,Brooklyn,2295155.292,Cypress Hills
19-Jul,36047117400,3117400,14790,69021,83811,Brooklyn,2295155.292,Cypress Hills
21-Jul,36047117400,3117400,11859,56345,68204,Brooklyn,2295155.292,Cypress Hills
19-Aug,36047117400,3117400,9466,84198,93664,Brooklyn,2295155.292,Cypress Hills
21-Aug,36047117400,3117400,7550,65698,73248,Brooklyn,2295155.292,Cypress Hills
19-May,36047117601,3117601,1030,101153,102183,Brooklyn,1639988.19,Cypress Hills
21-May,36047117601,3117601,5964,201232,207196,Brooklyn,1639988.19,Cypress Hills
19-Jun,36047117601,3117601,4205,50000,54205,Brooklyn,1639988.19,Cypress Hills
21-Jun,36047117601,3117601,9231,54422,63653,Brooklyn,1639988.19,Cypress Hills
19-Jul,36047117601,3117601,9705,62711,72416,Brooklyn,1639988.19,Cypress Hills
21-Jul,36047117601,3117601,8276,87783,96059,Brooklyn,1639988.19,Cypress Hills
19-Aug,36047117601,3117601,6568,84486,91054,Brooklyn,1639988.19,Cypress Hills
21-Aug,36047117601,3117601,11024,66146,77170,Brooklyn,1639988.19,Cypress Hills
19-May,36047117602,3117602,9757,67025,76782,Brooklyn,1548008.021,Cypress Hills
21-May,36047117602,3117602,1403,100794,102197,Brooklyn,1548008.021,Cypress Hills
19-Jun,36047117602,3117602,13013,96516,109529,Brooklyn,1548008.021,Cypress Hills
21-Jun,36047117602,3117602,14927,69971,84898,Brooklyn,1548008.021,Cypress Hills
19-Jul,36047117602,3117602,16749,31447,48196,Brooklyn,1548008.021,Cypress Hills
21-Jul,36047117602,3117602,10071,26555,36626,Brooklyn,1548008.021,Cypress Hills
19-Aug,36047117602,3117602,16359,115179,131538,Brooklyn,1548008.021,Cypress Hills
21-Aug,36047117602,3117602,9710,72530,82240,Brooklyn,1548008.021,Cypress Hills
19-May,36047117800,3117800,4776,93788,98564,Brooklyn,1528412.172,Cypress Hills
21-May,36047117800,3117800,7005,87510,94515,Brooklyn,1528412.172,Cypress Hills
19-Jun,36047117800,3117800,16232,75233,91465,Brooklyn,1528412.172,Cypress Hills
21-Jun,36047117800,3117800,9732,76644,86376,Brooklyn,1528412.172,Cypress Hills
19-Jul,36047117800,3117800,4116,42060,46176,Brooklyn,1528412.172,Cypress Hills
21-Jul,36047117800,3117800,4780,51918,56698,Brooklyn,1528412.172,Cypress Hills
19-Aug,36047117800,3117800,6502,66778,73280,Brooklyn,1528412.172,Cypress Hills
21-Aug,36047117800,3117800,12879,72125,85004,Brooklyn,1528412.172,Cypress Hills
19-May,36047118000,3118000,2636,58704,61340,Brooklyn,8100960.298,Highland Park-Cypress Hills Cemeteries (South)
21-May,36047118000,3118000,12968,127391,140359,Brooklyn,8100960.298,Highland Park-Cypress Hills Cemeteries (South)
19-Jun,36047118000,3118000,10389,129649,140038,Brooklyn,8100960.298,Highland Park-Cypress Hills Cemeteries (South)
21-Jun,36047118000,3118000,21464,64185,85649,Brooklyn,8100960.298,Highland Park-Cypress Hills Cemeteries (South)
19-Jul,36047118000,3118000,2496,41514,44010,Brooklyn,8100960.298,Highland Park-Cypress Hills Cemeteries (South)
21-Jul,36047118000,3118000,12822,26639,39461,Brooklyn,8100960.298,Highland Park-Cypress Hills Cemeteries (South)
19-Aug,36047118000,3118000,15017,84692,99709,Brooklyn,8100960.298,Highland Park-Cypress Hills Cemeteries (South)
21-Aug,36047118000,3118000,4138,68013,72151,Brooklyn,8100960.298,Highland Park-Cypress Hills Cemeteries (South)
19-May,36047118201,3118201,5607,45729,51336,Brooklyn,1360340.153,Cypress Hills
21-May,36047118201,3118201,15046,147222,162268,Brooklyn,1360340.153,Cypress Hills
19-Jun,36047118201,3118201,1793,72530,74323,Brooklyn,1360340.153,Cypress Hills
21-Jun,36047118201,3118201,14657,90308,104965,Brooklyn,1360340.153,Cypress Hills
19-Jul,36047118201,3118201,2182,31223,33405,Brooklyn,1360340.153,Cypress Hills
21-Jul,36047118201,3118201,17034,80871,97905,Brooklyn,1360340.153,Cypress Hills
19-Aug,36047118201,3118201,2384,89435,91819,Brooklyn,1360340.153,Cypress Hills
21-Aug,36047118201,3118201,11208,7641,18849,Brooklyn,1360340.153,Cypress Hills
19-May,36047118202,3118202,1015,94438,95453,Brooklyn,1337869.819,Cypress Hills
21-May,36047118202,3118202,7120,5834,12954,Brooklyn,1337869.819,Cypress Hills
19-Jun,36047118202,3118202,14959,58766,73725,Brooklyn,1337869.819,Cypress Hills
21-Jun,36047118202,3118202,8297,78384,86681,Brooklyn,1337869.819,Cypress Hills
19-Jul,36047118202,3118202,5778,86561,92339,Brooklyn,1337869.819,Cypress Hills
21-Jul,36047118202,3118202,5269,105320,110589,Brooklyn,1337869.819,Cypress Hills
19-Aug,36047118202,3118202,13993,90466,104459,Brooklyn,1337869.819,Cypress Hills
21-Aug,36047118202,3118202,11442,91852,103294,Brooklyn,1337869.819,Cypress Hills
19-May,36047118400,3118400,3396,82744,86140,Brooklyn,2204317.887,Cypress Hills
21-May,36047118400,3118400,1690,70479,72169,Brooklyn,2204317.887,Cypress Hills
19-Jun,36047118400,3118400,9539,86862,96401,Brooklyn,2204317.887,Cypress Hills
21-Jun,36047118400,3118400,5525,40744,46269,Brooklyn,2204317.887,Cypress Hills
19-Jul,36047118400,3118400,11353,81262,92615,Brooklyn,2204317.887,Cypress Hills
21-Jul,36047118400,3118400,4629,22253,26882,Brooklyn,2204317.887,Cypress Hills
19-Aug,36047118400,3118400,6629,120709,127338,Brooklyn,2204317.887,Cypress Hills
21-Aug,36047118400,3118400,9803,115512,125315,Brooklyn,2204317.887,Cypress Hills
19-May,36047118800,3118800,6310,54325,60635,Brooklyn,1877213.46,East New York-City Line
21-May,36047118800,3118800,10641,96650,107291,Brooklyn,1877213.46,East New York-City Line
19-Jun,36047118800,3118800,742,98358,99100,Brooklyn,1877213.46,East New York-City Line
21-Jun,36047118800,3118800,3561,56731,60292,Brooklyn,1877213.46,East New York-City Line
19-Jul,36047118800,3118800,10600,51735,62335,Brooklyn,1877213.46,East New York-City Line
21-Jul,36047118800,3118800,2292,72349,74641,Brooklyn,1877213.46,East New York-City Line
19-Aug,36047118800,3118800,8800,59744,68544,Brooklyn,1877213.46,East New York-City Line
21-Aug,36047118800,3118800,15725,95008,110733,Brooklyn,1877213.46,East New York-City Line
19-May,36047119000,3119000,13724,75069,88793,Brooklyn,1510640.523,East New York-City Line
21-May,36047119000,3119000,6466,122203,128669,Brooklyn,1510640.523,East New York-City Line
19-Jun,36047119000,3119000,5722,54301,60023,Brooklyn,1510640.523,East New York-City Line
21-Jun,36047119000,3119000,2486,91179,93665,Brooklyn,1510640.523,East New York-City Line
19-Jul,36047119000,3119000,13223,42809,56032,Brooklyn,1510640.523,East New York-City Line
21-Jul,36047119000,3119000,12293,49499,61792,Brooklyn,1510640.523,East New York-City Line
19-Aug,36047119000,3119000,3827,99702,103529,Brooklyn,1510640.523,East New York-City Line
21-Aug,36047119000,3119000,1159,113500,114659,Brooklyn,1510640.523,East New York-City Line
19-May,36047119200,3119200,10245,77452,87697,Brooklyn,2421479.275,East New York (North)
21-May,36047119200,3119200,5566,87638,93204,Brooklyn,2421479.275,East New York (North)
19-Jun,36047119200,3119200,12945,98344,111289,Brooklyn,2421479.275,East New York (North)
21-Jun,36047119200,3119200,5576,92243,97819,Brooklyn,2421479.275,East New York (North)
19-Jul,36047119200,3119200,8406,55793,64199,Brooklyn,2421479.275,East New York (North)
21-Jul,36047119200,3119200,6266,60919,67185,Brooklyn,2421479.275,East New York (North)
19-Aug,36047119200,3119200,12045,150329,162374,Brooklyn,2421479.275,East New York (North)
21-Aug,36047119200,3119200,13635,76254,89889,Brooklyn,2421479.275,East New York (North)
19-May,36047119400,3119400,0,83207,83207,Brooklyn,1964535.954,East New York (North)
21-May,36047119400,3119400,10998,48894,59892,Brooklyn,1964535.954,East New York (North)
19-Jun,36047119400,3119400,16557,44742,61299,Brooklyn,1964535.954,East New York (North)
21-Jun,36047119400,3119400,12786,64115,76901,Brooklyn,1964535.954,East New York (North)
19-Jul,36047119400,3119400,11750,36079,47829,Brooklyn,1964535.954,East New York (North)
21-Jul,36047119400,3119400,8149,51502,59651,Brooklyn,1964535.954,East New York (North)
19-Aug,36047119400,3119400,5172,46231,51403,Brooklyn,1964535.954,East New York (North)
21-Aug,36047119400,3119400,7063,115531,122594,Brooklyn,1964535.954,East New York (North)
19-May,36047119600,3119600,16142,55071,71213,Brooklyn,3290843.756,East New York-City Line
21-May,36047119600,3119600,13361,99282,112643,Brooklyn,3290843.756,East New York-City Line
19-Jun,36047119600,3119600,13727,53514,67241,Brooklyn,3290843.756,East New York-City Line
21-Jun,36047119600,3119600,9969,79347,89316,Brooklyn,3290843.756,East New York-City Line
19-Jul,36047119600,3119600,2932,73407,76339,Brooklyn,3290843.756,East New York-City Line
21-Jul,36047119600,3119600,8657,10278,18935,Brooklyn,3290843.756,East New York-City Line
19-Aug,36047119600,3119600,6228,71,6299,Brooklyn,3290843.756,East New York-City Line
21-Aug,36047119600,3119600,14204,59971,74175,Brooklyn,3290843.756,East New York-City Line
19-May,36047119800,3119800,8398,62135,70533,Brooklyn,3527651.391,East New York (North)
21-May,36047119800,3119800,8417,119266,127683,Brooklyn,3527651.391,East New York (North)
19-Jun,36047119800,3119800,9766,81152,90918,Brooklyn,3527651.391,East New York (North)
21-Jun,36047119800,3119800,8360,103125,111485,Brooklyn,3527651.391,East New York (North)
19-Jul,36047119800,3119800,17111,23240,40351,Brooklyn,3527651.391,East New York (North)
21-Jul,36047119800,3119800,6848,53857,60705,Brooklyn,3527651.391,East New York (North)
19-Aug,36047119800,3119800,11901,98011,109912,Brooklyn,3527651.391,East New York (North)
21-Aug,36047119800,3119800,3453,47754,51207,Brooklyn,3527651.391,East New York (North)
19-May,36047120000,3120000,7084,7292,14376,Brooklyn,1623804.089,East New York-City Line
21-May,36047120000,3120000,3516,68966,72482,Brooklyn,1623804.089,East New York-City Line
19-Jun,36047120000,3120000,703,120190,120893,Brooklyn,1623804.089,East New York-City Line
21-Jun,36047120000,3120000,16226,7603,23829,Brooklyn,1623804.089,East New York-City Line
19-Jul,36047120000,3120000,2537,71,2608,Brooklyn,1623804.089,East New York-City Line
21-Jul,36047120000,3120000,12499,71715,84214,Brooklyn,1623804.089,East New York-City Line
19-Aug,36047120000,3120000,5254,64325,69579,Brooklyn,1623804.089,East New York-City Line
21-Aug,36047120000,3120000,11799,26006,37805,Brooklyn,1623804.089,East New York-City Line
19-May,36047120200,3120200,3655,24383,28038,Brooklyn,1641233.539,East New York-City Line
21-May,36047120200,3120200,10201,40381,50582,Brooklyn,1641233.539,East New York-City Line
19-Jun,36047120200,3120200,12725,87229,99954,Brooklyn,1641233.539,East New York-City Line
21-Jun,36047120200,3120200,504,138115,138619,Brooklyn,1641233.539,East New York-City Line
19-Jul,36047120200,3120200,1911,90291,92202,Brooklyn,1641233.539,East New York-City Line
21-Jul,36047120200,3120200,3616,100696,104312,Brooklyn,1641233.539,East New York-City Line
19-Aug,36047120200,3120200,9444,51908,61352,Brooklyn,1641233.539,East New York-City Line
21-Aug,36047120200,3120200,13464,54107,67571,Brooklyn,1641233.539,East New York-City Line
19-May,36047120801,3120801,6048,60342,66390,Brooklyn,2167971.934,East New York-City Line
21-May,36047120801,3120801,13656,103165,116821,Brooklyn,2167971.934,East New York-City Line
19-Jun,36047120801,3120801,3353,85121,88474,Brooklyn,2167971.934,East New York-City Line
21-Jun,36047120801,3120801,7734,66953,74687,Brooklyn,2167971.934,East New York-City Line
19-Jul,36047120801,3120801,3015,71136,74151,Brooklyn,2167971.934,East New York-City Line
21-Jul,36047120801,3120801,3500,28544,32044,Brooklyn,2167971.934,East New York-City Line
19-Aug,36047120801,3120801,4858,106001,110859,Brooklyn,2167971.934,East New York-City Line
21-Aug,36047120801,3120801,2995,72906,75901,Brooklyn,2167971.934,East New York-City Line
19-May,36047120802,3120802,8333,46973,55306,Brooklyn,1268359.457,East New York-City Line
21-May,36047120802,3120802,12267,11501,23768,Brooklyn,1268359.457,East New York-City Line
19-Jun,36047120802,3120802,8453,90693,99146,Brooklyn,1268359.457,East New York-City Line
21-Jun,36047120802,3120802,2845,18729,21574,Brooklyn,1268359.457,East New York-City Line
19-Jul,36047120802,3120802,6525,37849,44374,Brooklyn,1268359.457,East New York-City Line
21-Jul,36047120802,3120802,2690,49092,51782,Brooklyn,1268359.457,East New York-City Line
19-Aug,36047120802,3120802,0,43937,43937,Brooklyn,1268359.457,East New York-City Line
21-Aug,36047120802,3120802,2785,75085,77870,Brooklyn,1268359.457,East New York-City Line
19-May,36047120803,3120803,2819,78801,81620,Brooklyn,1665738.943,East New York-City Line
21-May,36047120803,3120803,10222,18339,28561,Brooklyn,1665738.943,East New York-City Line
19-Jun,36047120803,3120803,2258,85266,87524,Brooklyn,1665738.943,East New York-City Line
21-Jun,36047120803,3120803,503,64359,64862,Brooklyn,1665738.943,East New York-City Line
19-Jul,36047120803,3120803,8759,74098,82857,Brooklyn,1665738.943,East New York-City Line
21-Jul,36047120803,3120803,10393,25726,36119,Brooklyn,1665738.943,East New York-City Line
19-Aug,36047120803,3120803,2339,41821,44160,Brooklyn,1665738.943,East New York-City Line
21-Aug,36047120803,3120803,8706,77729,86435,Brooklyn,1665738.943,East New York-City Line
19-May,36047121000,3121000,7211,71,7282,Brooklyn,1716806.548,East New York-City Line
21-May,36047121000,3121000,6908,68355,75263,Brooklyn,1716806.548,East New York-City Line
19-Jun,36047121000,3121000,12734,102671,115405,Brooklyn,1716806.548,East New York-City Line
21-Jun,36047121000,3121000,12935,93097,106032,Brooklyn,1716806.548,East New York-City Line
19-Jul,36047121000,3121000,6467,59585,66052,Brooklyn,1716806.548,East New York-City Line
21-Jul,36047121000,3121000,2246,112340,114586,Brooklyn,1716806.548,East New York-City Line
19-Aug,36047121000,3121000,15627,97264,112891,Brooklyn,1716806.548,East New York-City Line
21-Aug,36047121000,3121000,13721,83924,97645,Brooklyn,1716806.548,East New York-City Line
19-May,36047121400,3121400,16425,99556,115981,Brooklyn,1864053.895,East New York-City Line
21-May,36047121400,3121400,6676,58592,65268,Brooklyn,1864053.895,East New York-City Line
19-Jun,36047121400,3121400,2704,87937,90641,Brooklyn,1864053.895,East New York-City Line
21-Jun,36047121400,3121400,9480,65684,75164,Brooklyn,1864053.895,East New York-City Line
19-Jul,36047121400,3121400,14362,71,14433,Brooklyn,1864053.895,East New York-City Line
21-Jul,36047121400,3121400,17965,26525,44490,Brooklyn,1864053.895,East New York-City Line
19-Aug,36047121400,3121400,3496,43770,47266,Brooklyn,1864053.895,East New York-City Line
21-Aug,36047121400,3121400,9298,95997,105295,Brooklyn,1864053.895,East New York-City Line
19-May,36047122000,3122000,14765,13337,28102,Brooklyn,11487294.49,East New York-City Line
21-May,36047122000,3122000,7769,55420,63189,Brooklyn,11487294.49,East New York-City Line
19-Jun,36047122000,3122000,6143,21803,27946,Brooklyn,11487294.49,East New York-City Line
21-Jun,36047122000,3122000,3200,71813,75013,Brooklyn,11487294.49,East New York-City Line
19-Jul,36047122000,3122000,6877,114930,121807,Brooklyn,11487294.49,East New York-City Line
21-Jul,36047122000,3122000,10261,81205,91466,Brooklyn,11487294.49,East New York-City Line
19-Aug,36047122000,3122000,1414,122747,124161,Brooklyn,11487294.49,East New York-City Line
21-Aug,36047122000,3122000,1288,58233,59521,Brooklyn,11487294.49,East New York-City Line
19-May,36047123700,3123700,8811,115720,124531,Brooklyn,3459462.478,Bedford-Stuyvesant (West)
21-May,36047123700,3123700,1530,127015,128545,Brooklyn,3459462.478,Bedford-Stuyvesant (West)
19-Jun,36047123700,3123700,10738,129377,140115,Brooklyn,3459462.478,Bedford-Stuyvesant (West)
21-Jun,36047123700,3123700,11809,64702,76511,Brooklyn,3459462.478,Bedford-Stuyvesant (West)
19-Jul,36047123700,3123700,13809,78324,92133,Brooklyn,3459462.478,Bedford-Stuyvesant (West)
21-Jul,36047123700,3123700,7217,152025,159242,Brooklyn,3459462.478,Bedford-Stuyvesant (West)
19-Aug,36047123700,3123700,0,78479,78479,Brooklyn,3459462.478,Bedford-Stuyvesant (West)
21-Aug,36047123700,3123700,7948,71,8019,Brooklyn,3459462.478,Bedford-Stuyvesant (West)
19-May,36061014300,1014300,2245,82548,84793,Manhattan,38312378.8,Central Park
21-May,36061014300,1014300,6783,78197,84980,Manhattan,38312378.8,Central Park
19-Jun,36061014300,1014300,14295,18280,32575,Manhattan,38312378.8,Central Park
21-Jun,36061014300,1014300,7206,129716,136922,Manhattan,38312378.8,Central Park
19-Jul,36061014300,1014300,8678,60329,69007,Manhattan,38312378.8,Central Park
21-Jul,36061014300,1014300,15623,90051,105674,Manhattan,38312378.8,Central Park
19-Aug,36061014300,1014300,12341,49698,62039,Manhattan,38312378.8,Central Park
21-Aug,36061014300,1014300,10460,15746,26206,Manhattan,38312378.8,Central Park
19-May,36081032000,4032000,12351,58684,71035,Queens,11399298.87,Springfield Gardens (South)-Brookville
21-May,36081032000,4032000,9558,69187,78745,Queens,11399298.87,Springfield Gardens (South)-Brookville
19-Jun,36081032000,4032000,1174,51650,52824,Queens,11399298.87,Springfield Gardens (South)-Brookville
21-Jun,36081032000,4032000,3412,49081,52493,Queens,11399298.87,Springfield Gardens (South)-Brookville
19-Jul,36081032000,4032000,10358,132306,142664,Queens,11399298.87,Springfield Gardens (South)-Brookville
21-Jul,36081032000,4032000,17520,48629,66149,Queens,11399298.87,Springfield Gardens (South)-Brookville
19-Aug,36081032000,4032000,7875,127693,135568,Queens,11399298.87,Springfield Gardens (South)-Brookville
21-Aug,36081032000,4032000,7250,118184,125434,Queens,11399298.87,Springfield Gardens (South)-Brookville
19-May,36081068000,4068000,9297,77264,86561,Queens,8269995.744,Springfield Gardens (South)-Brookville
21-May,36081068000,4068000,9892,40830,50722,Queens,8269995.744,Springfield Gardens (South)-Brookville
19-Jun,36081068000,4068000,3621,104621,108242,Queens,8269995.744,Springfield Gardens (South)-Brookville
21-Jun,36081068000,4068000,10718,10644,21362,Queens,8269995.744,Springfield Gardens (South)-Brookville
19-Jul,36081068000,4068000,4302,36144,40446,Queens,8269995.744,Springfield Gardens (South)-Brookville
21-Jul,36081068000,4068000,9873,32057,41930,Queens,8269995.744,Springfield Gardens (South)-Brookville
19-Aug,36081068000,4068000,6156,73226,79382,Queens,8269995.744,Springfield Gardens (South)-Brookville
21-Aug,36081068000,4068000,8288,83558,91846,Queens,8269995.744,Springfield Gardens (South)-Brookville
19-May,36081048302,4048302,13818,91128,104946,Queens,1453031.968,Woodside
21-May,36081048302,4048302,11259,16901,28160,Queens,1453031.968,Woodside
19-Jun,36081048302,4048302,8313,50470,58783,Queens,1453031.968,Woodside
21-Jun,36081048302,4048302,199,71,270,Queens,1453031.968,Woodside
19-Jul,36081048302,4048302,3749,49792,53541,Queens,1453031.968,Woodside
21-Jul,36081048302,4048302,3829,69171,73000,Queens,1453031.968,Woodside
19-Aug,36081048302,4048302,13030,97925,110955,Queens,1453031.968,Woodside
21-Aug,36081048302,4048302,9550,151256,160806,Queens,1453031.968,Woodside
19-May,36005007100,2007100,14274,34794,49068,Bronx,2841852.308,Melrose
21-May,36005007100,2007100,7097,90106,97203,Bronx,2841852.308,Melrose
19-Jun,36005007100,2007100,10109,61970,72079,Bronx,2841852.308,Melrose
21-Jun,36005007100,2007100,5570,89478,95048,Bronx,2841852.308,Melrose
19-Jul,36005007100,2007100,13036,104646,117682,Bronx,2841852.308,Melrose
21-Jul,36005007100,2007100,11749,105506,117255,Bronx,2841852.308,Melrose
19-Aug,36005007100,2007100,9628,77635,87263,Bronx,2841852.308,Melrose
21-Aug,36005007100,2007100,6776,92556,99332,Bronx,2841852.308,Melrose
19-May,36005007500,2007500,6466,94318,100784,Bronx,2458741.057,Melrose
21-May,36005007500,2007500,1423,75109,76532,Bronx,2458741.057,Melrose
19-Jun,36005007500,2007500,6196,23073,29269,Bronx,2458741.057,Melrose
21-Jun,36005007500,2007500,3029,128573,131602,Bronx,2458741.057,Melrose
19-Jul,36005007500,2007500,7251,71,7322,Bronx,2458741.057,Melrose
21-Jul,36005007500,2007500,0,94075,94075,Bronx,2458741.057,Melrose
19-Aug,36005007500,2007500,12701,120645,133346,Bronx,2458741.057,Melrose
21-Aug,36005007500,2007500,1751,116962,118713,Bronx,2458741.057,Melrose
19-May,36005014100,2014100,3116,59914,63030,Bronx,1907232.525,Morrisania
21-May,36005014100,2014100,8074,82679,90753,Bronx,1907232.525,Morrisania
19-Jun,36005014100,2014100,12630,58083,70713,Bronx,1907232.525,Morrisania
21-Jun,36005014100,2014100,14224,16222,30446,Bronx,1907232.525,Morrisania
19-Jul,36005014100,2014100,5406,87826,93232,Bronx,1907232.525,Morrisania
21-Jul,36005014100,2014100,3270,88901,92171,Bronx,1907232.525,Morrisania
19-Aug,36005014100,2014100,7936,117146,125082,Bronx,1907232.525,Morrisania
21-Aug,36005014100,2014100,16855,40175,57030,Bronx,1907232.525,Morrisania
19-May,36081024500,4024500,2957,54484,57441,Queens,2774851.733,Woodside
21-May,36081024500,4024500,11924,95742,107666,Queens,2774851.733,Woodside
19-Jun,36081024500,4024500,8801,112002,120803,Queens,2774851.733,Woodside
21-Jun,36081024500,4024500,18267,82583,100850,Queens,2774851.733,Woodside
19-Jul,36081024500,4024500,16672,104600,121272,Queens,2774851.733,Woodside
21-Jul,36081024500,4024500,12236,83590,95826,Queens,2774851.733,Woodside
19-Aug,36081024500,4024500,12263,13694,25957,Queens,2774851.733,Woodside
21-Aug,36081024500,4024500,6826,38414,45240,Queens,2774851.733,Woodside
19-May,36081024700,4024700,7022,35910,42932,Queens,1050662.081,Woodside
21-May,36081024700,4024700,16037,21048,37085,Queens,1050662.081,Woodside
19-Jun,36081024700,4024700,4726,107476,112202,Queens,1050662.081,Woodside
21-Jun,36081024700,4024700,10273,118116,128389,Queens,1050662.081,Woodside
19-Jul,36081024700,4024700,11967,124885,136852,Queens,1050662.081,Woodside
21-Jul,36081024700,4024700,4198,51594,55792,Queens,1050662.081,Woodside
19-Aug,36081024700,4024700,7352,106784,114136,Queens,1050662.081,Woodside
21-Aug,36081024700,4024700,7402,64607,72009,Queens,1050662.081,Woodside
19-May,36085014606,5014606,8501,47989,56490,Staten Island,19044545.85,Great Kills-Eltingville
21-May,36085014606,5014606,5495,83394,88889,Staten Island,19044545.85,Great Kills-Eltingville
19-Jun,36085014606,5014606,7165,118620,125785,Staten Island,19044545.85,Great Kills-Eltingville
21-Jun,36085014606,5014606,10675,63703,74378,Staten Island,19044545.85,Great Kills-Eltingville
19-Jul,36085014606,5014606,6918,100184,107102,Staten Island,19044545.85,Great Kills-Eltingville
21-Jul,36085014606,5014606,16826,78168,94994,Staten Island,19044545.85,Great Kills-Eltingville
19-Aug,36085014606,5014606,11338,22467,33805,Staten Island,19044545.85,Great Kills-Eltingville
21-Aug,36085014606,5014606,14588,89312,103900,Staten Island,19044545.85,Great Kills-Eltingville
19-May,36047007500,3007500,4836,109100,113936,Brooklyn,3052490.568,Carroll Gardens-Cobble Hill-Gowanus-Red Hook
21-May,36047007500,3007500,12772,43182,55954,Brooklyn,3052490.568,Carroll Gardens-Cobble Hill-Gowanus-Red Hook
19-Jun,36047007500,3007500,8123,80568,88691,Brooklyn,3052490.568,Carroll Gardens-Cobble Hill-Gowanus-Red Hook
21-Jun,36047007500,3007500,18294,141378,159672,Brooklyn,3052490.568,Carroll Gardens-Cobble Hill-Gowanus-Red Hook
19-Jul,36047007500,3007500,12049,58463,70512,Brooklyn,3052490.568,Carroll Gardens-Cobble Hill-Gowanus-Red Hook
21-Jul,36047007500,3007500,17573,73991,91564,Brooklyn,3052490.568,Carroll Gardens-Cobble Hill-Gowanus-Red Hook
19-Aug,36047007500,3007500,12209,120060,132269,Brooklyn,3052490.568,Carroll Gardens-Cobble Hill-Gowanus-Red Hook
21-Aug,36047007500,3007500,16213,50475,66688,Brooklyn,3052490.568,Carroll Gardens-Cobble Hill-Gowanus-Red Hook
19-May,36047007700,3007700,7539,78011,85550,Brooklyn,4166505.206,Carroll Gardens-Cobble Hill-Gowanus-Red Hook
21-May,36047007700,3007700,10969,116547,127516,Brooklyn,4166505.206,Carroll Gardens-Cobble Hill-Gowanus-Red Hook
19-Jun,36047007700,3007700,11907,88657,100564,Brooklyn,4166505.206,Carroll Gardens-Cobble Hill-Gowanus-Red Hook
21-Jun,36047007700,3007700,11585,51719,63304,Brooklyn,4166505.206,Carroll Gardens-Cobble Hill-Gowanus-Red Hook
19-Jul,36047007700,3007700,1807,23868,25675,Brooklyn,4166505.206,Carroll Gardens-Cobble Hill-Gowanus-Red Hook
21-Jul,36047007700,3007700,8453,105183,113636,Brooklyn,4166505.206,Carroll Gardens-Cobble Hill-Gowanus-Red Hook
19-Aug,36047007700,3007700,8169,120146,128315,Brooklyn,4166505.206,Carroll Gardens-Cobble Hill-Gowanus-Red Hook
21-Aug,36047007700,3007700,7858,112862,120720,Brooklyn,4166505.206,Carroll Gardens-Cobble Hill-Gowanus-Red Hook
19-May,36081056800,4056800,6866,57470,64336,Queens,9137102.916,Queens Village
21-May,36081056800,4056800,0,71,71,Queens,9137102.916,Queens Village
19-Jun,36081056800,4056800,2876,71,2947,Queens,9137102.916,Queens Village
21-Jun,36081056800,4056800,3186,123491,126677,Queens,9137102.916,Queens Village
19-Jul,36081056800,4056800,163,150880,151043,Queens,9137102.916,Queens Village
21-Jul,36081056800,4056800,2486,78822,81308,Queens,9137102.916,Queens Village
19-Aug,36081056800,4056800,5280,51456,56736,Queens,9137102.916,Queens Village
21-Aug,36081056800,4056800,0,107305,107305,Queens,9137102.916,Queens Village
19-May,36081058000,4058000,6966,14465,21431,Queens,5917020.359,Queens Village
21-May,36081058000,4058000,9273,79328,88601,Queens,5917020.359,Queens Village
19-Jun,36081058000,4058000,11344,69536,80880,Queens,5917020.359,Queens Village
21-Jun,36081058000,4058000,6639,57884,64523,Queens,5917020.359,Queens Village
19-Jul,36081058000,4058000,12696,114416,127112,Queens,5917020.359,Queens Village
21-Jul,36081058000,4058000,1549,67948,69497,Queens,5917020.359,Queens Village
19-Aug,36081058000,4058000,2610,71,2681,Queens,5917020.359,Queens Village
21-Aug,36081058000,4058000,10345,13548,23893,Queens,5917020.359,Queens Village
19-May,36081013700,4013700,8790,36062,44852,Queens,2153336.397,Astoria (North)-Ditmars-Steinway
21-May,36081013700,4013700,20822,16717,37539,Queens,2153336.397,Astoria (North)-Ditmars-Steinway
19-Jun,36081013700,4013700,12676,129522,142198,Queens,2153336.397,Astoria (North)-Ditmars-Steinway
21-Jun,36081013700,4013700,8543,99134,107677,Queens,2153336.397,Astoria (North)-Ditmars-Steinway
19-Jul,36081013700,4013700,5969,68546,74515,Queens,2153336.397,Astoria (North)-Ditmars-Steinway
21-Jul,36081013700,4013700,4275,71,4346,Queens,2153336.397,Astoria (North)-Ditmars-Steinway
19-Aug,36081013700,4013700,8800,32412,41212,Queens,2153336.397,Astoria (North)-Ditmars-Steinway
21-Aug,36081013700,4013700,8039,155143,163182,Queens,2153336.397,Astoria (North)-Ditmars-Steinway
19-May,36081014100,4014100,11938,51769,63707,Queens,1841152.958,Astoria (East)-Woodside (North)
21-May,36081014100,4014100,0,79489,79489,Queens,1841152.958,Astoria (East)-Woodside (North)
19-Jun,36081014100,4014100,4697,61124,65821,Queens,1841152.958,Astoria (East)-Woodside (North)
21-Jun,36081014100,4014100,0,21817,21817,Queens,1841152.958,Astoria (East)-Woodside (North)
19-Jul,36081014100,4014100,7230,99350,106580,Queens,1841152.958,Astoria (East)-Woodside (North)
21-Jul,36081014100,4014100,8059,55344,63403,Queens,1841152.958,Astoria (East)-Woodside (North)
19-Aug,36081014100,4014100,13948,36150,50098,Queens,1841152.958,Astoria (East)-Woodside (North)
21-Aug,36081014100,4014100,9910,61031,70941,Queens,1841152.958,Astoria (East)-Woodside (North)
19-May,36047105804,3105804,3249,96161,99410,Brooklyn,7126198.474,Spring Creek-Starrett City
21-May,36047105804,3105804,7716,44382,52098,Brooklyn,7126198.474,Spring Creek-Starrett City
19-Jun,36047105804,3105804,8188,8943,17131,Brooklyn,7126198.474,Spring Creek-Starrett City
21-Jun,36047105804,3105804,0,26317,26317,Brooklyn,7126198.474,Spring Creek-Starrett City
19-Jul,36047105804,3105804,12130,109873,122003,Brooklyn,7126198.474,Spring Creek-Starrett City
21-Jul,36047105804,3105804,10407,74029,84436,Brooklyn,7126198.474,Spring Creek-Starrett City
19-Aug,36047105804,3105804,4836,20685,25521,Brooklyn,7126198.474,Spring Creek-Starrett City
21-Aug,36047105804,3105804,11776,44686,56462,Brooklyn,7126198.474,Spring Creek-Starrett City
19-May,36047107002,3107002,1998,71,2069,Brooklyn,18284900.85,Shirley Chisholm State Park
21-May,36047107002,3107002,3354,17648,21002,Brooklyn,18284900.85,Shirley Chisholm State Park
19-Jun,36047107002,3107002,8297,49626,57923,Brooklyn,18284900.85,Shirley Chisholm State Park
21-Jun,36047107002,3107002,6081,33724,39805,Brooklyn,18284900.85,Shirley Chisholm State Park
19-Jul,36047107002,3107002,0,46886,46886,Brooklyn,18284900.85,Shirley Chisholm State Park
21-Jul,36047107002,3107002,6483,115175,121658,Brooklyn,18284900.85,Shirley Chisholm State Park
19-Aug,36047107002,3107002,8180,94914,103094,Brooklyn,18284900.85,Shirley Chisholm State Park
21-Aug,36047107002,3107002,7826,97538,105364,Brooklyn,18284900.85,Shirley Chisholm State Park
19-May,36005037600,2037600,8197,109552,117749,Bronx,1341410.751,Williamsbridge-Olinville
21-May,36005037600,2037600,3474,91969,95443,Bronx,1341410.751,Williamsbridge-Olinville
19-Jun,36005037600,2037600,6408,141999,148407,Bronx,1341410.751,Williamsbridge-Olinville
21-Jun,36005037600,2037600,4864,73548,78412,Bronx,1341410.751,Williamsbridge-Olinville
19-Jul,36005037600,2037600,18113,65664,83777,Bronx,1341410.751,Williamsbridge-Olinville
21-Jul,36005037600,2037600,14894,56959,71853,Bronx,1341410.751,Williamsbridge-Olinville
19-Aug,36005037600,2037600,14423,116255,130678,Bronx,1341410.751,Williamsbridge-Olinville
21-Aug,36005037600,2037600,8789,149476,158265,Bronx,1341410.751,Williamsbridge-Olinville
19-May,36005017300,2017300,6246,127787,134033,Bronx,1774072.447,Concourse-Concourse Village
21-May,36005017300,2017300,21140,26542,47682,Bronx,1774072.447,Concourse-Concourse Village
19-Jun,36005017300,2017300,0,28321,28321,Bronx,1774072.447,Concourse-Concourse Village
21-Jun,36005017300,2017300,12611,101437,114048,Bronx,1774072.447,Concourse-Concourse Village
19-Jul,36005017300,2017300,8360,56479,64839,Bronx,1774072.447,Concourse-Concourse Village
21-Jul,36005017300,2017300,2670,66910,69580,Bronx,1774072.447,Concourse-Concourse Village
19-Aug,36005017300,2017300,5134,28853,33987,Bronx,1774072.447,Concourse-Concourse Village
21-Aug,36005017300,2017300,8785,135763,144548,Bronx,1774072.447,Concourse-Concourse Village
19-May,36005034500,2034500,14131,69372,83503,Bronx,2966149.46,Riverdale-Spuyten Duyvil
21-May,36005034500,2034500,10795,52802,63597,Bronx,2966149.46,Riverdale-Spuyten Duyvil
19-Jun,36005034500,2034500,6133,137309,143442,Bronx,2966149.46,Riverdale-Spuyten Duyvil
21-Jun,36005034500,2034500,9291,55973,65264,Bronx,2966149.46,Riverdale-Spuyten Duyvil
19-Jul,36005034500,2034500,4535,55656,60191,Bronx,2966149.46,Riverdale-Spuyten Duyvil
21-Jul,36005034500,2034500,5611,269,5880,Bronx,2966149.46,Riverdale-Spuyten Duyvil
19-Aug,36005034500,2034500,15265,75852,91117,Bronx,2966149.46,Riverdale-Spuyten Duyvil
21-Aug,36005034500,2034500,8332,37034,45366,Bronx,2966149.46,Riverdale-Spuyten Duyvil
19-May,36081051100,4051100,2624,32875,35499,Queens,2951354.89,Maspeth
21-May,36081051100,4051100,3846,71,3917,Queens,2951354.89,Maspeth
19-Jun,36081051100,4051100,3645,99309,102954,Queens,2951354.89,Maspeth
21-Jun,36081051100,4051100,7885,71070,78955,Queens,2951354.89,Maspeth
19-Jul,36081051100,4051100,8606,22198,30804,Queens,2951354.89,Maspeth
21-Jul,36081051100,4051100,12714,117104,129818,Queens,2951354.89,Maspeth
19-Aug,36081051100,4051100,6798,78788,85586,Queens,2951354.89,Maspeth
21-Aug,36081051100,4051100,2791,118781,121572,Queens,2951354.89,Maspeth
19-May,36081060701,4060701,18329,118307,136636,Queens,7642767.926,Mount Olivet & All Faiths Cemeteries
21-May,36081060701,4060701,5226,67919,73145,Queens,7642767.926,Mount Olivet & All Faiths Cemeteries
19-Jun,36081060701,4060701,12619,50746,63365,Queens,7642767.926,Mount Olivet & All Faiths Cemeteries
21-Jun,36081060701,4060701,5297,78733,84030,Queens,7642767.926,Mount Olivet & All Faiths Cemeteries
19-Jul,36081060701,4060701,22216,71,22287,Queens,7642767.926,Mount Olivet & All Faiths Cemeteries
21-Jul,36081060701,4060701,7535,88970,96505,Queens,7642767.926,Mount Olivet & All Faiths Cemeteries
19-Aug,36081060701,4060701,3312,39093,42405,Queens,7642767.926,Mount Olivet & All Faiths Cemeteries
21-Aug,36081060701,4060701,12507,80353,92860,Queens,7642767.926,Mount Olivet & All Faiths Cemeteries
19-May,36005003700,2003700,9734,31281,41015,Bronx,1787327.439,Mott Haven-Port Morris
21-May,36005003700,2003700,7604,61865,69469,Bronx,1787327.439,Mott Haven-Port Morris
19-Jun,36005003700,2003700,5658,46264,51922,Bronx,1787327.439,Mott Haven-Port Morris
21-Jun,36005003700,2003700,7981,40060,48041,Bronx,1787327.439,Mott Haven-Port Morris
19-Jul,36005003700,2003700,5657,112096,117753,Bronx,1787327.439,Mott Haven-Port Morris
21-Jul,36005003700,2003700,7060,168800,175860,Bronx,1787327.439,Mott Haven-Port Morris
19-Aug,36005003700,2003700,9102,64375,73477,Bronx,1787327.439,Mott Haven-Port Morris
21-Aug,36005003700,2003700,8155,107255,115410,Bronx,1787327.439,Mott Haven-Port Morris
19-May,36061014700,1014700,9549,203089,212638,Manhattan,703936.2042,Upper West Side-Lincoln Square
21-May,36061014700,1014700,375,75085,75460,Manhattan,703936.2042,Upper West Side-Lincoln Square
19-Jun,36061014700,1014700,4949,54642,59591,Manhattan,703936.2042,Upper West Side-Lincoln Square
21-Jun,36061014700,1014700,9672,3808,13480,Manhattan,703936.2042,Upper West Side-Lincoln Square
19-Jul,36061014700,1014700,8376,91497,99873,Manhattan,703936.2042,Upper West Side-Lincoln Square
21-Jul,36061014700,1014700,7754,13263,21017,Manhattan,703936.2042,Upper West Side-Lincoln Square
19-Aug,36061014700,1014700,3151,76021,79172,Manhattan,703936.2042,Upper West Side-Lincoln Square
21-Aug,36061014700,1014700,9313,13498,22811,Manhattan,703936.2042,Upper West Side-Lincoln Square
19-May,36061015102,1015102,11090,103833,114923,Manhattan,2391493.146,Upper West Side-Lincoln Square
21-May,36061015102,1015102,0,79354,79354,Manhattan,2391493.146,Upper West Side-Lincoln Square
19-Jun,36061015102,1015102,8508,25050,33558,Manhattan,2391493.146,Upper West Side-Lincoln Square
21-Jun,36061015102,1015102,17634,36792,54426,Manhattan,2391493.146,Upper West Side-Lincoln Square
19-Jul,36061015102,1015102,8455,83035,91490,Manhattan,2391493.146,Upper West Side-Lincoln Square
21-Jul,36061015102,1015102,10759,67886,78645,Manhattan,2391493.146,Upper West Side-Lincoln Square
19-Aug,36061015102,1015102,9507,43140,52647,Manhattan,2391493.146,Upper West Side-Lincoln Square
21-Aug,36061015102,1015102,12908,47327,60235,Manhattan,2391493.146,Upper West Side-Lincoln Square
19-May,36061008601,1008601,12569,56628,69197,Manhattan,1239411.117,Murray Hill-Kips Bay
21-May,36061008601,1008601,16249,115899,132148,Manhattan,1239411.117,Murray Hill-Kips Bay
19-Jun,36061008601,1008601,0,32408,32408,Manhattan,1239411.117,Murray Hill-Kips Bay
21-Jun,36061008601,1008601,7134,104415,111549,Manhattan,1239411.117,Murray Hill-Kips Bay
19-Jul,36061008601,1008601,11419,77571,88990,Manhattan,1239411.117,Murray Hill-Kips Bay
21-Jul,36061008601,1008601,13153,61932,75085,Manhattan,1239411.117,Murray Hill-Kips Bay
19-Aug,36061008601,1008601,4306,44093,48399,Manhattan,1239411.117,Murray Hill-Kips Bay
21-Aug,36061008601,1008601,14942,142223,157165,Manhattan,1239411.117,Murray Hill-Kips Bay
19-May,36061008800,1008800,11626,28217,39843,Manhattan,1929071.601,Murray Hill-Kips Bay
21-May,36061008800,1008800,7834,17068,24902,Manhattan,1929071.601,Murray Hill-Kips Bay
19-Jun,36061008800,1008800,1861,38690,40551,Manhattan,1929071.601,Murray Hill-Kips Bay
21-Jun,36061008800,1008800,4163,167898,172061,Manhattan,1929071.601,Murray Hill-Kips Bay
19-Jul,36061008800,1008800,14015,95544,109559,Manhattan,1929071.601,Murray Hill-Kips Bay
21-Jul,36061008800,1008800,16517,108419,124936,Manhattan,1929071.601,Murray Hill-Kips Bay
19-Aug,36061008800,1008800,15556,78536,94092,Manhattan,1929071.601,Murray Hill-Kips Bay
21-Aug,36061008800,1008800,12051,88051,100102,Manhattan,1929071.601,Murray Hill-Kips Bay
19-May,36005022000,2022000,10333,93954,104287,Bronx,2460400.778,West Farms
21-May,36005022000,2022000,3813,95253,99066,Bronx,2460400.778,West Farms
19-Jun,36005022000,2022000,8805,102240,111045,Bronx,2460400.778,West Farms
21-Jun,36005022000,2022000,10484,45096,55580,Bronx,2460400.778,West Farms
19-Jul,36005022000,2022000,0,34205,34205,Bronx,2460400.778,West Farms
21-Jul,36005022000,2022000,5611,79961,85572,Bronx,2460400.778,West Farms
19-Aug,36005022000,2022000,9833,62262,72095,Bronx,2460400.778,West Farms
21-Aug,36005022000,2022000,9121,122009,131130,Bronx,2460400.778,West Farms
19-May,36061008602,1008602,14443,26163,40606,Manhattan,1091249.97,United Nations
21-May,36061008602,1008602,12420,46716,59136,Manhattan,1091249.97,United Nations
19-Jun,36061008602,1008602,8136,107515,115651,Manhattan,1091249.97,United Nations
21-Jun,36061008602,1008602,12812,71,12883,Manhattan,1091249.97,United Nations
19-Jul,36061008602,1008602,7980,66077,74057,Manhattan,1091249.97,United Nations
21-Jul,36061008602,1008602,7764,60625,68389,Manhattan,1091249.97,United Nations
19-Aug,36061008602,1008602,11799,73962,85761,Manhattan,1091249.97,United Nations
21-Aug,36061008602,1008602,11650,72646,84296,Manhattan,1091249.97,United Nations
19-May,36047050803,3050803,10300,50176,60476,Brooklyn,602995.59,Flatbush
21-May,36047050803,3050803,5949,111945,117894,Brooklyn,602995.59,Flatbush
19-Jun,36047050803,3050803,14256,34170,48426,Brooklyn,602995.59,Flatbush
21-Jun,36047050803,3050803,9017,47793,56810,Brooklyn,602995.59,Flatbush
19-Jul,36047050803,3050803,8865,102665,111530,Brooklyn,602995.59,Flatbush
21-Jul,36047050803,3050803,1503,71,1574,Brooklyn,602995.59,Flatbush
19-Aug,36047050803,3050803,9489,29377,38866,Brooklyn,602995.59,Flatbush
21-Aug,36047050803,3050803,6303,163282,169585,Brooklyn,602995.59,Flatbush
19-May,36047079802,3079802,0,70612,70612,Brooklyn,1145198.831,Prospect Lefferts Gardens-Wingate
21-May,36047079802,3079802,18625,77478,96103,Brooklyn,1145198.831,Prospect Lefferts Gardens-Wingate
19-Jun,36047079802,3079802,10556,84812,95368,Brooklyn,1145198.831,Prospect Lefferts Gardens-Wingate
21-Jun,36047079802,3079802,6042,193206,199248,Brooklyn,1145198.831,Prospect Lefferts Gardens-Wingate
19-Jul,36047079802,3079802,10650,122831,133481,Brooklyn,1145198.831,Prospect Lefferts Gardens-Wingate
21-Jul,36047079802,3079802,3649,96707,100356,Brooklyn,1145198.831,Prospect Lefferts Gardens-Wingate
19-Aug,36047079802,3079802,8877,24405,33282,Brooklyn,1145198.831,Prospect Lefferts Gardens-Wingate
21-Aug,36047079802,3079802,6983,120127,127110,Brooklyn,1145198.831,Prospect Lefferts Gardens-Wingate
19-May,36005006100,2006100,3659,153817,157476,Bronx,2613468.908,Concourse-Concourse Village
21-May,36005006100,2006100,12336,63723,76059,Bronx,2613468.908,Concourse-Concourse Village
19-Jun,36005006100,2006100,9688,134704,144392,Bronx,2613468.908,Concourse-Concourse Village
21-Jun,36005006100,2006100,14559,11620,26179,Bronx,2613468.908,Concourse-Concourse Village
19-Jul,36005006100,2006100,1028,68413,69441,Bronx,2613468.908,Concourse-Concourse Village
21-Jul,36005006100,2006100,8038,10719,18757,Bronx,2613468.908,Concourse-Concourse Village
19-Aug,36005006100,2006100,6445,58477,64922,Bronx,2613468.908,Concourse-Concourse Village
21-Aug,36005006100,2006100,1414,59708,61122,Bronx,2613468.908,Concourse-Concourse Village
19-May,36061029900,1029900,12020,55620,67640,Manhattan,6678107.675,Inwood
21-May,36061029900,1029900,6002,74581,80583,Manhattan,6678107.675,Inwood
19-Jun,36061029900,1029900,6868,76643,83511,Manhattan,6678107.675,Inwood
21-Jun,36061029900,1029900,16480,115762,132242,Manhattan,6678107.675,Inwood
19-Jul,36061029900,1029900,13097,72379,85476,Manhattan,6678107.675,Inwood
21-Jul,36061029900,1029900,13069,72002,85071,Manhattan,6678107.675,Inwood
19-Aug,36061029900,1029900,12013,71,12084,Manhattan,6678107.675,Inwood
21-Aug,36061029900,1029900,17301,105042,122343,Manhattan,6678107.675,Inwood
19-May,36047152200,3152200,12364,75697,88061,Brooklyn,4196763.282,Flatbush (West)-Ditmas Park-Parkville
21-May,36047152200,3152200,8418,72269,80687,Brooklyn,4196763.282,Flatbush (West)-Ditmas Park-Parkville
19-Jun,36047152200,3152200,8464,22079,30543,Brooklyn,4196763.282,Flatbush (West)-Ditmas Park-Parkville
21-Jun,36047152200,3152200,9860,16160,26020,Brooklyn,4196763.282,Flatbush (West)-Ditmas Park-Parkville
19-Jul,36047152200,3152200,14782,6667,21449,Brooklyn,4196763.282,Flatbush (West)-Ditmas Park-Parkville
21-Jul,36047152200,3152200,10278,105769,116047,Brooklyn,4196763.282,Flatbush (West)-Ditmas Park-Parkville
19-Aug,36047152200,3152200,17473,71,17544,Brooklyn,4196763.282,Flatbush (West)-Ditmas Park-Parkville
21-Aug,36047152200,3152200,10967,85386,96353,Brooklyn,4196763.282,Flatbush (West)-Ditmas Park-Parkville
19-May,36005005300,2005300,21816,69402,91218,Bronx,908149.4422,University Heights (South)-Morris Heights
21-May,36005005300,2005300,10761,122645,133406,Bronx,908149.4422,University Heights (South)-Morris Heights
19-Jun,36005005300,2005300,11977,102414,114391,Bronx,908149.4422,University Heights (South)-Morris Heights
21-Jun,36005005300,2005300,8430,74687,83117,Bronx,908149.4422,University Heights (South)-Morris Heights
19-Jul,36005005300,2005300,12070,7431,19501,Bronx,908149.4422,University Heights (South)-Morris Heights
21-Jul,36005005300,2005300,715,71,786,Bronx,908149.4422,University Heights (South)-Morris Heights
19-Aug,36005005300,2005300,11083,103320,114403,Bronx,908149.4422,University Heights (South)-Morris Heights
21-Aug,36005005300,2005300,8866,106699,115565,Bronx,908149.4422,University Heights (South)-Morris Heights
19-May,36081060300,4060300,11703,77818,89521,Queens,1952653.296,Maspeth
21-May,36081060300,4060300,13869,76692,90561,Queens,1952653.296,Maspeth
19-Jun,36081060300,4060300,7411,57191,64602,Queens,1952653.296,Maspeth
21-Jun,36081060300,4060300,15209,49146,64355,Queens,1952653.296,Maspeth
19-Jul,36081060300,4060300,6083,51741,57824,Queens,1952653.296,Maspeth
21-Jul,36081060300,4060300,14230,43337,57567,Queens,1952653.296,Maspeth
19-Aug,36081060300,4060300,5353,59339,64692,Queens,1952653.296,Maspeth
21-Aug,36081060300,4060300,13322,95228,108550,Queens,1952653.296,Maspeth
19-May,36081061301,4061301,17836,80789,98625,Queens,7603813.651,Ridgewood
21-May,36081061301,4061301,2554,28187,30741,Queens,7603813.651,Ridgewood
19-Jun,36081061301,4061301,10894,78060,88954,Queens,7603813.651,Ridgewood
21-Jun,36081061301,4061301,8156,60836,68992,Queens,7603813.651,Ridgewood
19-Jul,36081061301,4061301,14778,125874,140652,Queens,7603813.651,Ridgewood
21-Jul,36081061301,4061301,6630,99272,105902,Queens,7603813.651,Ridgewood
19-Aug,36081061301,4061301,12728,71422,84150,Queens,7603813.651,Ridgewood
21-Aug,36081061301,4061301,15520,61744,77264,Queens,7603813.651,Ridgewood
19-May,36081089201,4089201,8596,54711,63307,Queens,19157615.49,Howard Beach-Lindenwood
21-May,36081089201,4089201,9864,34388,44252,Queens,19157615.49,Howard Beach-Lindenwood
19-Jun,36081089201,4089201,9235,134898,144133,Queens,19157615.49,Howard Beach-Lindenwood
21-Jun,36081089201,4089201,13239,70507,83746,Queens,19157615.49,Howard Beach-Lindenwood
19-Jul,36081089201,4089201,15750,101313,117063,Queens,19157615.49,Howard Beach-Lindenwood
21-Jul,36081089201,4089201,3712,37332,41044,Queens,19157615.49,Howard Beach-Lindenwood
19-Aug,36081089201,4089201,19716,33256,52972,Queens,19157615.49,Howard Beach-Lindenwood
21-Aug,36081089201,4089201,7930,40151,48081,Queens,19157615.49,Howard Beach-Lindenwood
19-May,36081006201,4006201,12194,83894,96088,Queens,4332014.272,Howard Beach-Lindenwood
21-May,36081006201,4006201,5654,84104,89758,Queens,4332014.272,Howard Beach-Lindenwood
19-Jun,36081006201,4006201,9592,99359,108951,Queens,4332014.272,Howard Beach-Lindenwood
21-Jun,36081006201,4006201,5575,94323,99898,Queens,4332014.272,Howard Beach-Lindenwood
19-Jul,36081006201,4006201,5696,102691,108387,Queens,4332014.272,Howard Beach-Lindenwood
21-Jul,36081006201,4006201,10149,78577,88726,Queens,4332014.272,Howard Beach-Lindenwood
19-Aug,36081006201,4006201,2757,715,3472,Queens,4332014.272,Howard Beach-Lindenwood
21-Aug,36081006201,4006201,13132,94077,107209,Queens,4332014.272,Howard Beach-Lindenwood
19-May,36081088400,4088400,9679,51769,61448,Queens,16672406.6,Howard Beach-Lindenwood
21-May,36081088400,4088400,8211,71,8282,Queens,16672406.6,Howard Beach-Lindenwood
19-Jun,36081088400,4088400,1192,19201,20393,Queens,16672406.6,Howard Beach-Lindenwood
21-Jun,36081088400,4088400,3178,117864,121042,Queens,16672406.6,Howard Beach-Lindenwood
19-Jul,36081088400,4088400,0,113601,113601,Queens,16672406.6,Howard Beach-Lindenwood
21-Jul,36081088400,4088400,8149,148615,156764,Queens,16672406.6,Howard Beach-Lindenwood
19-Aug,36081088400,4088400,5223,78203,83426,Queens,16672406.6,Howard Beach-Lindenwood
21-Aug,36081088400,4088400,4442,124558,129000,Queens,16672406.6,Howard Beach-Lindenwood
19-May,36005018301,2018301,10637,21860,32497,Bronx,719418.2611,Concourse-Concourse Village
21-May,36005018301,2018301,11046,91473,102519,Bronx,719418.2611,Concourse-Concourse Village
19-Jun,36005018301,2018301,0,139393,139393,Bronx,719418.2611,Concourse-Concourse Village
21-Jun,36005018301,2018301,5533,115240,120773,Bronx,719418.2611,Concourse-Concourse Village
19-Jul,36005018301,2018301,11453,84691,96144,Bronx,719418.2611,Concourse-Concourse Village
21-Jul,36005018301,2018301,10762,80563,91325,Bronx,719418.2611,Concourse-Concourse Village
19-Aug,36005018301,2018301,11875,99932,111807,Bronx,719418.2611,Concourse-Concourse Village
21-Aug,36005018301,2018301,3119,120240,123359,Bronx,719418.2611,Concourse-Concourse Village
19-May,36005019500,2019500,8560,8183,16743,Bronx,2376401.338,Concourse-Concourse Village
21-May,36005019500,2019500,4530,15897,20427,Bronx,2376401.338,Concourse-Concourse Village
19-Jun,36005019500,2019500,9418,94071,103489,Bronx,2376401.338,Concourse-Concourse Village
21-Jun,36005019500,2019500,7467,75726,83193,Bronx,2376401.338,Concourse-Concourse Village
19-Jul,36005019500,2019500,11445,43072,54517,Bronx,2376401.338,Concourse-Concourse Village
21-Jul,36005019500,2019500,10302,43272,53574,Bronx,2376401.338,Concourse-Concourse Village
19-Aug,36005019500,2019500,9873,85123,94996,Bronx,2376401.338,Concourse-Concourse Village
21-Aug,36005019500,2019500,2842,104241,107083,Bronx,2376401.338,Concourse-Concourse Village
19-May,36005005902,2005902,5488,118432,123920,Bronx,764814.5639,Concourse-Concourse Village
21-May,36005005902,2005902,15840,130528,146368,Bronx,764814.5639,Concourse-Concourse Village
19-Jun,36005005902,2005902,15780,90245,106025,Bronx,764814.5639,Concourse-Concourse Village
21-Jun,36005005902,2005902,8312,48616,56928,Bronx,764814.5639,Concourse-Concourse Village
19-Jul,36005005902,2005902,10348,58468,68816,Bronx,764814.5639,Concourse-Concourse Village
21-Jul,36005005902,2005902,7534,70761,78295,Bronx,764814.5639,Concourse-Concourse Village
19-Aug,36005005902,2005902,0,107617,107617,Bronx,764814.5639,Concourse-Concourse Village
21-Aug,36005005902,2005902,8419,96863,105282,Bronx,764814.5639,Concourse-Concourse Village
19-May,36085014604,5014604,7503,134169,141672,Staten Island,12148066.18,Great Kills-Eltingville
21-May,36085014604,5014604,1937,59280,61217,Staten Island,12148066.18,Great Kills-Eltingville
19-Jun,36085014604,5014604,0,61034,61034,Staten Island,12148066.18,Great Kills-Eltingville
21-Jun,36085014604,5014604,11846,115934,127780,Staten Island,12148066.18,Great Kills-Eltingville
19-Jul,36085014604,5014604,11179,65439,76618,Staten Island,12148066.18,Great Kills-Eltingville
21-Jul,36085014604,5014604,8171,30987,39158,Staten Island,12148066.18,Great Kills-Eltingville
19-Aug,36085014604,5014604,8420,55624,64044,Staten Island,12148066.18,Great Kills-Eltingville
21-Aug,36085014604,5014604,9656,51028,60684,Staten Island,12148066.18,Great Kills-Eltingville
19-May,36085014605,5014605,2856,78270,81126,Staten Island,9497529.12,Great Kills-Eltingville
21-May,36085014605,5014605,2285,123536,125821,Staten Island,9497529.12,Great Kills-Eltingville
19-Jun,36085014605,5014605,20360,134521,154881,Staten Island,9497529.12,Great Kills-Eltingville
21-Jun,36085014605,5014605,14864,42374,57238,Staten Island,9497529.12,Great Kills-Eltingville
19-Jul,36085014605,5014605,1062,132042,133104,Staten Island,9497529.12,Great Kills-Eltingville
21-Jul,36085014605,5014605,14620,86924,101544,Staten Island,9497529.12,Great Kills-Eltingville
19-Aug,36085014605,5014605,6512,50116,56628,Staten Island,9497529.12,Great Kills-Eltingville
21-Aug,36085014605,5014605,11826,71006,82832,Staten Island,9497529.12,Great Kills-Eltingville
19-May,36085005901,5005901,9740,86607,96347,Staten Island,10114541.5,West New Brighton-Silver Lake-Grymes Hill
21-May,36085005901,5005901,20328,95062,115390,Staten Island,10114541.5,West New Brighton-Silver Lake-Grymes Hill
19-Jun,36085005901,5005901,11146,97191,108337,Staten Island,10114541.5,West New Brighton-Silver Lake-Grymes Hill
21-Jun,36085005901,5005901,15470,138537,154007,Staten Island,10114541.5,West New Brighton-Silver Lake-Grymes Hill
19-Jul,36085005901,5005901,18981,81833,100814,Staten Island,10114541.5,West New Brighton-Silver Lake-Grymes Hill
21-Jul,36085005901,5005901,7324,106582,113906,Staten Island,10114541.5,West New Brighton-Silver Lake-Grymes Hill
19-Aug,36085005901,5005901,9216,94123,103339,Staten Island,10114541.5,West New Brighton-Silver Lake-Grymes Hill
21-Aug,36085005901,5005901,6383,126739,133122,Staten Island,10114541.5,West New Brighton-Silver Lake-Grymes Hill
19-May,36047051200,3051200,5281,498,5779,Brooklyn,1506254.077,Flatbush
21-May,36047051200,3051200,10945,71,11016,Brooklyn,1506254.077,Flatbush
19-Jun,36047051200,3051200,5362,156544,161906,Brooklyn,1506254.077,Flatbush
21-Jun,36047051200,3051200,6751,122431,129182,Brooklyn,1506254.077,Flatbush
19-Jul,36047051200,3051200,9988,15376,25364,Brooklyn,1506254.077,Flatbush
21-Jul,36047051200,3051200,10531,101636,112167,Brooklyn,1506254.077,Flatbush
19-Aug,36047051200,3051200,3964,58367,62331,Brooklyn,1506254.077,Flatbush
21-Aug,36047051200,3051200,10941,69753,80694,Brooklyn,1506254.077,Flatbush
19-May,36081032900,4032900,8097,114839,122936,Queens,4703532.314,East Elmhurst
21-May,36081032900,4032900,6828,4627,11455,Queens,4703532.314,East Elmhurst
19-Jun,36081032900,4032900,22890,49438,72328,Queens,4703532.314,East Elmhurst
21-Jun,36081032900,4032900,0,126949,126949,Queens,4703532.314,East Elmhurst
19-Jul,36081032900,4032900,10650,49933,60583,Queens,4703532.314,East Elmhurst
21-Jul,36081032900,4032900,5403,41007,46410,Queens,4703532.314,East Elmhurst
19-Aug,36081032900,4032900,15175,64078,79253,Queens,4703532.314,East Elmhurst
21-Aug,36081032900,4032900,7870,92526,100396,Queens,4703532.314,East Elmhurst
19-May,36005016600,2016600,11244,180493,191737,Bronx,3077495.737,Throgs Neck-Schuylerville
21-May,36005016600,2016600,2391,68950,71341,Bronx,3077495.737,Throgs Neck-Schuylerville
19-Jun,36005016600,2016600,2132,78463,80595,Bronx,3077495.737,Throgs Neck-Schuylerville
21-Jun,36005016600,2016600,7824,132644,140468,Bronx,3077495.737,Throgs Neck-Schuylerville
19-Jul,36005016600,2016600,8790,145022,153812,Bronx,3077495.737,Throgs Neck-Schuylerville
21-Jul,36005016600,2016600,978,28575,29553,Bronx,3077495.737,Throgs Neck-Schuylerville
19-Aug,36005016600,2016600,4034,48409,52443,Bronx,3077495.737,Throgs Neck-Schuylerville
21-Aug,36005016600,2016600,3864,101800,105664,Bronx,3077495.737,Throgs Neck-Schuylerville
19-May,36047050600,3050600,19538,122989,142527,Brooklyn,1771606.05,Flatbush (West)-Ditmas Park-Parkville
21-May,36047050600,3050600,7575,86940,94515,Brooklyn,1771606.05,Flatbush (West)-Ditmas Park-Parkville
19-Jun,36047050600,3050600,9439,16741,26180,Brooklyn,1771606.05,Flatbush (West)-Ditmas Park-Parkville
21-Jun,36047050600,3050600,14595,89296,103891,Brooklyn,1771606.05,Flatbush (West)-Ditmas Park-Parkville
19-Jul,36047050600,3050600,6567,71,6638,Brooklyn,1771606.05,Flatbush (West)-Ditmas Park-Parkville
21-Jul,36047050600,3050600,10705,25137,35842,Brooklyn,1771606.05,Flatbush (West)-Ditmas Park-Parkville
19-Aug,36047050600,3050600,9204,56750,65954,Brooklyn,1771606.05,Flatbush (West)-Ditmas Park-Parkville
21-Aug,36047050600,3050600,14767,104840,119607,Brooklyn,1771606.05,Flatbush (West)-Ditmas Park-Parkville
19-May,36081049900,4049900,10534,80102,90636,Queens,4961429.112,Elmhurst
21-May,36081049900,4049900,10686,102656,113342,Queens,4961429.112,Elmhurst
19-Jun,36081049900,4049900,14105,55304,69409,Queens,4961429.112,Elmhurst
21-Jun,36081049900,4049900,8300,111622,119922,Queens,4961429.112,Elmhurst
19-Jul,36081049900,4049900,9334,107324,116658,Queens,4961429.112,Elmhurst
21-Jul,36081049900,4049900,12650,141824,154474,Queens,4961429.112,Elmhurst
19-Aug,36081049900,4049900,7677,66649,74326,Queens,4961429.112,Elmhurst
21-Aug,36081049900,4049900,16959,87054,104013,Queens,4961429.112,Elmhurst
19-May,36081050700,4050700,2751,69198,71949,Queens,4005975.409,Middle Village
21-May,36081050700,4050700,7209,72368,79577,Queens,4005975.409,Middle Village
19-Jun,36081050700,4050700,10384,81116,91500,Queens,4005975.409,Middle Village
21-Jun,36081050700,4050700,8143,75020,83163,Queens,4005975.409,Middle Village
19-Jul,36081050700,4050700,2507,91463,93970,Queens,4005975.409,Middle Village
21-Jul,36081050700,4050700,3211,81053,84264,Queens,4005975.409,Middle Village
19-Aug,36081050700,4050700,9950,37630,47580,Queens,4005975.409,Middle Village
21-Aug,36081050700,4050700,5335,93605,98940,Queens,4005975.409,Middle Village
19-May,36005001902,2001902,18528,16174,34702,Bronx,5059222.398,Mott Haven-Port Morris
21-May,36005001902,2001902,3152,106410,109562,Bronx,5059222.398,Mott Haven-Port Morris
19-Jun,36005001902,2001902,0,82003,82003,Bronx,5059222.398,Mott Haven-Port Morris
21-Jun,36005001902,2001902,7713,215513,223226,Bronx,5059222.398,Mott Haven-Port Morris
19-Jul,36005001902,2001902,5509,82442,87951,Bronx,5059222.398,Mott Haven-Port Morris
21-Jul,36005001902,2001902,1103,59282,60385,Bronx,5059222.398,Mott Haven-Port Morris
19-Aug,36005001902,2001902,5671,120753,126424,Bronx,5059222.398,Mott Haven-Port Morris
21-Aug,36005001902,2001902,18236,35249,53485,Bronx,5059222.398,Mott Haven-Port Morris
19-May,36047006300,3006300,14082,50511,64593,Brooklyn,1081285.375,Carroll Gardens-Cobble Hill-Gowanus-Red Hook
21-May,36047006300,3006300,11171,85220,96391,Brooklyn,1081285.375,Carroll Gardens-Cobble Hill-Gowanus-Red Hook
19-Jun,36047006300,3006300,6688,113520,120208,Brooklyn,1081285.375,Carroll Gardens-Cobble Hill-Gowanus-Red Hook
21-Jun,36047006300,3006300,10821,109260,120081,Brooklyn,1081285.375,Carroll Gardens-Cobble Hill-Gowanus-Red Hook
19-Jul,36047006300,3006300,1126,137875,139001,Brooklyn,1081285.375,Carroll Gardens-Cobble Hill-Gowanus-Red Hook
21-Jul,36047006300,3006300,7466,11329,18795,Brooklyn,1081285.375,Carroll Gardens-Cobble Hill-Gowanus-Red Hook
19-Aug,36047006300,3006300,3236,101673,104909,Brooklyn,1081285.375,Carroll Gardens-Cobble Hill-Gowanus-Red Hook
21-Aug,36047006300,3006300,2486,142916,145402,Brooklyn,1081285.375,Carroll Gardens-Cobble Hill-Gowanus-Red Hook
19-May,36047005100,3005100,5447,88362,93809,Brooklyn,1969090.129,Carroll Gardens-Cobble Hill-Gowanus-Red Hook
21-May,36047005100,3005100,7465,67644,75109,Brooklyn,1969090.129,Carroll Gardens-Cobble Hill-Gowanus-Red Hook
19-Jun,36047005100,3005100,3080,77721,80801,Brooklyn,1969090.129,Carroll Gardens-Cobble Hill-Gowanus-Red Hook
21-Jun,36047005100,3005100,4283,64186,68469,Brooklyn,1969090.129,Carroll Gardens-Cobble Hill-Gowanus-Red Hook
19-Jul,36047005100,3005100,1074,3666,4740,Brooklyn,1969090.129,Carroll Gardens-Cobble Hill-Gowanus-Red Hook
21-Jul,36047005100,3005100,8976,75407,84383,Brooklyn,1969090.129,Carroll Gardens-Cobble Hill-Gowanus-Red Hook
19-Aug,36047005100,3005100,10532,82534,93066,Brooklyn,1969090.129,Carroll Gardens-Cobble Hill-Gowanus-Red Hook
21-Aug,36047005100,3005100,12287,36669,48956,Brooklyn,1969090.129,Carroll Gardens-Cobble Hill-Gowanus-Red Hook
19-May,36047005900,3005900,9409,78383,87792,Brooklyn,3843225.683,Carroll Gardens-Cobble Hill-Gowanus-Red Hook
21-May,36047005900,3005900,8923,32339,41262,Brooklyn,3843225.683,Carroll Gardens-Cobble Hill-Gowanus-Red Hook
19-Jun,36047005900,3005900,6795,30749,37544,Brooklyn,3843225.683,Carroll Gardens-Cobble Hill-Gowanus-Red Hook
21-Jun,36047005900,3005900,13463,110673,124136,Brooklyn,3843225.683,Carroll Gardens-Cobble Hill-Gowanus-Red Hook
19-Jul,36047005900,3005900,0,67507,67507,Brooklyn,3843225.683,Carroll Gardens-Cobble Hill-Gowanus-Red Hook
21-Jul,36047005900,3005900,3137,58339,61476,Brooklyn,3843225.683,Carroll Gardens-Cobble Hill-Gowanus-Red Hook
19-Aug,36047005900,3005900,1347,8430,9777,Brooklyn,3843225.683,Carroll Gardens-Cobble Hill-Gowanus-Red Hook
21-Aug,36047005900,3005900,2428,204157,206585,Brooklyn,3843225.683,Carroll Gardens-Cobble Hill-Gowanus-Red Hook
19-May,36085021300,5021300,10511,101464,111975,Staten Island,8432869.651,Port Richmond
21-May,36085021300,5021300,2199,48860,51059,Staten Island,8432869.651,Port Richmond
19-Jun,36085021300,5021300,4297,80466,84763,Staten Island,8432869.651,Port Richmond
21-Jun,36085021300,5021300,11198,103904,115102,Staten Island,8432869.651,Port Richmond
19-Jul,36085021300,5021300,7354,97763,105117,Staten Island,8432869.651,Port Richmond
21-Jul,36085021300,5021300,12049,53549,65598,Staten Island,8432869.651,Port Richmond
19-Aug,36085021300,5021300,11905,118204,130109,Staten Island,8432869.651,Port Richmond
21-Aug,36085021300,5021300,9941,89115,99056,Staten Island,8432869.651,Port Richmond
19-May,36085024700,5024700,8170,114744,122914,Staten Island,5174183.299,Port Richmond
21-May,36085024700,5024700,8553,30329,38882,Staten Island,5174183.299,Port Richmond
19-Jun,36085024700,5024700,8977,170961,179938,Staten Island,5174183.299,Port Richmond
21-Jun,36085024700,5024700,9679,67890,77569,Staten Island,5174183.299,Port Richmond
19-Jul,36085024700,5024700,4522,109051,113573,Staten Island,5174183.299,Port Richmond
21-Jul,36085024700,5024700,15158,71224,86382,Staten Island,5174183.299,Port Richmond
19-Aug,36085024700,5024700,10826,87713,98539,Staten Island,5174183.299,Port Richmond
21-Aug,36085024700,5024700,8272,88576,96848,Staten Island,5174183.299,Port Richmond
19-May,36005005100,2005100,1088,52667,53755,Bronx,5514198.697,Mott Haven-Port Morris
21-May,36005005100,2005100,3860,36483,40343,Bronx,5514198.697,Mott Haven-Port Morris
19-Jun,36005005100,2005100,8362,58441,66803,Bronx,5514198.697,Mott Haven-Port Morris
21-Jun,36005005100,2005100,8955,69287,78242,Bronx,5514198.697,Mott Haven-Port Morris
19-Jul,36005005100,2005100,13008,46592,59600,Bronx,5514198.697,Mott Haven-Port Morris
21-Jul,36005005100,2005100,0,44006,44006,Bronx,5514198.697,Mott Haven-Port Morris
19-Aug,36005005100,2005100,15649,71,15720,Bronx,5514198.697,Mott Haven-Port Morris
21-Aug,36005005100,2005100,2302,180561,182863,Bronx,5514198.697,Mott Haven-Port Morris
19-May,36047035400,3035400,9543,57699,67242,Brooklyn,4052451.982,Coney Island-Sea Gate
21-May,36047035400,3035400,7124,71,7195,Brooklyn,4052451.982,Coney Island-Sea Gate
19-Jun,36047035400,3035400,16644,107666,124310,Brooklyn,4052451.982,Coney Island-Sea Gate
21-Jun,36047035400,3035400,6921,105217,112138,Brooklyn,4052451.982,Coney Island-Sea Gate
19-Jul,36047035400,3035400,8220,103825,112045,Brooklyn,4052451.982,Coney Island-Sea Gate
21-Jul,36047035400,3035400,14999,81830,96829,Brooklyn,4052451.982,Coney Island-Sea Gate
19-Aug,36047035400,3035400,10944,44807,55751,Brooklyn,4052451.982,Coney Island-Sea Gate
21-Aug,36047035400,3035400,3409,71,3480,Brooklyn,4052451.982,Coney Island-Sea Gate
19-May,36047036600,3036600,6563,92925,99488,Brooklyn,2516458.26,Brighton Beach
21-May,36047036600,3036600,1623,71,1694,Brooklyn,2516458.26,Brighton Beach
19-Jun,36047036600,3036600,12036,53682,65718,Brooklyn,2516458.26,Brighton Beach
21-Jun,36047036600,3036600,3348,78835,82183,Brooklyn,2516458.26,Brighton Beach
19-Jul,36047036600,3036600,12619,57459,70078,Brooklyn,2516458.26,Brighton Beach
21-Jul,36047036600,3036600,11093,68677,79770,Brooklyn,2516458.26,Brighton Beach
19-Aug,36047036600,3036600,6747,72703,79450,Brooklyn,2516458.26,Brighton Beach
21-Aug,36047036600,3036600,7491,71904,79395,Brooklyn,2516458.26,Brighton Beach
19-May,36081003900,4003900,0,84296,84296,Queens,1580667.335,Queensbridge-Ravenswood-Dutch Kills
21-May,36081003900,4003900,7078,89960,97038,Queens,1580667.335,Queensbridge-Ravenswood-Dutch Kills
19-Jun,36081003900,4003900,1079,23909,24988,Queens,1580667.335,Queensbridge-Ravenswood-Dutch Kills
21-Jun,36081003900,4003900,14241,106543,120784,Queens,1580667.335,Queensbridge-Ravenswood-Dutch Kills
19-Jul,36081003900,4003900,8309,154996,163305,Queens,1580667.335,Queensbridge-Ravenswood-Dutch Kills
21-Jul,36081003900,4003900,10072,102094,112166,Queens,1580667.335,Queensbridge-Ravenswood-Dutch Kills
19-Aug,36081003900,4003900,3921,42140,46061,Queens,1580667.335,Queensbridge-Ravenswood-Dutch Kills
21-Aug,36081003900,4003900,14243,121363,135606,Queens,1580667.335,Queensbridge-Ravenswood-Dutch Kills
19-May,36081034700,4034700,1730,37082,38812,Queens,4118366.796,East Elmhurst
21-May,36081034700,4034700,5150,68536,73686,Queens,4118366.796,East Elmhurst
19-Jun,36081034700,4034700,13268,82803,96071,Queens,4118366.796,East Elmhurst
21-Jun,36081034700,4034700,11651,62168,73819,Queens,4118366.796,East Elmhurst
19-Jul,36081034700,4034700,7028,66680,73708,Queens,4118366.796,East Elmhurst
21-Jul,36081034700,4034700,7227,115411,122638,Queens,4118366.796,East Elmhurst
19-Aug,36081034700,4034700,3586,37092,40678,Queens,4118366.796,East Elmhurst
21-Aug,36081034700,4034700,6695,93977,100672,Queens,4118366.796,East Elmhurst
19-May,36005015700,2015700,2598,145413,148011,Bronx,3362794.336,Crotona Park East
21-May,36005015700,2015700,6364,77297,83661,Bronx,3362794.336,Crotona Park East
19-Jun,36005015700,2015700,9945,78431,88376,Bronx,3362794.336,Crotona Park East
21-Jun,36005015700,2015700,9472,170544,180016,Bronx,3362794.336,Crotona Park East
19-Jul,36005015700,2015700,12310,55785,68095,Bronx,3362794.336,Crotona Park East
21-Jul,36005015700,2015700,8749,83467,92216,Bronx,3362794.336,Crotona Park East
19-Aug,36005015700,2015700,6368,19810,26178,Bronx,3362794.336,Crotona Park East
21-Aug,36005015700,2015700,9685,72441,82126,Bronx,3362794.336,Crotona Park East
19-May,36061031703,1031703,5394,12743,18137,Manhattan,2649774.011,Financial District-Battery Park City
21-May,36061031703,1031703,14430,121199,135629,Manhattan,2649774.011,Financial District-Battery Park City
19-Jun,36061031703,1031703,0,89207,89207,Manhattan,2649774.011,Financial District-Battery Park City
21-Jun,36061031703,1031703,6070,61252,67322,Manhattan,2649774.011,Financial District-Battery Park City
19-Jul,36061031703,1031703,6587,88741,95328,Manhattan,2649774.011,Financial District-Battery Park City
21-Jul,36061031703,1031703,5702,14250,19952,Manhattan,2649774.011,Financial District-Battery Park City
19-Aug,36061031703,1031703,9854,124865,134719,Manhattan,2649774.011,Financial District-Battery Park City
21-Aug,36061031703,1031703,1372,114886,116258,Manhattan,2649774.011,Financial District-Battery Park City
19-May,36085029106,5029106,17824,76986,94810,Staten Island,4648918.527,New Springville-Willowbrook-Bulls Head-Travis
21-May,36085029106,5029106,9990,110085,120075,Staten Island,4648918.527,New Springville-Willowbrook-Bulls Head-Travis
19-Jun,36085029106,5029106,9076,66866,75942,Staten Island,4648918.527,New Springville-Willowbrook-Bulls Head-Travis
21-Jun,36085029106,5029106,11580,66591,78171,Staten Island,4648918.527,New Springville-Willowbrook-Bulls Head-Travis
19-Jul,36085029106,5029106,14063,39873,53936,Staten Island,4648918.527,New Springville-Willowbrook-Bulls Head-Travis
21-Jul,36085029106,5029106,0,90689,90689,Staten Island,4648918.527,New Springville-Willowbrook-Bulls Head-Travis
19-Aug,36085029106,5029106,2271,53281,55552,Staten Island,4648918.527,New Springville-Willowbrook-Bulls Head-Travis
21-Aug,36085029106,5029106,4939,76552,81491,Staten Island,4648918.527,New Springville-Willowbrook-Bulls Head-Travis
19-May,36047001300,3001300,5837,57376,63213,Brooklyn,3167176.045,Downtown Brooklyn-DUMBO-Boerum Hill
21-May,36047001300,3001300,12417,71,12488,Brooklyn,3167176.045,Downtown Brooklyn-DUMBO-Boerum Hill
19-Jun,36047001300,3001300,16024,80590,96614,Brooklyn,3167176.045,Downtown Brooklyn-DUMBO-Boerum Hill
21-Jun,36047001300,3001300,107,128737,128844,Brooklyn,3167176.045,Downtown Brooklyn-DUMBO-Boerum Hill
19-Jul,36047001300,3001300,11446,42294,53740,Brooklyn,3167176.045,Downtown Brooklyn-DUMBO-Boerum Hill
21-Jul,36047001300,3001300,10121,48669,58790,Brooklyn,3167176.045,Downtown Brooklyn-DUMBO-Boerum Hill
19-Aug,36047001300,3001300,5065,46566,51631,Brooklyn,3167176.045,Downtown Brooklyn-DUMBO-Boerum Hill
21-Aug,36047001300,3001300,9784,136588,146372,Brooklyn,3167176.045,Downtown Brooklyn-DUMBO-Boerum Hill
19-May,36085013203,5013203,13493,39480,52973,Staten Island,11124441.35,Great Kills-Eltingville
21-May,36085013203,5013203,15108,10249,25357,Staten Island,11124441.35,Great Kills-Eltingville
19-Jun,36085013203,5013203,4300,86494,90794,Staten Island,11124441.35,Great Kills-Eltingville
21-Jun,36085013203,5013203,1639,154762,156401,Staten Island,11124441.35,Great Kills-Eltingville
19-Jul,36085013203,5013203,3647,106887,110534,Staten Island,11124441.35,Great Kills-Eltingville
21-Jul,36085013203,5013203,11029,105432,116461,Staten Island,11124441.35,Great Kills-Eltingville
19-Aug,36085013203,5013203,8329,82060,90389,Staten Island,11124441.35,Great Kills-Eltingville
21-Aug,36085013203,5013203,4899,23846,28745,Staten Island,11124441.35,Great Kills-Eltingville
19-May,36085013204,5013204,7726,52191,59917,Staten Island,11249695.01,Oakwood-Richmondtown
21-May,36085013204,5013204,1091,57136,58227,Staten Island,11249695.01,Oakwood-Richmondtown
19-Jun,36085013204,5013204,6456,98949,105405,Staten Island,11249695.01,Oakwood-Richmondtown
21-Jun,36085013204,5013204,10288,53834,64122,Staten Island,11249695.01,Oakwood-Richmondtown
19-Jul,36085013204,5013204,4372,41147,45519,Staten Island,11249695.01,Oakwood-Richmondtown
21-Jul,36085013204,5013204,6326,73295,79621,Staten Island,11249695.01,Oakwood-Richmondtown
19-Aug,36085013204,5013204,9734,121334,131068,Staten Island,11249695.01,Oakwood-Richmondtown
21-Aug,36085013204,5013204,8519,101643,110162,Staten Island,11249695.01,Oakwood-Richmondtown
19-May,36085013201,5013201,0,61943,61943,Staten Island,5054382.966,Oakwood-Richmondtown
21-May,36085013201,5013201,6071,71,6142,Staten Island,5054382.966,Oakwood-Richmondtown
19-Jun,36085013201,5013201,10317,73859,84176,Staten Island,5054382.966,Oakwood-Richmondtown
21-Jun,36085013201,5013201,11978,98403,110381,Staten Island,5054382.966,Oakwood-Richmondtown
19-Jul,36085013201,5013201,3604,144106,147710,Staten Island,5054382.966,Oakwood-Richmondtown
21-Jul,36085013201,5013201,0,112429,112429,Staten Island,5054382.966,Oakwood-Richmondtown
19-Aug,36085013201,5013201,11077,24114,35191,Staten Island,5054382.966,Oakwood-Richmondtown
21-Aug,36085013201,5013201,12179,113067,125246,Staten Island,5054382.966,Oakwood-Richmondtown
19-May,36085013800,5013800,7659,35864,43523,Staten Island,15149158.97,Oakwood-Richmondtown
21-May,36085013800,5013800,8219,83379,91598,Staten Island,15149158.97,Oakwood-Richmondtown
19-Jun,36085013800,5013800,14494,17850,32344,Staten Island,15149158.97,Oakwood-Richmondtown
21-Jun,36085013800,5013800,6887,71,6958,Staten Island,15149158.97,Oakwood-Richmondtown
19-Jul,36085013800,5013800,8358,103903,112261,Staten Island,15149158.97,Oakwood-Richmondtown
21-Jul,36085013800,5013800,11013,59059,70072,Staten Island,15149158.97,Oakwood-Richmondtown
19-Aug,36085013800,5013800,8438,66333,74771,Staten Island,15149158.97,Oakwood-Richmondtown
21-Aug,36085013800,5013800,12119,54831,66950,Staten Island,15149158.97,Oakwood-Richmondtown
19-May,36061011700,1011700,2875,117685,120560,Manhattan,2125062.026,Chelsea-Hudson Yards
21-May,36061011700,1011700,15562,36379,51941,Manhattan,2125062.026,Chelsea-Hudson Yards
19-Jun,36061011700,1011700,9002,34016,43018,Manhattan,2125062.026,Chelsea-Hudson Yards
21-Jun,36061011700,1011700,2605,97523,100128,Manhattan,2125062.026,Chelsea-Hudson Yards
19-Jul,36061011700,1011700,16278,38533,54811,Manhattan,2125062.026,Chelsea-Hudson Yards
21-Jul,36061011700,1011700,16776,105344,122120,Manhattan,2125062.026,Chelsea-Hudson Yards
19-Aug,36061011700,1011700,9517,94035,103552,Manhattan,2125062.026,Chelsea-Hudson Yards
21-Aug,36061011700,1011700,0,89308,89308,Manhattan,2125062.026,Chelsea-Hudson Yards
19-May,36061012901,1012901,10890,60234,71124,Manhattan,2303134.25,Hell's Kitchen
21-May,36061012901,1012901,0,54670,54670,Manhattan,2303134.25,Hell's Kitchen
19-Jun,36061012901,1012901,11096,110501,121597,Manhattan,2303134.25,Hell's Kitchen
21-Jun,36061012901,1012901,4979,128982,133961,Manhattan,2303134.25,Hell's Kitchen
19-Jul,36061012901,1012901,18886,108470,127356,Manhattan,2303134.25,Hell's Kitchen
21-Jul,36061012901,1012901,0,121256,121256,Manhattan,2303134.25,Hell's Kitchen
19-Aug,36061012901,1012901,6356,39738,46094,Manhattan,2303134.25,Hell's Kitchen
21-Aug,36061012901,1012901,11049,1334,12383,Manhattan,2303134.25,Hell's Kitchen
19-May,36047017100,3017100,0,8790,8790,Brooklyn,2247115.249,Windsor Terrace-South Slope
21-May,36047017100,3017100,7073,77681,84754,Brooklyn,2247115.249,Windsor Terrace-South Slope
19-Jun,36047017100,3017100,935,64314,65249,Brooklyn,2247115.249,Windsor Terrace-South Slope
21-Jun,36047017100,3017100,10648,50546,61194,Brooklyn,2247115.249,Windsor Terrace-South Slope
19-Jul,36047017100,3017100,11196,95590,106786,Brooklyn,2247115.249,Windsor Terrace-South Slope
21-Jul,36047017100,3017100,7748,104305,112053,Brooklyn,2247115.249,Windsor Terrace-South Slope
19-Aug,36047017100,3017100,10075,37335,47410,Brooklyn,2247115.249,Windsor Terrace-South Slope
21-Aug,36047017100,3017100,0,61298,61298,Brooklyn,2247115.249,Windsor Terrace-South Slope
19-May,36047050202,3050202,5496,37781,43277,Brooklyn,1451525.346,Windsor Terrace-South Slope
21-May,36047050202,3050202,4384,71,4455,Brooklyn,1451525.346,Windsor Terrace-South Slope
19-Jun,36047050202,3050202,6488,51081,57569,Brooklyn,1451525.346,Windsor Terrace-South Slope
21-Jun,36047050202,3050202,10751,43153,53904,Brooklyn,1451525.346,Windsor Terrace-South Slope
19-Jul,36047050202,3050202,2196,43438,45634,Brooklyn,1451525.346,Windsor Terrace-South Slope
21-Jul,36047050202,3050202,1818,61981,63799,Brooklyn,1451525.346,Windsor Terrace-South Slope
19-Aug,36047050202,3050202,16329,51717,68046,Brooklyn,1451525.346,Windsor Terrace-South Slope
21-Aug,36047050202,3050202,13301,44872,58173,Brooklyn,1451525.346,Windsor Terrace-South Slope
19-May,36047050001,3050001,6458,136571,143029,Brooklyn,1513120.705,Windsor Terrace-South Slope
21-May,36047050001,3050001,10564,81617,92181,Brooklyn,1513120.705,Windsor Terrace-South Slope
19-Jun,36047050001,3050001,1327,171543,172870,Brooklyn,1513120.705,Windsor Terrace-South Slope
21-Jun,36047050001,3050001,4607,100095,104702,Brooklyn,1513120.705,Windsor Terrace-South Slope
19-Jul,36047050001,3050001,9020,135399,144419,Brooklyn,1513120.705,Windsor Terrace-South Slope
21-Jul,36047050001,3050001,8446,103474,111920,Brooklyn,1513120.705,Windsor Terrace-South Slope
19-Aug,36047050001,3050001,0,53218,53218,Brooklyn,1513120.705,Windsor Terrace-South Slope
21-Aug,36047050001,3050001,17351,104254,121605,Brooklyn,1513120.705,Windsor Terrace-South Slope
19-May,36047150200,3150200,5589,64376,69965,Brooklyn,3430773.693,Windsor Terrace-South Slope
21-May,36047150200,3150200,13713,29479,43192,Brooklyn,3430773.693,Windsor Terrace-South Slope
19-Jun,36047150200,3150200,10008,41482,51490,Brooklyn,3430773.693,Windsor Terrace-South Slope
21-Jun,36047150200,3150200,0,75560,75560,Brooklyn,3430773.693,Windsor Terrace-South Slope
19-Jul,36047150200,3150200,10723,102585,113308,Brooklyn,3430773.693,Windsor Terrace-South Slope
21-Jul,36047150200,3150200,6766,88535,95301,Brooklyn,3430773.693,Windsor Terrace-South Slope
19-Aug,36047150200,3150200,6068,31996,38064,Brooklyn,3430773.693,Windsor Terrace-South Slope
21-Aug,36047150200,3150200,3457,69824,73281,Brooklyn,3430773.693,Windsor Terrace-South Slope
19-May,36081056400,4056400,10400,60324,70724,Queens,2025501.905,Queens Village
21-May,36081056400,4056400,13898,47759,61657,Queens,2025501.905,Queens Village
19-Jun,36081056400,4056400,0,89078,89078,Queens,2025501.905,Queens Village
21-Jun,36081056400,4056400,4142,139813,143955,Queens,2025501.905,Queens Village
19-Jul,36081056400,4056400,9884,117852,127736,Queens,2025501.905,Queens Village
21-Jul,36081056400,4056400,15150,46294,61444,Queens,2025501.905,Queens Village
19-Aug,36081056400,4056400,12720,73128,85848,Queens,2025501.905,Queens Village
21-Aug,36081056400,4056400,5496,112657,118153,Queens,2025501.905,Queens Village
19-May,36061023900,1023900,11161,80848,92009,Manhattan,687788.5411,Washington Heights (South)
21-May,36061023900,1023900,13431,87721,101152,Manhattan,687788.5411,Washington Heights (South)
19-Jun,36061023900,1023900,10716,103877,114593,Manhattan,687788.5411,Washington Heights (South)
21-Jun,36061023900,1023900,13823,68495,82318,Manhattan,687788.5411,Washington Heights (South)
19-Jul,36061023900,1023900,1334,68022,69356,Manhattan,687788.5411,Washington Heights (South)
21-Jul,36061023900,1023900,557,89619,90176,Manhattan,687788.5411,Washington Heights (South)
19-Aug,36061023900,1023900,11956,101593,113549,Manhattan,687788.5411,Washington Heights (South)
21-Aug,36061023900,1023900,4121,48210,52331,Manhattan,687788.5411,Washington Heights (South)
19-May,36047054300,3054300,3894,18999,22893,Brooklyn,10106059.83,Brooklyn Navy Yard
21-May,36047054300,3054300,3864,104421,108285,Brooklyn,10106059.83,Brooklyn Navy Yard
19-Jun,36047054300,3054300,4295,111707,116002,Brooklyn,10106059.83,Brooklyn Navy Yard
21-Jun,36047054300,3054300,3320,103816,107136,Brooklyn,10106059.83,Brooklyn Navy Yard
19-Jul,36047054300,3054300,10178,93764,103942,Brooklyn,10106059.83,Brooklyn Navy Yard
21-Jul,36047054300,3054300,864,30704,31568,Brooklyn,10106059.83,Brooklyn Navy Yard
19-Aug,36047054300,3054300,12685,48478,61163,Brooklyn,10106059.83,Brooklyn Navy Yard
21-Aug,36047054300,3054300,6800,47323,54123,Brooklyn,10106059.83,Brooklyn Navy Yard
19-May,36047054500,3054500,3017,76159,79176,Brooklyn,1801771.594,South Williamsburg
21-May,36047054500,3054500,7918,43922,51840,Brooklyn,1801771.594,South Williamsburg
19-Jun,36047054500,3054500,8197,27416,35613,Brooklyn,1801771.594,South Williamsburg
21-Jun,36047054500,3054500,4222,58914,63136,Brooklyn,1801771.594,South Williamsburg
19-Jul,36047054500,3054500,8476,103054,111530,Brooklyn,1801771.594,South Williamsburg
21-Jul,36047054500,3054500,11479,17721,29200,Brooklyn,1801771.594,South Williamsburg
19-Aug,36047054500,3054500,17137,43971,61108,Brooklyn,1801771.594,South Williamsburg
21-Aug,36047054500,3054500,6979,67209,74188,Brooklyn,1801771.594,South Williamsburg
19-May,36081030904,4030904,11265,99068,110333,Queens,4460641.887,Jackson Heights
21-May,36081030904,4030904,8184,84693,92877,Queens,4460641.887,Jackson Heights
19-Jun,36081030904,4030904,20355,48628,68983,Queens,4460641.887,Jackson Heights
21-Jun,36081030904,4030904,0,113564,113564,Queens,4460641.887,Jackson Heights
19-Jul,36081030904,4030904,11531,57608,69139,Queens,4460641.887,Jackson Heights
21-Jul,36081030904,4030904,10517,34661,45178,Queens,4460641.887,Jackson Heights
19-Aug,36081030904,4030904,2803,52187,54990,Queens,4460641.887,Jackson Heights
21-Aug,36081030904,4030904,9511,102042,111553,Queens,4460641.887,Jackson Heights
19-May,36081030905,4030905,10173,81275,91448,Queens,2079363.884,Jackson Heights
21-May,36081030905,4030905,11712,112107,123819,Queens,2079363.884,Jackson Heights
19-Jun,36081030905,4030905,8309,69622,77931,Queens,2079363.884,Jackson Heights
21-Jun,36081030905,4030905,0,72657,72657,Queens,2079363.884,Jackson Heights
19-Jul,36081030905,4030905,0,33045,33045,Queens,2079363.884,Jackson Heights
21-Jul,36081030905,4030905,10396,75841,86237,Queens,2079363.884,Jackson Heights
19-Aug,36081030905,4030905,10661,70445,81106,Queens,2079363.884,Jackson Heights
21-Aug,36081030905,4030905,2914,95148,98062,Queens,2079363.884,Jackson Heights
19-May,36047069602,3069602,3189,70938,74127,Brooklyn,7888385.838,Marine Park-Mill Basin-Bergen Beach
21-May,36047069602,3069602,4433,49428,53861,Brooklyn,7888385.838,Marine Park-Mill Basin-Bergen Beach
19-Jun,36047069602,3069602,0,85478,85478,Brooklyn,7888385.838,Marine Park-Mill Basin-Bergen Beach
21-Jun,36047069602,3069602,0,121146,121146,Brooklyn,7888385.838,Marine Park-Mill Basin-Bergen Beach
19-Jul,36047069602,3069602,4824,35469,40293,Brooklyn,7888385.838,Marine Park-Mill Basin-Bergen Beach
21-Jul,36047069602,3069602,6670,81393,88063,Brooklyn,7888385.838,Marine Park-Mill Basin-Bergen Beach
19-Aug,36047069602,3069602,12166,22640,34806,Brooklyn,7888385.838,Marine Park-Mill Basin-Bergen Beach
21-Aug,36047069602,3069602,10217,47153,57370,Brooklyn,7888385.838,Marine Park-Mill Basin-Bergen Beach
19-May,36047070601,3070601,9436,71,9507,Brooklyn,4536147.223,Marine Park-Mill Basin-Bergen Beach
21-May,36047070601,3070601,12161,58059,70220,Brooklyn,4536147.223,Marine Park-Mill Basin-Bergen Beach
19-Jun,36047070601,3070601,3562,43198,46760,Brooklyn,4536147.223,Marine Park-Mill Basin-Bergen Beach
21-Jun,36047070601,3070601,10098,60451,70549,Brooklyn,4536147.223,Marine Park-Mill Basin-Bergen Beach
19-Jul,36047070601,3070601,9463,73470,82933,Brooklyn,4536147.223,Marine Park-Mill Basin-Bergen Beach
21-Jul,36047070601,3070601,5508,77523,83031,Brooklyn,4536147.223,Marine Park-Mill Basin-Bergen Beach
19-Aug,36047070601,3070601,5360,135289,140649,Brooklyn,4536147.223,Marine Park-Mill Basin-Bergen Beach
21-Aug,36047070601,3070601,13109,57278,70387,Brooklyn,4536147.223,Marine Park-Mill Basin-Bergen Beach
19-May,36085017016,5017016,16805,40505,57310,Staten Island,7141525.487,Arden Heights-Rossville
21-May,36085017016,5017016,7892,47292,55184,Staten Island,7141525.487,Arden Heights-Rossville
19-Jun,36085017016,5017016,13194,51876,65070,Staten Island,7141525.487,Arden Heights-Rossville
21-Jun,36085017016,5017016,596,116009,116605,Staten Island,7141525.487,Arden Heights-Rossville
19-Jul,36085017016,5017016,3271,56622,59893,Staten Island,7141525.487,Arden Heights-Rossville
21-Jul,36085017016,5017016,0,32497,32497,Staten Island,7141525.487,Arden Heights-Rossville
19-Aug,36085017016,5017016,13085,5457,18542,Staten Island,7141525.487,Arden Heights-Rossville
21-Aug,36085017016,5017016,9803,44767,54570,Staten Island,7141525.487,Arden Heights-Rossville
19-May,36005005600,2005600,0,119588,119588,Bronx,1511686.141,Soundview-Bruckner-Bronx River
21-May,36005005600,2005600,3664,47611,51275,Bronx,1511686.141,Soundview-Bruckner-Bronx River
19-Jun,36005005600,2005600,1712,63492,65204,Bronx,1511686.141,Soundview-Bruckner-Bronx River
21-Jun,36005005600,2005600,0,52636,52636,Bronx,1511686.141,Soundview-Bruckner-Bronx River
19-Jul,36005005600,2005600,10042,76413,86455,Bronx,1511686.141,Soundview-Bruckner-Bronx River
21-Jul,36005005600,2005600,5735,117150,122885,Bronx,1511686.141,Soundview-Bruckner-Bronx River
19-Aug,36005005600,2005600,13274,93272,106546,Bronx,1511686.141,Soundview-Bruckner-Bronx River
21-Aug,36005005600,2005600,0,78382,78382,Bronx,1511686.141,Soundview-Bruckner-Bronx River
19-May,36005006200,2006200,20528,77042,97570,Bronx,2074926.98,Soundview-Bruckner-Bronx River
21-May,36005006200,2006200,12856,115530,128386,Bronx,2074926.98,Soundview-Bruckner-Bronx River
19-Jun,36005006200,2006200,6101,49675,55776,Bronx,2074926.98,Soundview-Bruckner-Bronx River
21-Jun,36005006200,2006200,7830,51212,59042,Bronx,2074926.98,Soundview-Bruckner-Bronx River
19-Jul,36005006200,2006200,13327,95954,109281,Bronx,2074926.98,Soundview-Bruckner-Bronx River
21-Jul,36005006200,2006200,4571,72570,77141,Bronx,2074926.98,Soundview-Bruckner-Bronx River
19-Aug,36005006200,2006200,13067,74598,87665,Bronx,2074926.98,Soundview-Bruckner-Bronx River
21-Aug,36005006200,2006200,10823,71416,82239,Bronx,2074926.98,Soundview-Bruckner-Bronx River
19-May,36081127700,4127700,14904,14942,29846,Queens,11505210.51,Jamaica Estates-Holliswood
21-May,36081127700,4127700,175,37823,37998,Queens,11505210.51,Jamaica Estates-Holliswood
19-Jun,36081127700,4127700,8269,71333,79602,Queens,11505210.51,Jamaica Estates-Holliswood
21-Jun,36081127700,4127700,9106,129893,138999,Queens,11505210.51,Jamaica Estates-Holliswood
19-Jul,36081127700,4127700,865,56356,57221,Queens,11505210.51,Jamaica Estates-Holliswood
21-Jul,36081127700,4127700,13957,45997,59954,Queens,11505210.51,Jamaica Estates-Holliswood
19-Aug,36081127700,4127700,14216,63836,78052,Queens,11505210.51,Jamaica Estates-Holliswood
21-Aug,36081127700,4127700,10787,40808,51595,Queens,11505210.51,Jamaica Estates-Holliswood
19-May,36005021601,2021601,7123,79150,86273,Bronx,1761363.118,Soundview-Bruckner-Bronx River
21-May,36005021601,2021601,5539,57036,62575,Bronx,1761363.118,Soundview-Bruckner-Bronx River
19-Jun,36005021601,2021601,16544,58894,75438,Bronx,1761363.118,Soundview-Bruckner-Bronx River
21-Jun,36005021601,2021601,17097,88547,105644,Bronx,1761363.118,Soundview-Bruckner-Bronx River
19-Jul,36005021601,2021601,0,51809,51809,Bronx,1761363.118,Soundview-Bruckner-Bronx River
21-Jul,36005021601,2021601,8345,61080,69425,Bronx,1761363.118,Soundview-Bruckner-Bronx River
19-Aug,36005021601,2021601,5272,38266,43538,Bronx,1761363.118,Soundview-Bruckner-Bronx River
21-Aug,36005021601,2021601,7947,53107,61054,Bronx,1761363.118,Soundview-Bruckner-Bronx River
19-May,36005021602,2021602,5835,71344,77179,Bronx,1788230.554,Parkchester
21-May,36005021602,2021602,6942,86805,93747,Bronx,1788230.554,Parkchester
19-Jun,36005021602,2021602,0,106019,106019,Bronx,1788230.554,Parkchester
21-Jun,36005021602,2021602,8489,149932,158421,Bronx,1788230.554,Parkchester
19-Jul,36005021602,2021602,13834,18611,32445,Bronx,1788230.554,Parkchester
21-Jul,36005021602,2021602,3309,96821,100130,Bronx,1788230.554,Parkchester
19-Aug,36005021602,2021602,4582,84489,89071,Bronx,1788230.554,Parkchester
21-Aug,36005021602,2021602,18280,36796,55076,Bronx,1788230.554,Parkchester
19-May,36081138502,4138502,15582,38616,54198,Queens,26132395.9,Alley Pond Park
21-May,36081138502,4138502,10477,113686,124163,Queens,26132395.9,Alley Pond Park
19-Jun,36081138502,4138502,12877,55452,68329,Queens,26132395.9,Alley Pond Park
21-Jun,36081138502,4138502,1834,41303,43137,Queens,26132395.9,Alley Pond Park
19-Jul,36081138502,4138502,6792,54663,61455,Queens,26132395.9,Alley Pond Park
21-Jul,36081138502,4138502,4800,95533,100333,Queens,26132395.9,Alley Pond Park
19-Aug,36081138502,4138502,13316,113154,126470,Queens,26132395.9,Alley Pond Park
21-Aug,36081138502,4138502,5964,85647,91611,Queens,26132395.9,Alley Pond Park
19-May,36081152901,4152901,9809,117797,127606,Queens,15065142.58,Douglaston-Little Neck
21-May,36081152901,4152901,304,83695,83999,Queens,15065142.58,Douglaston-Little Neck
19-Jun,36081152901,4152901,0,120017,120017,Queens,15065142.58,Douglaston-Little Neck
21-Jun,36081152901,4152901,10951,84711,95662,Queens,15065142.58,Douglaston-Little Neck
19-Jul,36081152901,4152901,8069,84126,92195,Queens,15065142.58,Douglaston-Little Neck
21-Jul,36081152901,4152901,3433,121712,125145,Queens,15065142.58,Douglaston-Little Neck
19-Aug,36081152901,4152901,7591,115775,123366,Queens,15065142.58,Douglaston-Little Neck
21-Aug,36081152901,4152901,12491,19386,31877,Queens,15065142.58,Douglaston-Little Neck
19-May,36047010100,3010100,786,171910,172696,Brooklyn,3393635.867,Sunset Park (West)
21-May,36047010100,3010100,13507,43712,57219,Brooklyn,3393635.867,Sunset Park (West)
19-Jun,36047010100,3010100,13732,71,13803,Brooklyn,3393635.867,Sunset Park (West)
21-Jun,36047010100,3010100,20157,94127,114284,Brooklyn,3393635.867,Sunset Park (West)
19-Jul,36047010100,3010100,12498,68484,80982,Brooklyn,3393635.867,Sunset Park (West)
21-Jul,36047010100,3010100,4965,119436,124401,Brooklyn,3393635.867,Sunset Park (West)
19-Aug,36047010100,3010100,1944,162138,164082,Brooklyn,3393635.867,Sunset Park (West)
21-Aug,36047010100,3010100,9235,93816,103051,Brooklyn,3393635.867,Sunset Park (West)
19-May,36081048900,4048900,8155,102195,110350,Queens,3902882.928,Woodside
21-May,36081048900,4048900,9824,66475,76299,Queens,3902882.928,Woodside
19-Jun,36081048900,4048900,7661,65363,73024,Queens,3902882.928,Woodside
21-Jun,36081048900,4048900,0,76266,76266,Queens,3902882.928,Woodside
19-Jul,36081048900,4048900,0,42933,42933,Queens,3902882.928,Woodside
21-Jul,36081048900,4048900,12245,121203,133448,Queens,3902882.928,Woodside
19-Aug,36081048900,4048900,9523,128200,137723,Queens,3902882.928,Woodside
21-Aug,36081048900,4048900,10869,61616,72485,Queens,3902882.928,Woodside
19-May,36047014500,3014500,11920,51909,63829,Brooklyn,2317452.554,Sunset Park (West)
21-May,36047014500,3014500,2421,189559,191980,Brooklyn,2317452.554,Sunset Park (West)
19-Jun,36047014500,3014500,1594,49990,51584,Brooklyn,2317452.554,Sunset Park (West)
21-Jun,36047014500,3014500,9721,105718,115439,Brooklyn,2317452.554,Sunset Park (West)
19-Jul,36047014500,3014500,2259,45889,48148,Brooklyn,2317452.554,Sunset Park (West)
21-Jul,36047014500,3014500,6902,124836,131738,Brooklyn,2317452.554,Sunset Park (West)
19-Aug,36047014500,3014500,3635,56379,60014,Brooklyn,2317452.554,Sunset Park (West)
21-Aug,36047014500,3014500,13419,65657,79076,Brooklyn,2317452.554,Sunset Park (West)
19-May,36047011700,3011700,9413,65869,75282,Brooklyn,2163265.163,Carroll Gardens-Cobble Hill-Gowanus-Red Hook
21-May,36047011700,3011700,8989,82853,91842,Brooklyn,2163265.163,Carroll Gardens-Cobble Hill-Gowanus-Red Hook
19-Jun,36047011700,3011700,6728,68127,74855,Brooklyn,2163265.163,Carroll Gardens-Cobble Hill-Gowanus-Red Hook
21-Jun,36047011700,3011700,13983,71,14054,Brooklyn,2163265.163,Carroll Gardens-Cobble Hill-Gowanus-Red Hook
19-Jul,36047011700,3011700,4012,82018,86030,Brooklyn,2163265.163,Carroll Gardens-Cobble Hill-Gowanus-Red Hook
21-Jul,36047011700,3011700,6366,60928,67294,Brooklyn,2163265.163,Carroll Gardens-Cobble Hill-Gowanus-Red Hook
19-Aug,36047011700,3011700,15916,52004,67920,Brooklyn,2163265.163,Carroll Gardens-Cobble Hill-Gowanus-Red Hook
21-Aug,36047011700,3011700,14361,52660,67021,Brooklyn,2163265.163,Carroll Gardens-Cobble Hill-Gowanus-Red Hook
19-May,36047014300,3014300,4928,97584,102512,Brooklyn,2335437.135,Sunset Park (West)
21-May,36047014300,3014300,17025,25908,42933,Brooklyn,2335437.135,Sunset Park (West)
19-Jun,36047014300,3014300,1835,22955,24790,Brooklyn,2335437.135,Sunset Park (West)
21-Jun,36047014300,3014300,8541,93329,101870,Brooklyn,2335437.135,Sunset Park (West)
19-Jul,36047014300,3014300,10188,128814,139002,Brooklyn,2335437.135,Sunset Park (West)
21-Jul,36047014300,3014300,1088,64385,65473,Brooklyn,2335437.135,Sunset Park (West)
19-Aug,36047014300,3014300,8476,56848,65324,Brooklyn,2335437.135,Sunset Park (West)
21-Aug,36047014300,3014300,11381,89390,100771,Brooklyn,2335437.135,Sunset Park (West)
19-May,36005021001,2021001,14442,30154,44596,Bronx,2077079.85,Parkchester
21-May,36005021001,2021001,588,4421,5009,Bronx,2077079.85,Parkchester
19-Jun,36005021001,2021001,6014,109884,115898,Bronx,2077079.85,Parkchester
21-Jun,36005021001,2021001,3688,92743,96431,Bronx,2077079.85,Parkchester
19-Jul,36005021001,2021001,12577,69085,81662,Bronx,2077079.85,Parkchester
21-Jul,36005021001,2021001,8670,149594,158264,Bronx,2077079.85,Parkchester
19-Aug,36005021001,2021001,6152,61016,67168,Bronx,2077079.85,Parkchester
21-Aug,36005021001,2021001,21376,58918,80294,Bronx,2077079.85,Parkchester
19-May,36081021900,4021900,7785,33304,41089,Queens,13806344.6,Maspeth
21-May,36081021900,4021900,15652,71,15723,Queens,13806344.6,Maspeth
19-Jun,36081021900,4021900,2514,37529,40043,Queens,13806344.6,Maspeth
21-Jun,36081021900,4021900,8182,119875,128057,Queens,13806344.6,Maspeth
19-Jul,36081021900,4021900,11308,47723,59031,Queens,13806344.6,Maspeth
21-Jul,36081021900,4021900,1605,79576,81181,Queens,13806344.6,Maspeth
19-Aug,36081021900,4021900,2512,13800,16312,Queens,13806344.6,Maspeth
21-Aug,36081021900,4021900,1465,68450,69915,Queens,13806344.6,Maspeth
19-May,36081053502,4053502,8158,86500,94658,Queens,3494827.724,Maspeth
21-May,36081053502,4053502,10386,141156,151542,Queens,3494827.724,Maspeth
19-Jun,36081053502,4053502,0,91767,91767,Queens,3494827.724,Maspeth
21-Jun,36081053502,4053502,10472,16221,26693,Queens,3494827.724,Maspeth
19-Jul,36081053502,4053502,17543,44365,61908,Queens,3494827.724,Maspeth
21-Jul,36081053502,4053502,0,56734,56734,Queens,3494827.724,Maspeth
19-Aug,36081053502,4053502,10049,88615,98664,Queens,3494827.724,Maspeth
21-Aug,36081053502,4053502,7995,79168,87163,Queens,3494827.724,Maspeth
19-May,36061000202,1000202,8280,80746,89026,Manhattan,3315114.285,Lower East Side
21-May,36061000202,1000202,9197,126803,136000,Manhattan,3315114.285,Lower East Side
19-Jun,36061000202,1000202,0,80775,80775,Manhattan,3315114.285,Lower East Side
21-Jun,36061000202,1000202,9257,120342,129599,Manhattan,3315114.285,Lower East Side
19-Jul,36061000202,1000202,15025,84514,99539,Manhattan,3315114.285,Lower East Side
21-Jul,36061000202,1000202,9793,30373,40166,Manhattan,3315114.285,Lower East Side
19-Aug,36061000202,1000202,8546,39205,47751,Manhattan,3315114.285,Lower East Side
21-Aug,36061000202,1000202,7738,114837,122575,Manhattan,3315114.285,Lower East Side
19-May,36047002100,3002100,17205,47644,64849,Brooklyn,5707270.125,Downtown Brooklyn-DUMBO-Boerum Hill
21-May,36047002100,3002100,7983,61558,69541,Brooklyn,5707270.125,Downtown Brooklyn-DUMBO-Boerum Hill
19-Jun,36047002100,3002100,14753,38509,53262,Brooklyn,5707270.125,Downtown Brooklyn-DUMBO-Boerum Hill
21-Jun,36047002100,3002100,5803,65108,70911,Brooklyn,5707270.125,Downtown Brooklyn-DUMBO-Boerum Hill
19-Jul,36047002100,3002100,9726,58566,68292,Brooklyn,5707270.125,Downtown Brooklyn-DUMBO-Boerum Hill
21-Jul,36047002100,3002100,10412,58489,68901,Brooklyn,5707270.125,Downtown Brooklyn-DUMBO-Boerum Hill
19-Aug,36047002100,3002100,10653,64420,75073,Brooklyn,5707270.125,Downtown Brooklyn-DUMBO-Boerum Hill
21-Aug,36047002100,3002100,9191,28734,37925,Brooklyn,5707270.125,Downtown Brooklyn-DUMBO-Boerum Hill
19-May,36047038700,3038700,16504,140752,157256,Brooklyn,2027988.185,Bedford-Stuyvesant (East)
21-May,36047038700,3038700,0,64072,64072,Brooklyn,2027988.185,Bedford-Stuyvesant (East)
19-Jun,36047038700,3038700,8143,155032,163175,Brooklyn,2027988.185,Bedford-Stuyvesant (East)
21-Jun,36047038700,3038700,10980,58198,69178,Brooklyn,2027988.185,Bedford-Stuyvesant (East)
19-Jul,36047038700,3038700,4692,58794,63486,Brooklyn,2027988.185,Bedford-Stuyvesant (East)
21-Jul,36047038700,3038700,12373,54936,67309,Brooklyn,2027988.185,Bedford-Stuyvesant (East)
19-Aug,36047038700,3038700,3913,36346,40259,Brooklyn,2027988.185,Bedford-Stuyvesant (East)
21-Aug,36047038700,3038700,0,32585,32585,Brooklyn,2027988.185,Bedford-Stuyvesant (East)
19-May,36047039500,3039500,10003,41233,51236,Brooklyn,1715478.626,Bushwick (East)
21-May,36047039500,3039500,6393,7068,13461,Brooklyn,1715478.626,Bushwick (East)
19-Jun,36047039500,3039500,15320,72229,87549,Brooklyn,1715478.626,Bushwick (East)
21-Jun,36047039500,3039500,3255,24051,27306,Brooklyn,1715478.626,Bushwick (East)
19-Jul,36047039500,3039500,14201,36910,51111,Brooklyn,1715478.626,Bushwick (East)
21-Jul,36047039500,3039500,13483,97366,110849,Brooklyn,1715478.626,Bushwick (East)
19-Aug,36047039500,3039500,5227,95207,100434,Brooklyn,1715478.626,Bushwick (East)
21-Aug,36047039500,3039500,10366,122192,132558,Brooklyn,1715478.626,Bushwick (East)
19-May,36047028900,3028900,9785,126416,136201,Brooklyn,1784336.197,Bedford-Stuyvesant (East)
21-May,36047028900,3028900,15051,57191,72242,Brooklyn,1784336.197,Bedford-Stuyvesant (East)
19-Jun,36047028900,3028900,2096,79978,82074,Brooklyn,1784336.197,Bedford-Stuyvesant (East)
21-Jun,36047028900,3028900,6326,69069,75395,Brooklyn,1784336.197,Bedford-Stuyvesant (East)
19-Jul,36047028900,3028900,2570,106135,108705,Brooklyn,1784336.197,Bedford-Stuyvesant (East)
21-Jul,36047028900,3028900,7424,126063,133487,Brooklyn,1784336.197,Bedford-Stuyvesant (East)
19-Aug,36047028900,3028900,4303,46793,51096,Brooklyn,1784336.197,Bedford-Stuyvesant (East)
21-Aug,36047028900,3028900,10371,85591,95962,Brooklyn,1784336.197,Bedford-Stuyvesant (East)
19-May,36047039300,3039300,10115,94965,105080,Brooklyn,2043908.716,Bushwick (West)
21-May,36047039300,3039300,16242,14959,31201,Brooklyn,2043908.716,Bushwick (West)
19-Jun,36047039300,3039300,10050,84628,94678,Brooklyn,2043908.716,Bushwick (West)
21-Jun,36047039300,3039300,10597,111830,122427,Brooklyn,2043908.716,Bushwick (West)
19-Jul,36047039300,3039300,7948,8409,16357,Brooklyn,2043908.716,Bushwick (West)
21-Jul,36047039300,3039300,9340,67640,76980,Brooklyn,2043908.716,Bushwick (West)
19-Aug,36047039300,3039300,16914,30080,46994,Brooklyn,2043908.716,Bushwick (West)
21-Aug,36047039300,3039300,8721,148796,157517,Brooklyn,2043908.716,Bushwick (West)
19-May,36081003600,4003600,0,34557,34557,Queens,1937264.607,Ozone Park (North)
21-May,36081003600,4003600,8895,68657,77552,Queens,1937264.607,Ozone Park (North)
19-Jun,36081003600,4003600,3858,39265,43123,Queens,1937264.607,Ozone Park (North)
21-Jun,36081003600,4003600,6377,140437,146814,Queens,1937264.607,Ozone Park (North)
19-Jul,36081003600,4003600,7846,82534,90380,Queens,1937264.607,Ozone Park (North)
21-Jul,36081003600,4003600,8284,118872,127156,Queens,1937264.607,Ozone Park (North)
19-Aug,36081003600,4003600,280,51158,51438,Queens,1937264.607,Ozone Park (North)
21-Aug,36081003600,4003600,12333,50396,62729,Queens,1937264.607,Ozone Park (North)
19-May,36047032700,3032700,15709,71,15780,Brooklyn,1904249.861,Prospect Lefferts Gardens-Wingate
21-May,36047032700,3032700,8082,78479,86561,Brooklyn,1904249.861,Prospect Lefferts Gardens-Wingate
19-Jun,36047032700,3032700,10861,127438,138299,Brooklyn,1904249.861,Prospect Lefferts Gardens-Wingate
21-Jun,36047032700,3032700,7818,59475,67293,Brooklyn,1904249.861,Prospect Lefferts Gardens-Wingate
19-Jul,36047032700,3032700,9395,74831,84226,Brooklyn,1904249.861,Prospect Lefferts Gardens-Wingate
21-Jul,36047032700,3032700,8449,31846,40295,Brooklyn,1904249.861,Prospect Lefferts Gardens-Wingate
19-Aug,36047032700,3032700,1084,43510,44594,Brooklyn,1904249.861,Prospect Lefferts Gardens-Wingate
21-Aug,36047032700,3032700,1746,82690,84436,Brooklyn,1904249.861,Prospect Lefferts Gardens-Wingate
19-May,36005003500,2003500,12669,117507,130176,Bronx,1525330.715,Mott Haven-Port Morris
21-May,36005003500,2003500,4894,78527,83421,Bronx,1525330.715,Mott Haven-Port Morris
19-Jun,36005003500,2003500,7771,84649,92420,Bronx,1525330.715,Mott Haven-Port Morris
21-Jun,36005003500,2003500,10116,49307,59423,Bronx,1525330.715,Mott Haven-Port Morris
19-Jul,36005003500,2003500,325,45937,46262,Bronx,1525330.715,Mott Haven-Port Morris
21-Jul,36005003500,2003500,5649,69600,75249,Bronx,1525330.715,Mott Haven-Port Morris
19-Aug,36005003500,2003500,7248,62962,70210,Bronx,1525330.715,Mott Haven-Port Morris
21-Aug,36005003500,2003500,3674,62984,66658,Bronx,1525330.715,Mott Haven-Port Morris
19-May,36005007300,2007300,7479,101777,109256,Bronx,1507611.388,Melrose
21-May,36005007300,2007300,5502,52063,57565,Bronx,1507611.388,Melrose
19-Jun,36005007300,2007300,13500,95449,108949,Bronx,1507611.388,Melrose
21-Jun,36005007300,2007300,4681,95218,99899,Bronx,1507611.388,Melrose
19-Jul,36005007300,2007300,7955,90846,98801,Bronx,1507611.388,Melrose
21-Jul,36005007300,2007300,13043,116962,130005,Bronx,1507611.388,Melrose
19-Aug,36005007300,2007300,0,23608,23608,Bronx,1507611.388,Melrose
21-Aug,36005007300,2007300,10892,90960,101852,Bronx,1507611.388,Melrose
19-May,36085007500,5007500,4025,48255,52280,Staten Island,5158898.76,West New Brighton-Silver Lake-Grymes Hill
21-May,36085007500,5007500,10150,144550,154700,Staten Island,5158898.76,West New Brighton-Silver Lake-Grymes Hill
19-Jun,36085007500,5007500,8059,64996,73055,Staten Island,5158898.76,West New Brighton-Silver Lake-Grymes Hill
21-Jun,36085007500,5007500,8565,77340,85905,Staten Island,5158898.76,West New Brighton-Silver Lake-Grymes Hill
19-Jul,36085007500,5007500,13511,19278,32789,Staten Island,5158898.76,West New Brighton-Silver Lake-Grymes Hill
21-Jul,36085007500,5007500,8244,31972,40216,Staten Island,5158898.76,West New Brighton-Silver Lake-Grymes Hill
19-Aug,36085007500,5007500,10760,53208,63968,Staten Island,5158898.76,West New Brighton-Silver Lake-Grymes Hill
21-Aug,36085007500,5007500,6874,90513,97387,Staten Island,5158898.76,West New Brighton-Silver Lake-Grymes Hill
19-May,36085007700,5007700,4365,68872,73237,Staten Island,2674908.169,St. George-New Brighton
21-May,36085007700,5007700,2196,51184,53380,Staten Island,2674908.169,St. George-New Brighton
19-Jun,36085007700,5007700,11532,28029,39561,Staten Island,2674908.169,St. George-New Brighton
21-Jun,36085007700,5007700,3403,55887,59290,Staten Island,2674908.169,St. George-New Brighton
19-Jul,36085007700,5007700,9200,126674,135874,Staten Island,2674908.169,St. George-New Brighton
21-Jul,36085007700,5007700,6877,43477,50354,Staten Island,2674908.169,St. George-New Brighton
19-Aug,36085007700,5007700,3859,24822,28681,Staten Island,2674908.169,St. George-New Brighton
21-Aug,36085007700,5007700,6922,95870,102792,Staten Island,2674908.169,St. George-New Brighton
19-May,36081001902,4001902,5180,42729,47909,Queens,1909109.976,Long Island City-Hunters Point
21-May,36081001902,4001902,10828,75048,85876,Queens,1909109.976,Long Island City-Hunters Point
19-Jun,36081001902,4001902,3734,103141,106875,Queens,1909109.976,Long Island City-Hunters Point
21-Jun,36081001902,4001902,4705,39098,43803,Queens,1909109.976,Long Island City-Hunters Point
19-Jul,36081001902,4001902,5405,113995,119400,Queens,1909109.976,Long Island City-Hunters Point
21-Jul,36081001902,4001902,2377,114425,116802,Queens,1909109.976,Long Island City-Hunters Point
19-Aug,36081001902,4001902,6814,103355,110169,Queens,1909109.976,Long Island City-Hunters Point
21-Aug,36081001902,4001902,6265,88286,94551,Queens,1909109.976,Long Island City-Hunters Point
19-May,36081047500,4047500,10165,113741,123906,Queens,3028835.984,Elmhurst
21-May,36081047500,4047500,12162,37744,49906,Queens,3028835.984,Elmhurst
19-Jun,36081047500,4047500,10885,62329,73214,Queens,3028835.984,Elmhurst
21-Jun,36081047500,4047500,4925,72195,77120,Queens,3028835.984,Elmhurst
19-Jul,36081047500,4047500,4785,110409,115194,Queens,3028835.984,Elmhurst
21-Jul,36081047500,4047500,10039,110079,120118,Queens,3028835.984,Elmhurst
19-Aug,36081047500,4047500,4336,78773,83109,Queens,3028835.984,Elmhurst
21-Aug,36081047500,4047500,6203,110838,117041,Queens,3028835.984,Elmhurst
19-May,36085014100,5014100,7721,97206,104927,Staten Island,3338848.526,Port Richmond
21-May,36085014100,5014100,21835,71,21906,Staten Island,3338848.526,Port Richmond
19-Jun,36085014100,5014100,7592,118477,126069,Staten Island,3338848.526,Port Richmond
21-Jun,36085014100,5014100,2326,49443,51769,Staten Island,3338848.526,Port Richmond
19-Jul,36085014100,5014100,9689,20121,29810,Staten Island,3338848.526,Port Richmond
21-Jul,36085014100,5014100,14539,49316,63855,Staten Island,3338848.526,Port Richmond
19-Aug,36085014100,5014100,7790,98599,106389,Staten Island,3338848.526,Port Richmond
21-Aug,36085014100,5014100,10359,66137,76496,Staten Island,3338848.526,Port Richmond
19-May,36085012500,5012500,13388,54392,67780,Staten Island,4952180.295,West New Brighton-Silver Lake-Grymes Hill
21-May,36085012500,5012500,6698,18445,25143,Staten Island,4952180.295,West New Brighton-Silver Lake-Grymes Hill
19-Jun,36085012500,5012500,4093,59821,63914,Staten Island,4952180.295,West New Brighton-Silver Lake-Grymes Hill
21-Jun,36085012500,5012500,6946,16243,23189,Staten Island,4952180.295,West New Brighton-Silver Lake-Grymes Hill
19-Jul,36085012500,5012500,8432,77261,85693,Staten Island,4952180.295,West New Brighton-Silver Lake-Grymes Hill
21-Jul,36085012500,5012500,7521,53242,60763,Staten Island,4952180.295,West New Brighton-Silver Lake-Grymes Hill
19-Aug,36085012500,5012500,16063,94992,111055,Staten Island,4952180.295,West New Brighton-Silver Lake-Grymes Hill
21-Aug,36085012500,5012500,15177,50270,65447,Staten Island,4952180.295,West New Brighton-Silver Lake-Grymes Hill
19-May,36085014700,5014700,2682,65243,67925,Staten Island,17978117.84,Westerleigh-Castleton Corners
21-May,36085014700,5014700,17833,44850,62683,Staten Island,17978117.84,Westerleigh-Castleton Corners
19-Jun,36085014700,5014700,0,104093,104093,Staten Island,17978117.84,Westerleigh-Castleton Corners
21-Jun,36085014700,5014700,11622,64580,76202,Staten Island,17978117.84,Westerleigh-Castleton Corners
19-Jul,36085014700,5014700,12987,47799,60786,Staten Island,17978117.84,Westerleigh-Castleton Corners
21-Jul,36085014700,5014700,10748,79723,90471,Staten Island,17978117.84,Westerleigh-Castleton Corners
19-Aug,36085014700,5014700,13121,30054,43175,Staten Island,17978117.84,Westerleigh-Castleton Corners
21-Aug,36085014700,5014700,11469,61910,73379,Staten Island,17978117.84,Westerleigh-Castleton Corners
19-May,36061000800,1000800,16756,54936,71692,Manhattan,2377774.575,Chinatown-Two Bridges
21-May,36061000800,1000800,12815,25948,38763,Manhattan,2377774.575,Chinatown-Two Bridges
19-Jun,36061000800,1000800,5090,87707,92797,Manhattan,2377774.575,Chinatown-Two Bridges
21-Jun,36061000800,1000800,15292,57852,73144,Manhattan,2377774.575,Chinatown-Two Bridges
19-Jul,36061000800,1000800,13840,73463,87303,Manhattan,2377774.575,Chinatown-Two Bridges
21-Jul,36061000800,1000800,11100,89404,100504,Manhattan,2377774.575,Chinatown-Two Bridges
19-Aug,36061000800,1000800,7733,109773,117506,Manhattan,2377774.575,Chinatown-Two Bridges
21-Aug,36061000800,1000800,9395,65008,74403,Manhattan,2377774.575,Chinatown-Two Bridges
19-May,36047036502,3036502,8062,43176,51238,Brooklyn,1316867.713,Ocean Hill
21-May,36047036502,3036502,1445,58919,60364,Brooklyn,1316867.713,Ocean Hill
19-Jun,36047036502,3036502,7360,33801,41161,Brooklyn,1316867.713,Ocean Hill
21-Jun,36047036502,3036502,4763,66615,71378,Brooklyn,1316867.713,Ocean Hill
19-Jul,36047036502,3036502,1217,80178,81395,Brooklyn,1316867.713,Ocean Hill
21-Jul,36047036502,3036502,15046,64245,79291,Brooklyn,1316867.713,Ocean Hill
19-Aug,36047036502,3036502,4758,107058,111816,Brooklyn,1316867.713,Ocean Hill
21-Aug,36047036502,3036502,15725,53379,69104,Brooklyn,1316867.713,Ocean Hill
19-May,36061006200,1006200,0,61724,61724,Manhattan,3167924.507,Murray Hill-Kips Bay
21-May,36061006200,1006200,4436,75085,79521,Manhattan,3167924.507,Murray Hill-Kips Bay
19-Jun,36061006200,1006200,12902,65180,78082,Manhattan,3167924.507,Murray Hill-Kips Bay
21-Jun,36061006200,1006200,14127,63598,77725,Manhattan,3167924.507,Murray Hill-Kips Bay
19-Jul,36061006200,1006200,9376,96633,106009,Manhattan,3167924.507,Murray Hill-Kips Bay
21-Jul,36061006200,1006200,5012,71,5083,Manhattan,3167924.507,Murray Hill-Kips Bay
19-Aug,36061006200,1006200,6518,34033,40551,Manhattan,3167924.507,Murray Hill-Kips Bay
21-Aug,36061006200,1006200,15239,84377,99616,Manhattan,3167924.507,Murray Hill-Kips Bay
19-May,36047056302,3056302,4843,61747,66590,Brooklyn,2050580.935,Greenpoint
21-May,36047056302,3056302,16383,82652,99035,Brooklyn,2050580.935,Greenpoint
19-Jun,36047056302,3056302,18124,138824,156948,Brooklyn,2050580.935,Greenpoint
21-Jun,36047056302,3056302,15227,60648,75875,Brooklyn,2050580.935,Greenpoint
19-Jul,36047056302,3056302,18354,48723,67077,Brooklyn,2050580.935,Greenpoint
21-Jul,36047056302,3056302,12521,44763,57284,Brooklyn,2050580.935,Greenpoint
19-Aug,36047056302,3056302,6684,74725,81409,Brooklyn,2050580.935,Greenpoint
21-Aug,36047056302,3056302,12155,115743,127898,Brooklyn,2050580.935,Greenpoint
19-May,36081103201,4103201,3694,112341,116035,Queens,4311253.43,Far Rockaway-Bayswater
21-May,36081103201,4103201,9715,63441,73156,Queens,4311253.43,Far Rockaway-Bayswater
19-Jun,36081103201,4103201,5383,12799,18182,Queens,4311253.43,Far Rockaway-Bayswater
21-Jun,36081103201,4103201,14204,13249,27453,Queens,4311253.43,Far Rockaway-Bayswater
19-Jul,36081103201,4103201,478,82880,83358,Queens,4311253.43,Far Rockaway-Bayswater
21-Jul,36081103201,4103201,6203,16974,23177,Queens,4311253.43,Far Rockaway-Bayswater
19-Aug,36081103201,4103201,7707,28635,36342,Queens,4311253.43,Far Rockaway-Bayswater
21-Aug,36081103201,4103201,4877,88742,93619,Queens,4311253.43,Far Rockaway-Bayswater
19-May,36081103202,4103202,2878,102690,105568,Queens,7674612.929,Far Rockaway-Bayswater
21-May,36081103202,4103202,13159,123235,136394,Queens,7674612.929,Far Rockaway-Bayswater
19-Jun,36081103202,4103202,7945,93234,101179,Queens,7674612.929,Far Rockaway-Bayswater
21-Jun,36081103202,4103202,11343,71,11414,Queens,7674612.929,Far Rockaway-Bayswater
19-Jul,36081103202,4103202,7219,39369,46588,Queens,7674612.929,Far Rockaway-Bayswater
21-Jul,36081103202,4103202,11648,106032,117680,Queens,7674612.929,Far Rockaway-Bayswater
19-Aug,36081103202,4103202,6069,110870,116939,Queens,7674612.929,Far Rockaway-Bayswater
21-Aug,36081103202,4103202,9698,36909,46607,Queens,7674612.929,Far Rockaway-Bayswater
19-May,36005004100,2004100,15642,81136,96778,Bronx,1977775.591,Mott Haven-Port Morris
21-May,36005004100,2004100,1330,74645,75975,Bronx,1977775.591,Mott Haven-Port Morris
19-Jun,36005004100,2004100,5160,110177,115337,Bronx,1977775.591,Mott Haven-Port Morris
21-Jun,36005004100,2004100,12395,101614,114009,Bronx,1977775.591,Mott Haven-Port Morris
19-Jul,36005004100,2004100,3475,100504,103979,Bronx,1977775.591,Mott Haven-Port Morris
21-Jul,36005004100,2004100,5354,24923,30277,Bronx,1977775.591,Mott Haven-Port Morris
19-Aug,36005004100,2004100,3718,77260,80978,Bronx,1977775.591,Mott Haven-Port Morris
21-Aug,36005004100,2004100,6045,68880,74925,Bronx,1977775.591,Mott Haven-Port Morris
19-May,36005004300,2004300,8635,120278,128913,Bronx,2441015.713,Mott Haven-Port Morris
21-May,36005004300,2004300,3468,65078,68546,Bronx,2441015.713,Mott Haven-Port Morris
19-Jun,36005004300,2004300,5394,90672,96066,Bronx,2441015.713,Mott Haven-Port Morris
21-Jun,36005004300,2004300,8732,68315,77047,Bronx,2441015.713,Mott Haven-Port Morris
19-Jul,36005004300,2004300,1857,89326,91183,Bronx,2441015.713,Mott Haven-Port Morris
21-Jul,36005004300,2004300,9558,73206,82764,Bronx,2441015.713,Mott Haven-Port Morris
19-Aug,36005004300,2004300,9086,112549,121635,Bronx,2441015.713,Mott Haven-Port Morris
21-Aug,36005004300,2004300,12434,56864,69298,Bronx,2441015.713,Mott Haven-Port Morris
19-May,36047095400,3095400,7546,95430,102976,Brooklyn,2551621.364,Canarsie
21-May,36047095400,3095400,12298,76861,89159,Brooklyn,2551621.364,Canarsie
19-Jun,36047095400,3095400,1539,71,1610,Brooklyn,2551621.364,Canarsie
21-Jun,36047095400,3095400,9510,72850,82360,Brooklyn,2551621.364,Canarsie
19-Jul,36047095400,3095400,16285,72782,89067,Brooklyn,2551621.364,Canarsie
21-Jul,36047095400,3095400,14718,13836,28554,Brooklyn,2551621.364,Canarsie
19-Aug,36047095400,3095400,0,59425,59425,Brooklyn,2551621.364,Canarsie
21-Aug,36047095400,3095400,3527,130292,133819,Brooklyn,2551621.364,Canarsie
19-May,36047096000,3096000,7187,76062,83249,Brooklyn,4573323.611,Canarsie
21-May,36047096000,3096000,1535,97744,99279,Brooklyn,4573323.611,Canarsie
19-Jun,36047096000,3096000,1416,46725,48141,Brooklyn,4573323.611,Canarsie
21-Jun,36047096000,3096000,7279,77247,84526,Brooklyn,4573323.611,Canarsie
19-Jul,36047096000,3096000,9029,71241,80270,Brooklyn,4573323.611,Canarsie
21-Jul,36047096000,3096000,12525,71,12596,Brooklyn,4573323.611,Canarsie
19-Aug,36047096000,3096000,6817,28320,35137,Brooklyn,4573323.611,Canarsie
21-Aug,36047096000,3096000,10451,50778,61229,Brooklyn,4573323.611,Canarsie
19-May,36047057901,3057901,7326,98029,105355,Brooklyn,2643877.275,Greenpoint
21-May,36047057901,3057901,4540,137905,142445,Brooklyn,2643877.275,Greenpoint
19-Jun,36047057901,3057901,5121,76463,81584,Brooklyn,2643877.275,Greenpoint
21-Jun,36047057901,3057901,11702,79413,91115,Brooklyn,2643877.275,Greenpoint
19-Jul,36047057901,3057901,11483,86576,98059,Brooklyn,2643877.275,Greenpoint
21-Jul,36047057901,3057901,6345,91631,97976,Brooklyn,2643877.275,Greenpoint
19-Aug,36047057901,3057901,2490,86041,88531,Brooklyn,2643877.275,Greenpoint
21-Aug,36047057901,3057901,12560,33114,45674,Brooklyn,2643877.275,Greenpoint
19-May,36047057902,3057902,9350,70297,79647,Brooklyn,5305925.132,Greenpoint
21-May,36047057902,3057902,9192,82426,91618,Brooklyn,5305925.132,Greenpoint
19-Jun,36047057902,3057902,6624,94772,101396,Brooklyn,5305925.132,Greenpoint
21-Jun,36047057902,3057902,13538,71,13609,Brooklyn,5305925.132,Greenpoint
19-Jul,36047057902,3057902,6061,103464,109525,Brooklyn,5305925.132,Greenpoint
21-Jul,36047057902,3057902,8908,61292,70200,Brooklyn,5305925.132,Greenpoint
19-Aug,36047057902,3057902,2184,71,2255,Brooklyn,5305925.132,Greenpoint
21-Aug,36047057902,3057902,10233,29379,39612,Brooklyn,5305925.132,Greenpoint
19-May,36047099600,3099600,0,69077,69077,Brooklyn,2043824.084,Canarsie
21-May,36047099600,3099600,11150,44918,56068,Brooklyn,2043824.084,Canarsie
19-Jun,36047099600,3099600,6313,50457,56770,Brooklyn,2043824.084,Canarsie
21-Jun,36047099600,3099600,9207,91997,101204,Brooklyn,2043824.084,Canarsie
19-Jul,36047099600,3099600,5239,37265,42504,Brooklyn,2043824.084,Canarsie
21-Jul,36047099600,3099600,5077,98356,103433,Brooklyn,2043824.084,Canarsie
19-Aug,36047099600,3099600,5763,53075,58838,Brooklyn,2043824.084,Canarsie
21-Aug,36047099600,3099600,7913,103357,111270,Brooklyn,2043824.084,Canarsie
19-May,36047099800,3099800,15298,107651,122949,Brooklyn,4644482.759,Canarsie
21-May,36047099800,3099800,16305,66994,83299,Brooklyn,4644482.759,Canarsie
19-Jun,36047099800,3099800,0,88427,88427,Brooklyn,4644482.759,Canarsie
21-Jun,36047099800,3099800,2224,104746,106970,Brooklyn,4644482.759,Canarsie
19-Jul,36047099800,3099800,15476,76898,92374,Brooklyn,4644482.759,Canarsie
21-Jul,36047099800,3099800,6327,99630,105957,Brooklyn,4644482.759,Canarsie
19-Aug,36047099800,3099800,9566,44826,54392,Brooklyn,4644482.759,Canarsie
21-Aug,36047099800,3099800,14080,25512,39592,Brooklyn,4644482.759,Canarsie
19-May,36081017101,4017101,8610,74053,82663,Queens,8783519.114,Sunnyside Yards (South)
21-May,36081017101,4017101,0,85771,85771,Queens,8783519.114,Sunnyside Yards (South)
19-Jun,36081017101,4017101,0,31647,31647,Queens,8783519.114,Sunnyside Yards (South)
21-Jun,36081017101,4017101,17451,58224,75675,Queens,8783519.114,Sunnyside Yards (South)
19-Jul,36081017101,4017101,17277,107795,125072,Queens,8783519.114,Sunnyside Yards (South)
21-Jul,36081017101,4017101,9056,121479,130535,Queens,8783519.114,Sunnyside Yards (South)
19-Aug,36081017101,4017101,8772,70544,79316,Queens,8783519.114,Sunnyside Yards (South)
21-Aug,36081017101,4017101,18550,130963,149513,Queens,8783519.114,Sunnyside Yards (South)
19-May,36081017102,4017102,13206,87543,100749,Queens,4500282.29,Sunnyside Yards (North)
21-May,36081017102,4017102,9652,30858,40510,Queens,4500282.29,Sunnyside Yards (North)
19-Jun,36081017102,4017102,19116,119285,138401,Queens,4500282.29,Sunnyside Yards (North)
21-Jun,36081017102,4017102,8441,43584,52025,Queens,4500282.29,Sunnyside Yards (North)
19-Jul,36081017102,4017102,1945,55134,57079,Queens,4500282.29,Sunnyside Yards (North)
21-Jul,36081017102,4017102,8195,36386,44581,Queens,4500282.29,Sunnyside Yards (North)
19-Aug,36081017102,4017102,11312,61891,73203,Queens,4500282.29,Sunnyside Yards (North)
21-Aug,36081017102,4017102,12193,62584,74777,Queens,4500282.29,Sunnyside Yards (North)
19-May,36061010602,1010602,8022,89889,97911,Manhattan,1336810.853,Upper East Side-Lenox Hill-Roosevelt Island
21-May,36061010602,1010602,7016,118912,125928,Manhattan,1336810.853,Upper East Side-Lenox Hill-Roosevelt Island
19-Jun,36061010602,1010602,5258,106693,111951,Manhattan,1336810.853,Upper East Side-Lenox Hill-Roosevelt Island
21-Jun,36061010602,1010602,17742,81659,99401,Manhattan,1336810.853,Upper East Side-Lenox Hill-Roosevelt Island
19-Jul,36061010602,1010602,7069,93779,100848,Manhattan,1336810.853,Upper East Side-Lenox Hill-Roosevelt Island
21-Jul,36061010602,1010602,11022,71,11093,Manhattan,1336810.853,Upper East Side-Lenox Hill-Roosevelt Island
19-Aug,36061010602,1010602,3451,13822,17273,Manhattan,1336810.853,Upper East Side-Lenox Hill-Roosevelt Island
21-Aug,36061010602,1010602,9551,30228,39779,Manhattan,1336810.853,Upper East Side-Lenox Hill-Roosevelt Island
19-May,36061011600,1011600,5120,91613,96733,Manhattan,2117552.785,Upper East Side-Lenox Hill-Roosevelt Island
21-May,36061011600,1011600,7368,154978,162346,Manhattan,2117552.785,Upper East Side-Lenox Hill-Roosevelt Island
19-Jun,36061011600,1011600,16098,13766,29864,Manhattan,2117552.785,Upper East Side-Lenox Hill-Roosevelt Island
21-Jun,36061011600,1011600,7534,37810,45344,Manhattan,2117552.785,Upper East Side-Lenox Hill-Roosevelt Island
19-Jul,36061011600,1011600,7914,9440,17354,Manhattan,2117552.785,Upper East Side-Lenox Hill-Roosevelt Island
21-Jul,36061011600,1011600,8883,43932,52815,Manhattan,2117552.785,Upper East Side-Lenox Hill-Roosevelt Island
19-Aug,36061011600,1011600,16214,90666,106880,Manhattan,2117552.785,Upper East Side-Lenox Hill-Roosevelt Island
21-Aug,36061011600,1011600,4770,42588,47358,Manhattan,2117552.785,Upper East Side-Lenox Hill-Roosevelt Island
19-May,36061011401,1011401,11845,132438,144283,Manhattan,1060696.277,Upper East Side-Carnegie Hill
21-May,36061011401,1011401,6800,111757,118557,Manhattan,1060696.277,Upper East Side-Carnegie Hill
19-Jun,36061011401,1011401,5459,17731,23190,Manhattan,1060696.277,Upper East Side-Carnegie Hill
21-Jun,36061011401,1011401,9738,21844,31582,Manhattan,1060696.277,Upper East Side-Carnegie Hill
19-Jul,36061011401,1011401,5974,28786,34760,Manhattan,1060696.277,Upper East Side-Carnegie Hill
21-Jul,36061011401,1011401,9400,83332,92732,Manhattan,1060696.277,Upper East Side-Carnegie Hill
19-Aug,36061011401,1011401,8416,99220,107636,Manhattan,1060696.277,Upper East Side-Carnegie Hill
21-Aug,36061011401,1011401,13295,61637,74932,Manhattan,1060696.277,Upper East Side-Carnegie Hill
19-May,36005023800,2023800,5316,38278,43594,Bronx,3659519.696,Pelham Parkway-Van Nest
21-May,36005023800,2023800,995,125348,126343,Bronx,3659519.696,Pelham Parkway-Van Nest
19-Jun,36005023800,2023800,10674,83541,94215,Bronx,3659519.696,Pelham Parkway-Van Nest
21-Jun,36005023800,2023800,3609,77752,81361,Bronx,3659519.696,Pelham Parkway-Van Nest
19-Jul,36005023800,2023800,6821,91122,97943,Bronx,3659519.696,Pelham Parkway-Van Nest
21-Jul,36005023800,2023800,901,62842,63743,Bronx,3659519.696,Pelham Parkway-Van Nest
19-Aug,36005023800,2023800,7337,76471,83808,Bronx,3659519.696,Pelham Parkway-Van Nest
21-Aug,36005023800,2023800,3899,70875,74774,Bronx,3659519.696,Pelham Parkway-Van Nest
19-May,36005024000,2024000,12498,42801,55299,Bronx,2572874.345,Pelham Parkway-Van Nest
21-May,36005024000,2024000,11520,108968,120488,Bronx,2572874.345,Pelham Parkway-Van Nest
19-Jun,36005024000,2024000,581,51687,52268,Bronx,2572874.345,Pelham Parkway-Van Nest
21-Jun,36005024000,2024000,6296,89865,96161,Bronx,2572874.345,Pelham Parkway-Van Nest
19-Jul,36005024000,2024000,10771,91340,102111,Bronx,2572874.345,Pelham Parkway-Van Nest
21-Jul,36005024000,2024000,16811,48850,65661,Bronx,2572874.345,Pelham Parkway-Van Nest
19-Aug,36005024000,2024000,4902,19025,23927,Bronx,2572874.345,Pelham Parkway-Van Nest
21-Aug,36005024000,2024000,10802,122403,133205,Bronx,2572874.345,Pelham Parkway-Van Nest
19-May,36061029100,1029100,7702,37534,45236,Manhattan,2018094.023,Inwood
21-May,36061029100,1029100,16622,75045,91667,Manhattan,2018094.023,Inwood
19-Jun,36061029100,1029100,9448,39779,49227,Manhattan,2018094.023,Inwood
21-Jun,36061029100,1029100,15464,79911,95375,Manhattan,2018094.023,Inwood
19-Jul,36061029100,1029100,3746,72079,75825,Manhattan,2018094.023,Inwood
21-Jul,36061029100,1029100,5579,30414,35993,Manhattan,2018094.023,Inwood
19-Aug,36061029100,1029100,11290,106361,117651,Manhattan,2018094.023,Inwood
21-Aug,36061029100,1029100,1420,34633,36053,Manhattan,2018094.023,Inwood
19-May,36081099100,4099100,10301,109884,120185,Queens,11676757.46,Whitestone-Beechhurst
21-May,36081099100,4099100,6479,71,6550,Queens,11676757.46,Whitestone-Beechhurst
19-Jun,36081099100,4099100,0,65725,65725,Queens,11676757.46,Whitestone-Beechhurst
21-Jun,36081099100,4099100,9788,154252,164040,Queens,11676757.46,Whitestone-Beechhurst
19-Jul,36081099100,4099100,9389,85004,94393,Queens,11676757.46,Whitestone-Beechhurst
21-Jul,36081099100,4099100,17524,42926,60450,Queens,11676757.46,Whitestone-Beechhurst
19-Aug,36081099100,4099100,217,107129,107346,Queens,11676757.46,Whitestone-Beechhurst
21-Aug,36081099100,4099100,4960,37997,42957,Queens,11676757.46,Whitestone-Beechhurst
19-May,36081099705,4099705,14687,74889,89576,Queens,4729593.132,Bay Terrace-Clearview
21-May,36081099705,4099705,11845,76793,88638,Queens,4729593.132,Bay Terrace-Clearview
19-Jun,36081099705,4099705,4724,54629,59353,Queens,4729593.132,Bay Terrace-Clearview
21-Jun,36081099705,4099705,6556,140356,146912,Queens,4729593.132,Bay Terrace-Clearview
19-Jul,36081099705,4099705,5291,42721,48012,Queens,4729593.132,Bay Terrace-Clearview
21-Jul,36081099705,4099705,11998,104773,116771,Queens,4729593.132,Bay Terrace-Clearview
19-Aug,36081099705,4099705,990,141374,142364,Queens,4729593.132,Bay Terrace-Clearview
21-Aug,36081099705,4099705,14155,85599,99754,Queens,4729593.132,Bay Terrace-Clearview
19-May,36005033500,2033500,2382,120254,122636,Bronx,7482812.268,Riverdale-Spuyten Duyvil
21-May,36005033500,2033500,2671,114620,117291,Bronx,7482812.268,Riverdale-Spuyten Duyvil
19-Jun,36005033500,2033500,12664,71,12735,Bronx,7482812.268,Riverdale-Spuyten Duyvil
21-Jun,36005033500,2033500,8784,72350,81134,Bronx,7482812.268,Riverdale-Spuyten Duyvil
19-Jul,36005033500,2033500,7469,107259,114728,Bronx,7482812.268,Riverdale-Spuyten Duyvil
21-Jul,36005033500,2033500,1093,83017,84110,Bronx,7482812.268,Riverdale-Spuyten Duyvil
19-Aug,36005033500,2033500,9269,71,9340,Bronx,7482812.268,Riverdale-Spuyten Duyvil
21-Aug,36005033500,2033500,6196,83695,89891,Bronx,7482812.268,Riverdale-Spuyten Duyvil
19-May,36005035100,2035100,18245,102612,120857,Bronx,6238607.008,Riverdale-Spuyten Duyvil
21-May,36005035100,2035100,16870,115451,132321,Bronx,6238607.008,Riverdale-Spuyten Duyvil
19-Jun,36005035100,2035100,13590,72647,86237,Bronx,6238607.008,Riverdale-Spuyten Duyvil
21-Jun,36005035100,2035100,7637,63313,70950,Bronx,6238607.008,Riverdale-Spuyten Duyvil
19-Jul,36005035100,2035100,8733,44019,52752,Bronx,6238607.008,Riverdale-Spuyten Duyvil
21-Jul,36005035100,2035100,14851,54099,68950,Bronx,6238607.008,Riverdale-Spuyten Duyvil
19-Aug,36005035100,2035100,7650,65367,73017,Bronx,6238607.008,Riverdale-Spuyten Duyvil
21-Aug,36005035100,2035100,9624,46438,56062,Bronx,6238607.008,Riverdale-Spuyten Duyvil
19-May,36061023802,1023802,6794,142660,149454,Manhattan,2581833.881,Upper East Side-Lenox Hill-Roosevelt Island
21-May,36061023802,1023802,0,45477,45477,Manhattan,2581833.881,Upper East Side-Lenox Hill-Roosevelt Island
19-Jun,36061023802,1023802,6825,1741,8566,Manhattan,2581833.881,Upper East Side-Lenox Hill-Roosevelt Island
21-Jun,36061023802,1023802,7751,36821,44572,Manhattan,2581833.881,Upper East Side-Lenox Hill-Roosevelt Island
19-Jul,36061023802,1023802,3228,65474,68702,Manhattan,2581833.881,Upper East Side-Lenox Hill-Roosevelt Island
21-Jul,36061023802,1023802,8176,53073,61249,Manhattan,2581833.881,Upper East Side-Lenox Hill-Roosevelt Island
19-Aug,36061023802,1023802,11583,67155,78738,Manhattan,2581833.881,Upper East Side-Lenox Hill-Roosevelt Island
21-Aug,36061023802,1023802,12709,92094,104803,Manhattan,2581833.881,Upper East Side-Lenox Hill-Roosevelt Island
19-May,36061023803,1023803,11424,64235,75659,Manhattan,1105152.947,Upper East Side-Lenox Hill-Roosevelt Island
21-May,36061023803,1023803,6132,51946,58078,Manhattan,1105152.947,Upper East Side-Lenox Hill-Roosevelt Island
19-Jun,36061023803,1023803,14402,73562,87964,Manhattan,1105152.947,Upper East Side-Lenox Hill-Roosevelt Island
21-Jun,36061023803,1023803,16975,188566,205541,Manhattan,1105152.947,Upper East Side-Lenox Hill-Roosevelt Island
19-Jul,36061023803,1023803,9375,65324,74699,Manhattan,1105152.947,Upper East Side-Lenox Hill-Roosevelt Island
21-Jul,36061023803,1023803,7894,78932,86826,Manhattan,1105152.947,Upper East Side-Lenox Hill-Roosevelt Island
19-Aug,36061023803,1023803,12746,63722,76468,Manhattan,1105152.947,Upper East Side-Lenox Hill-Roosevelt Island
21-Aug,36061023803,1023803,6458,112997,119455,Manhattan,1105152.947,Upper East Side-Lenox Hill-Roosevelt Island
19-May,36085001800,5001800,14502,38788,53290,Staten Island,9867249.104,Fort Wadsworth
21-May,36085001800,5001800,11651,8601,20252,Staten Island,9867249.104,Fort Wadsworth
19-Jun,36085001800,5001800,13771,26125,39896,Staten Island,9867249.104,Fort Wadsworth
21-Jun,36085001800,5001800,14524,15363,29887,Staten Island,9867249.104,Fort Wadsworth
19-Jul,36085001800,5001800,7087,87979,95066,Staten Island,9867249.104,Fort Wadsworth
21-Jul,36085001800,5001800,16424,78714,95138,Staten Island,9867249.104,Fort Wadsworth
19-Aug,36085001800,5001800,9574,78999,88573,Staten Island,9867249.104,Fort Wadsworth
21-Aug,36085001800,5001800,8638,145761,154399,Staten Island,9867249.104,Fort Wadsworth
19-May,36005011800,2011800,7293,66415,73708,Bronx,10849463.01,Throgs Neck-Schuylerville
21-May,36005011800,2011800,7314,29603,36917,Bronx,10849463.01,Throgs Neck-Schuylerville
19-Jun,36005011800,2011800,3925,72749,76674,Bronx,10849463.01,Throgs Neck-Schuylerville
21-Jun,36005011800,2011800,8711,41097,49808,Bronx,10849463.01,Throgs Neck-Schuylerville
19-Jul,36005011800,2011800,9493,246,9739,Bronx,10849463.01,Throgs Neck-Schuylerville
21-Jul,36005011800,2011800,8297,20568,28865,Bronx,10849463.01,Throgs Neck-Schuylerville
19-Aug,36005011800,2011800,9715,56714,66429,Bronx,10849463.01,Throgs Neck-Schuylerville
21-Aug,36005011800,2011800,9579,71,9650,Bronx,10849463.01,Throgs Neck-Schuylerville
19-May,36005013800,2013800,1271,48750,50021,Bronx,8319740.733,Throgs Neck-Schuylerville
21-May,36005013800,2013800,39,148630,148669,Bronx,8319740.733,Throgs Neck-Schuylerville
19-Jun,36005013800,2013800,1802,104187,105989,Bronx,8319740.733,Throgs Neck-Schuylerville
21-Jun,36005013800,2013800,3342,30624,33966,Bronx,8319740.733,Throgs Neck-Schuylerville
19-Jul,36005013800,2013800,0,129588,129588,Bronx,8319740.733,Throgs Neck-Schuylerville
21-Jul,36005013800,2013800,742,68309,69051,Bronx,8319740.733,Throgs Neck-Schuylerville
19-Aug,36005013800,2013800,11740,90721,102461,Bronx,8319740.733,Throgs Neck-Schuylerville
21-Aug,36005013800,2013800,10810,34299,45109,Bronx,8319740.733,Throgs Neck-Schuylerville
19-May,36085002002,5002002,7465,97959,105424,Staten Island,8280213.15,Grasmere-Arrochar-South Beach-Dongan Hills
21-May,36085002002,5002002,10036,47331,57367,Staten Island,8280213.15,Grasmere-Arrochar-South Beach-Dongan Hills
19-Jun,36085002002,5002002,6078,91558,97636,Staten Island,8280213.15,Grasmere-Arrochar-South Beach-Dongan Hills
21-Jun,36085002002,5002002,8730,77908,86638,Staten Island,8280213.15,Grasmere-Arrochar-South Beach-Dongan Hills
19-Jul,36085002002,5002002,15051,61971,77022,Staten Island,8280213.15,Grasmere-Arrochar-South Beach-Dongan Hills
21-Jul,36085002002,5002002,0,127828,127828,Staten Island,8280213.15,Grasmere-Arrochar-South Beach-Dongan Hills
19-Aug,36085002002,5002002,7018,14366,21384,Staten Island,8280213.15,Grasmere-Arrochar-South Beach-Dongan Hills
21-Aug,36085002002,5002002,11766,37032,48798,Staten Island,8280213.15,Grasmere-Arrochar-South Beach-Dongan Hills
19-May,36061001501,1001501,5449,88368,93817,Manhattan,2955567.684,Financial District-Battery Park City
21-May,36061001501,1001501,11647,72361,84008,Manhattan,2955567.684,Financial District-Battery Park City
19-Jun,36061001501,1001501,3311,61374,64685,Manhattan,2955567.684,Financial District-Battery Park City
21-Jun,36061001501,1001501,10302,52601,62903,Manhattan,2955567.684,Financial District-Battery Park City
19-Jul,36061001501,1001501,8604,96280,104884,Manhattan,2955567.684,Financial District-Battery Park City
21-Jul,36061001501,1001501,11458,76535,87993,Manhattan,2955567.684,Financial District-Battery Park City
19-Aug,36061001501,1001501,9700,117699,127399,Manhattan,2955567.684,Financial District-Battery Park City
21-Aug,36061001501,1001501,10555,88064,98619,Manhattan,2955567.684,Financial District-Battery Park City
19-May,36061002901,1002901,6232,54455,60687,Manhattan,1561370.417,Tribeca-Civic Center
21-May,36061002901,1002901,20519,96628,117147,Manhattan,1561370.417,Tribeca-Civic Center
19-Jun,36061002901,1002901,10122,34281,44403,Manhattan,1561370.417,Tribeca-Civic Center
21-Jun,36061002901,1002901,6923,162072,168995,Manhattan,1561370.417,Tribeca-Civic Center
19-Jul,36061002901,1002901,18523,30068,48591,Manhattan,1561370.417,Tribeca-Civic Center
21-Jul,36061002901,1002901,6892,110301,117193,Manhattan,1561370.417,Tribeca-Civic Center
19-Aug,36061002901,1002901,14225,47300,61525,Manhattan,1561370.417,Tribeca-Civic Center
21-Aug,36061002901,1002901,17411,112491,129902,Manhattan,1561370.417,Tribeca-Civic Center
19-May,36061002700,1002700,6200,107495,113695,Manhattan,641369.1648,Chinatown-Two Bridges
21-May,36061002700,1002700,4454,73993,78447,Manhattan,641369.1648,Chinatown-Two Bridges
19-Jun,36061002700,1002700,7246,10258,17504,Manhattan,641369.1648,Chinatown-Two Bridges
21-Jun,36061002700,1002700,2113,81590,83703,Manhattan,641369.1648,Chinatown-Two Bridges
19-Jul,36061002700,1002700,5767,50770,56537,Manhattan,641369.1648,Chinatown-Two Bridges
21-Jul,36061002700,1002700,7453,39624,47077,Manhattan,641369.1648,Chinatown-Two Bridges
19-Aug,36061002700,1002700,7154,134424,141578,Manhattan,641369.1648,Chinatown-Two Bridges
21-Aug,36061002700,1002700,11239,77053,88292,Manhattan,641369.1648,Chinatown-Two Bridges
19-May,36061002902,1002902,3624,84572,88196,Manhattan,1327605.154,Chinatown-Two Bridges
21-May,36061002902,1002902,0,80054,80054,Manhattan,1327605.154,Chinatown-Two Bridges
19-Jun,36061002902,1002902,8526,100571,109097,Manhattan,1327605.154,Chinatown-Two Bridges
21-Jun,36061002902,1002902,8224,126841,135065,Manhattan,1327605.154,Chinatown-Two Bridges
19-Jul,36061002902,1002902,9494,58572,68066,Manhattan,1327605.154,Chinatown-Two Bridges
21-Jul,36061002902,1002902,7346,88370,95716,Manhattan,1327605.154,Chinatown-Two Bridges
19-Aug,36061002902,1002902,7574,30851,38425,Manhattan,1327605.154,Chinatown-Two Bridges
21-Aug,36061002902,1002902,0,49280,49280,Manhattan,1327605.154,Chinatown-Two Bridges
19-May,36047062600,3062600,7259,33966,41225,Brooklyn,3425960.965,Sheepshead Bay-Manhattan Beach-Gerritsen Beach
21-May,36047062600,3062600,7010,66361,73371,Brooklyn,3425960.965,Sheepshead Bay-Manhattan Beach-Gerritsen Beach
19-Jun,36047062600,3062600,17091,79826,96917,Brooklyn,3425960.965,Sheepshead Bay-Manhattan Beach-Gerritsen Beach
21-Jun,36047062600,3062600,1960,73935,75895,Brooklyn,3425960.965,Sheepshead Bay-Manhattan Beach-Gerritsen Beach
19-Jul,36047062600,3062600,9303,152446,161749,Brooklyn,3425960.965,Sheepshead Bay-Manhattan Beach-Gerritsen Beach
21-Jul,36047062600,3062600,12703,145023,157726,Brooklyn,3425960.965,Sheepshead Bay-Manhattan Beach-Gerritsen Beach
19-Aug,36047062600,3062600,3008,13976,16984,Brooklyn,3425960.965,Sheepshead Bay-Manhattan Beach-Gerritsen Beach
21-Aug,36047062600,3062600,7763,100330,108093,Brooklyn,3425960.965,Sheepshead Bay-Manhattan Beach-Gerritsen Beach
19-May,36047062800,3062800,8494,71198,79692,Brooklyn,8304005.119,Sheepshead Bay-Manhattan Beach-Gerritsen Beach
21-May,36047062800,3062800,3700,35725,39425,Brooklyn,8304005.119,Sheepshead Bay-Manhattan Beach-Gerritsen Beach
19-Jun,36047062800,3062800,14973,53877,68850,Brooklyn,8304005.119,Sheepshead Bay-Manhattan Beach-Gerritsen Beach
21-Jun,36047062800,3062800,16510,42954,59464,Brooklyn,8304005.119,Sheepshead Bay-Manhattan Beach-Gerritsen Beach
19-Jul,36047062800,3062800,11479,2477,13956,Brooklyn,8304005.119,Sheepshead Bay-Manhattan Beach-Gerritsen Beach
21-Jul,36047062800,3062800,2716,126243,128959,Brooklyn,8304005.119,Sheepshead Bay-Manhattan Beach-Gerritsen Beach
19-Aug,36047062800,3062800,15771,19399,35170,Brooklyn,8304005.119,Sheepshead Bay-Manhattan Beach-Gerritsen Beach
21-Aug,36047062800,3062800,14504,58329,72833,Brooklyn,8304005.119,Sheepshead Bay-Manhattan Beach-Gerritsen Beach
19-May,36085011204,5011204,11279,62998,74277,Staten Island,10866804.35,Miller Field
21-May,36085011204,5011204,11369,128371,139740,Staten Island,10866804.35,Miller Field
19-Jun,36085011204,5011204,17262,42951,60213,Staten Island,10866804.35,Miller Field
21-Jun,36085011204,5011204,4786,34330,39116,Staten Island,10866804.35,Miller Field
19-Jul,36085011204,5011204,0,90293,90293,Staten Island,10866804.35,Miller Field
21-Jul,36085011204,5011204,15529,52860,68389,Staten Island,10866804.35,Miller Field
19-Aug,36085011204,5011204,7025,60634,67659,Staten Island,10866804.35,Miller Field
21-Aug,36085011204,5011204,13896,53709,67605,Staten Island,10866804.35,Miller Field
19-May,36085012804,5012804,5646,47577,53223,Staten Island,9446184.751,New Dorp-Midland Beach
21-May,36085012804,5012804,12987,94283,107270,Staten Island,9446184.751,New Dorp-Midland Beach
19-Jun,36085012804,5012804,0,69110,69110,Staten Island,9446184.751,New Dorp-Midland Beach
21-Jun,36085012804,5012804,7632,50956,58588,Staten Island,9446184.751,New Dorp-Midland Beach
19-Jul,36085012804,5012804,5382,121559,126941,Staten Island,9446184.751,New Dorp-Midland Beach
21-Jul,36085012804,5012804,7567,165089,172656,Staten Island,9446184.751,New Dorp-Midland Beach
19-Aug,36085012804,5012804,13562,87156,100718,Staten Island,9446184.751,New Dorp-Midland Beach
21-Aug,36085012804,5012804,12800,938,13738,Staten Island,9446184.751,New Dorp-Midland Beach
19-May,36047066200,3066200,14298,98498,112796,Brooklyn,2488662.739,Marine Park-Mill Basin-Bergen Beach
21-May,36047066200,3066200,2289,91288,93577,Brooklyn,2488662.739,Marine Park-Mill Basin-Bergen Beach
19-Jun,36047066200,3066200,9050,68527,77577,Brooklyn,2488662.739,Marine Park-Mill Basin-Bergen Beach
21-Jun,36047066200,3066200,12013,84403,96416,Brooklyn,2488662.739,Marine Park-Mill Basin-Bergen Beach
19-Jul,36047066200,3066200,0,94964,94964,Brooklyn,2488662.739,Marine Park-Mill Basin-Bergen Beach
21-Jul,36047066200,3066200,3498,84067,87565,Brooklyn,2488662.739,Marine Park-Mill Basin-Bergen Beach
19-Aug,36047066200,3066200,1582,18726,20308,Brooklyn,2488662.739,Marine Park-Mill Basin-Bergen Beach
21-Aug,36047066200,3066200,15607,107198,122805,Brooklyn,2488662.739,Marine Park-Mill Basin-Bergen Beach
19-May,36047017700,3017700,13623,53496,67119,Brooklyn,27324218.96,Prospect Park
21-May,36047017700,3017700,5799,135706,141505,Brooklyn,27324218.96,Prospect Park
19-Jun,36047017700,3017700,14705,86399,101104,Brooklyn,27324218.96,Prospect Park
21-Jun,36047017700,3017700,2381,73955,76336,Brooklyn,27324218.96,Prospect Park
19-Jul,36047017700,3017700,9168,32292,41460,Brooklyn,27324218.96,Prospect Park
21-Jul,36047017700,3017700,2163,57437,59600,Brooklyn,27324218.96,Prospect Park
19-Aug,36047017700,3017700,4239,83932,88171,Brooklyn,27324218.96,Prospect Park
21-Aug,36047017700,3017700,9402,74353,83755,Brooklyn,27324218.96,Prospect Park
19-May,36047050401,3050401,4678,156379,161057,Brooklyn,1564161.084,Windsor Terrace-South Slope
21-May,36047050401,3050401,12746,108883,121629,Brooklyn,1564161.084,Windsor Terrace-South Slope
19-Jun,36047050401,3050401,10286,95595,105881,Brooklyn,1564161.084,Windsor Terrace-South Slope
21-Jun,36047050401,3050401,9019,137814,146833,Brooklyn,1564161.084,Windsor Terrace-South Slope
19-Jul,36047050401,3050401,9909,112419,122328,Brooklyn,1564161.084,Windsor Terrace-South Slope
21-Jul,36047050401,3050401,8070,78164,86234,Brooklyn,1564161.084,Windsor Terrace-South Slope
19-Aug,36047050401,3050401,11895,71,11966,Brooklyn,1564161.084,Windsor Terrace-South Slope
21-Aug,36047050401,3050401,3841,100680,104521,Brooklyn,1564161.084,Windsor Terrace-South Slope
19-May,36005032300,2032300,5106,160936,166042,Bronx,6019623.379,Riverdale-Spuyten Duyvil
21-May,36005032300,2032300,13782,80934,94716,Bronx,6019623.379,Riverdale-Spuyten Duyvil
19-Jun,36005032300,2032300,8684,116094,124778,Bronx,6019623.379,Riverdale-Spuyten Duyvil
21-Jun,36005032300,2032300,17065,89909,106974,Bronx,6019623.379,Riverdale-Spuyten Duyvil
19-Jul,36005032300,2032300,1312,65273,66585,Bronx,6019623.379,Riverdale-Spuyten Duyvil
21-Jul,36005032300,2032300,8124,40021,48145,Bronx,6019623.379,Riverdale-Spuyten Duyvil
19-Aug,36005032300,2032300,10602,59343,69945,Bronx,6019623.379,Riverdale-Spuyten Duyvil
21-Aug,36005032300,2032300,5518,99818,105336,Bronx,6019623.379,Riverdale-Spuyten Duyvil
19-May,36005033700,2033700,11313,42883,54196,Bronx,4629811.105,Riverdale-Spuyten Duyvil
21-May,36005033700,2033700,7066,76916,83982,Bronx,4629811.105,Riverdale-Spuyten Duyvil
19-Jun,36005033700,2033700,7488,28734,36222,Bronx,4629811.105,Riverdale-Spuyten Duyvil
21-Jun,36005033700,2033700,2161,115072,117233,Bronx,4629811.105,Riverdale-Spuyten Duyvil
19-Jul,36005033700,2033700,2320,38533,40853,Bronx,4629811.105,Riverdale-Spuyten Duyvil
21-Jul,36005033700,2033700,14984,63910,78894,Bronx,4629811.105,Riverdale-Spuyten Duyvil
19-Aug,36005033700,2033700,15781,102267,118048,Bronx,4629811.105,Riverdale-Spuyten Duyvil
21-Aug,36005033700,2033700,14488,16426,30914,Bronx,4629811.105,Riverdale-Spuyten Duyvil
19-May,36061002400,1002400,2168,98706,100874,Manhattan,1863566.817,East Village
21-May,36061002400,1002400,6735,148623,155358,Manhattan,1863566.817,East Village
19-Jun,36061002400,1002400,17884,90395,108279,Manhattan,1863566.817,East Village
21-Jun,36061002400,1002400,18092,100914,119006,Manhattan,1863566.817,East Village
19-Jul,36061002400,1002400,17095,33020,50115,Manhattan,1863566.817,East Village
21-Jul,36061002400,1002400,5120,46206,51326,Manhattan,1863566.817,East Village
19-Aug,36061002400,1002400,13442,72441,85883,Manhattan,1863566.817,East Village
21-Aug,36061002400,1002400,6213,71,6284,Manhattan,1863566.817,East Village
19-May,36081001400,4001400,5865,146345,152210,Queens,2306342.603,Woodhaven
21-May,36081001400,4001400,9451,108054,117505,Queens,2306342.603,Woodhaven
19-Jun,36081001400,4001400,7798,53476,61274,Queens,2306342.603,Woodhaven
21-Jun,36081001400,4001400,0,80215,80215,Queens,2306342.603,Woodhaven
19-Jul,36081001400,4001400,13691,65845,79536,Queens,2306342.603,Woodhaven
21-Jul,36081001400,4001400,710,76871,77581,Queens,2306342.603,Woodhaven
19-Aug,36081001400,4001400,10231,78762,88993,Queens,2306342.603,Woodhaven
21-Aug,36081001400,4001400,3396,92850,96246,Queens,2306342.603,Woodhaven
19-May,36081002200,4002200,9282,103883,113165,Queens,1594381.789,Woodhaven
21-May,36081002200,4002200,18575,103050,121625,Queens,1594381.789,Woodhaven
19-Jun,36081002200,4002200,8113,145585,153698,Queens,1594381.789,Woodhaven
21-Jun,36081002200,4002200,14018,41922,55940,Queens,1594381.789,Woodhaven
19-Jul,36081002200,4002200,5667,66365,72032,Queens,1594381.789,Woodhaven
21-Jul,36081002200,4002200,12187,27281,39468,Queens,1594381.789,Woodhaven
19-Aug,36081002200,4002200,7365,140013,147378,Queens,1594381.789,Woodhaven
21-Aug,36081002200,4002200,11923,75569,87492,Queens,1594381.789,Woodhaven
19-May,36081001800,4001800,9246,52169,61415,Queens,1914375.438,Woodhaven
21-May,36081001800,4001800,8022,54918,62940,Queens,1914375.438,Woodhaven
19-Jun,36081001800,4001800,9805,111584,121389,Queens,1914375.438,Woodhaven
21-Jun,36081001800,4001800,5268,54749,60017,Queens,1914375.438,Woodhaven
19-Jul,36081001800,4001800,7963,36105,44068,Queens,1914375.438,Woodhaven
21-Jul,36081001800,4001800,0,71,71,Queens,1914375.438,Woodhaven
19-Aug,36081001800,4001800,8703,70712,79415,Queens,1914375.438,Woodhaven
21-Aug,36081001800,4001800,11005,27095,38100,Queens,1914375.438,Woodhaven
19-May,36081002000,4002000,9200,47534,56734,Queens,1577804.689,Woodhaven
21-May,36081002000,4002000,10469,2270,12739,Queens,1577804.689,Woodhaven
19-Jun,36081002000,4002000,4752,108058,112810,Queens,1577804.689,Woodhaven
21-Jun,36081002000,4002000,8584,46409,54993,Queens,1577804.689,Woodhaven
19-Jul,36081002000,4002000,6067,35632,41699,Queens,1577804.689,Woodhaven
21-Jul,36081002000,4002000,10701,68274,78975,Queens,1577804.689,Woodhaven
19-Aug,36081002000,4002000,9656,77693,87349,Queens,1577804.689,Woodhaven
21-Aug,36081002000,4002000,6782,121931,128713,Queens,1577804.689,Woodhaven
19-May,36061031900,1031900,4741,79775,84516,Manhattan,1077040.154,The Battery-Governors Island-Ellis Island-Liberty Island
21-May,36061031900,1031900,7613,84601,92214,Manhattan,1077040.154,The Battery-Governors Island-Ellis Island-Liberty Island
19-Jun,36061031900,1031900,8197,46739,54936,Manhattan,1077040.154,The Battery-Governors Island-Ellis Island-Liberty Island
21-Jun,36061031900,1031900,15334,187821,203155,Manhattan,1077040.154,The Battery-Governors Island-Ellis Island-Liberty Island
19-Jul,36061031900,1031900,12523,70670,83193,Manhattan,1077040.154,The Battery-Governors Island-Ellis Island-Liberty Island
21-Jul,36061031900,1031900,10992,80432,91424,Manhattan,1077040.154,The Battery-Governors Island-Ellis Island-Liberty Island
19-Aug,36061031900,1031900,7096,76482,83578,Manhattan,1077040.154,The Battery-Governors Island-Ellis Island-Liberty Island
21-Aug,36061031900,1031900,7300,91530,98830,Manhattan,1077040.154,The Battery-Governors Island-Ellis Island-Liberty Island
19-May,36061021100,1021100,7131,21927,29058,Manhattan,3738242.611,Morningside Heights
21-May,36061021100,1021100,5918,63840,69758,Manhattan,3738242.611,Morningside Heights
19-Jun,36061021100,1021100,7513,33881,41394,Manhattan,3738242.611,Morningside Heights
21-Jun,36061021100,1021100,7170,44873,52043,Manhattan,3738242.611,Morningside Heights
19-Jul,36061021100,1021100,14596,84687,99283,Manhattan,3738242.611,Morningside Heights
21-Jul,36061021100,1021100,7419,17240,24659,Manhattan,3738242.611,Morningside Heights
19-Aug,36061021100,1021100,12591,62781,75372,Manhattan,3738242.611,Morningside Heights
21-Aug,36061021100,1021100,5757,70076,75833,Manhattan,3738242.611,Morningside Heights
19-May,36061021900,1021900,10917,140449,151366,Manhattan,3005263.723,Manhattanville-West Harlem
21-May,36061021900,1021900,12169,48435,60604,Manhattan,3005263.723,Manhattanville-West Harlem
19-Jun,36061021900,1021900,5268,67294,72562,Manhattan,3005263.723,Manhattanville-West Harlem
21-Jun,36061021900,1021900,12724,47244,59968,Manhattan,3005263.723,Manhattanville-West Harlem
19-Jul,36061021900,1021900,8898,88544,97442,Manhattan,3005263.723,Manhattanville-West Harlem
21-Jul,36061021900,1021900,2665,52553,55218,Manhattan,3005263.723,Manhattanville-West Harlem
19-Aug,36061021900,1021900,3769,71,3840,Manhattan,3005263.723,Manhattanville-West Harlem
21-Aug,36061021900,1021900,3466,36064,39530,Manhattan,3005263.723,Manhattanville-West Harlem
19-May,36081066404,4066404,12334,128377,140711,Queens,10975233.18,Springfield Gardens (South)-Brookville
21-May,36081066404,4066404,8902,83738,92640,Queens,10975233.18,Springfield Gardens (South)-Brookville
19-Jun,36081066404,4066404,7552,59669,67221,Queens,10975233.18,Springfield Gardens (South)-Brookville
21-Jun,36081066404,4066404,5069,42752,47821,Queens,10975233.18,Springfield Gardens (South)-Brookville
19-Jul,36081066404,4066404,5851,115935,121786,Queens,10975233.18,Springfield Gardens (South)-Brookville
21-Jul,36081066404,4066404,8421,33219,41640,Queens,10975233.18,Springfield Gardens (South)-Brookville
19-Aug,36081066404,4066404,4998,83450,88448,Queens,10975233.18,Springfield Gardens (South)-Brookville
21-Aug,36081066404,4066404,11992,29967,41959,Queens,10975233.18,Springfield Gardens (South)-Brookville
19-May,36047001801,3001801,6414,118418,124832,Brooklyn,5139571.284,Sunset Park (West)
21-May,36047001801,3001801,10589,176367,186956,Brooklyn,5139571.284,Sunset Park (West)
19-Jun,36047001801,3001801,0,81248,81248,Brooklyn,5139571.284,Sunset Park (West)
21-Jun,36047001801,3001801,9848,74824,84672,Brooklyn,5139571.284,Sunset Park (West)
19-Jul,36047001801,3001801,7550,98585,106135,Brooklyn,5139571.284,Sunset Park (West)
21-Jul,36047001801,3001801,3121,118789,121910,Brooklyn,5139571.284,Sunset Park (West)
19-Aug,36047001801,3001801,10261,36175,46436,Brooklyn,5139571.284,Sunset Park (West)
21-Aug,36047001801,3001801,16835,41877,58712,Brooklyn,5139571.284,Sunset Park (West)
19-May,36047005302,3005302,7654,42396,50050,Brooklyn,8312250.03,Carroll Gardens-Cobble Hill-Gowanus-Red Hook
21-May,36047005302,3005302,15558,20698,36256,Brooklyn,8312250.03,Carroll Gardens-Cobble Hill-Gowanus-Red Hook
19-Jun,36047005302,3005302,6274,18994,25268,Brooklyn,8312250.03,Carroll Gardens-Cobble Hill-Gowanus-Red Hook
21-Jun,36047005302,3005302,1482,76762,78244,Brooklyn,8312250.03,Carroll Gardens-Cobble Hill-Gowanus-Red Hook
19-Jul,36047005302,3005302,6775,53388,60163,Brooklyn,8312250.03,Carroll Gardens-Cobble Hill-Gowanus-Red Hook
21-Jul,36047005302,3005302,13022,89203,102225,Brooklyn,8312250.03,Carroll Gardens-Cobble Hill-Gowanus-Red Hook
19-Aug,36047005302,3005302,4524,55548,60072,Brooklyn,8312250.03,Carroll Gardens-Cobble Hill-Gowanus-Red Hook
21-Aug,36047005302,3005302,6393,138643,145036,Brooklyn,8312250.03,Carroll Gardens-Cobble Hill-Gowanus-Red Hook
19-May,36005051601,2051601,15352,77427,92779,Bronx,12452707.9,Pelham Bay-Country Club-City Island
21-May,36005051601,2051601,8157,68363,76520,Bronx,12452707.9,Pelham Bay-Country Club-City Island
19-Jun,36005051601,2051601,8903,75323,84226,Bronx,12452707.9,Pelham Bay-Country Club-City Island
21-Jun,36005051601,2051601,0,188712,188712,Bronx,12452707.9,Pelham Bay-Country Club-City Island
19-Jul,36005051601,2051601,9341,1458,10799,Bronx,12452707.9,Pelham Bay-Country Club-City Island
21-Jul,36005051601,2051601,0,74799,74799,Bronx,12452707.9,Pelham Bay-Country Club-City Island
19-Aug,36005051601,2051601,275,69548,69823,Bronx,12452707.9,Pelham Bay-Country Club-City Island
21-Aug,36005051601,2051601,8107,12112,20219,Bronx,12452707.9,Pelham Bay-Country Club-City Island
19-May,36005051602,2051602,9052,35382,44434,Bronx,4905129.201,Hart Island
21-May,36005051602,2051602,5650,134242,139892,Bronx,4905129.201,Hart Island
19-Jun,36005051602,2051602,7085,53992,61077,Bronx,4905129.201,Hart Island
21-Jun,36005051602,2051602,9503,138868,148371,Bronx,4905129.201,Hart Island
19-Jul,36005051602,2051602,10165,57232,67397,Bronx,4905129.201,Hart Island
21-Jul,36005051602,2051602,3369,143880,147249,Bronx,4905129.201,Hart Island
19-Aug,36005051602,2051602,5183,78969,84152,Bronx,4905129.201,Hart Island
21-Aug,36005051602,2051602,4652,71,4723,Bronx,4905129.201,Hart Island
19-May,36047036700,3036700,4633,117454,122087,Brooklyn,1961097.788,Ocean Hill
21-May,36047036700,3036700,0,50513,50513,Brooklyn,1961097.788,Ocean Hill
19-Jun,36047036700,3036700,8010,83816,91826,Brooklyn,1961097.788,Ocean Hill
21-Jun,36047036700,3036700,19433,76836,96269,Brooklyn,1961097.788,Ocean Hill
19-Jul,36047036700,3036700,9890,114173,124063,Brooklyn,1961097.788,Ocean Hill
21-Jul,36047036700,3036700,5490,52949,58439,Brooklyn,1961097.788,Ocean Hill
19-Aug,36047036700,3036700,6028,53627,59655,Brooklyn,1961097.788,Ocean Hill
21-Aug,36047036700,3036700,5818,105495,111313,Brooklyn,1961097.788,Ocean Hill
19-May,36081021601,4021601,3170,122179,125349,Queens,2454621.661,Kew Gardens
21-May,36081021601,4021601,8235,156260,164495,Queens,2454621.661,Kew Gardens
19-Jun,36081021601,4021601,5757,63919,69676,Queens,2454621.661,Kew Gardens
21-Jun,36081021601,4021601,9827,105166,114993,Queens,2454621.661,Kew Gardens
19-Jul,36081021601,4021601,4403,95575,99978,Queens,2454621.661,Kew Gardens
21-Jul,36081021601,4021601,10783,119544,130327,Queens,2454621.661,Kew Gardens
19-Aug,36081021601,4021601,14134,71,14205,Queens,2454621.661,Kew Gardens
21-Aug,36081021601,4021601,4050,107937,111987,Queens,2454621.661,Kew Gardens
19-May,36061009903,1009903,13017,22263,35280,Manhattan,4533958.774,Chelsea-Hudson Yards
21-May,36061009903,1009903,6947,118125,125072,Manhattan,4533958.774,Chelsea-Hudson Yards
19-Jun,36061009903,1009903,4622,25660,30282,Manhattan,4533958.774,Chelsea-Hudson Yards
21-Jun,36061009903,1009903,4986,13891,18877,Manhattan,4533958.774,Chelsea-Hudson Yards
19-Jul,36061009903,1009903,6830,87491,94321,Manhattan,4533958.774,Chelsea-Hudson Yards
21-Jul,36061009903,1009903,4572,50464,55036,Manhattan,4533958.774,Chelsea-Hudson Yards
19-Aug,36061009903,1009903,2572,14081,16653,Manhattan,4533958.774,Chelsea-Hudson Yards
21-Aug,36061009903,1009903,15503,70026,85529,Manhattan,4533958.774,Chelsea-Hudson Yards
19-May,36061010300,1010300,15038,19032,34070,Manhattan,1875852.823,Chelsea-Hudson Yards
21-May,36061010300,1010300,5989,107070,113059,Manhattan,1875852.823,Chelsea-Hudson Yards
19-Jun,36061010300,1010300,7554,85607,93161,Manhattan,1875852.823,Chelsea-Hudson Yards
21-Jun,36061010300,1010300,5909,84487,90396,Manhattan,1875852.823,Chelsea-Hudson Yards
19-Jul,36061010300,1010300,4333,70370,74703,Manhattan,1875852.823,Chelsea-Hudson Yards
21-Jul,36061010300,1010300,11996,45206,57202,Manhattan,1875852.823,Chelsea-Hudson Yards
19-Aug,36061010300,1010300,0,39581,39581,Manhattan,1875852.823,Chelsea-Hudson Yards
21-Aug,36061010300,1010300,4499,65216,69715,Manhattan,1875852.823,Chelsea-Hudson Yards
19-May,36061011100,1011100,5185,81788,86973,Manhattan,1889083.369,Chelsea-Hudson Yards
21-May,36061011100,1011100,13318,71,13389,Manhattan,1889083.369,Chelsea-Hudson Yards
19-Jun,36061011100,1011100,9929,89958,99887,Manhattan,1889083.369,Chelsea-Hudson Yards
21-Jun,36061011100,1011100,9766,100730,110496,Manhattan,1889083.369,Chelsea-Hudson Yards
19-Jul,36061011100,1011100,13506,99960,113466,Manhattan,1889083.369,Chelsea-Hudson Yards
21-Jul,36061011100,1011100,8143,71234,79377,Manhattan,1889083.369,Chelsea-Hudson Yards
19-Aug,36061011100,1011100,5384,151443,156827,Manhattan,1889083.369,Chelsea-Hudson Yards
21-Aug,36061011100,1011100,11847,99625,111472,Manhattan,1889083.369,Chelsea-Hudson Yards
19-May,36081003700,4003700,14321,61267,75588,Queens,4154203.051,Queensbridge-Ravenswood-Dutch Kills
21-May,36081003700,4003700,8724,102728,111452,Queens,4154203.051,Queensbridge-Ravenswood-Dutch Kills
19-Jun,36081003700,4003700,10524,50357,60881,Queens,4154203.051,Queensbridge-Ravenswood-Dutch Kills
21-Jun,36081003700,4003700,8405,79456,87861,Queens,4154203.051,Queensbridge-Ravenswood-Dutch Kills
19-Jul,36081003700,4003700,2691,36127,38818,Queens,4154203.051,Queensbridge-Ravenswood-Dutch Kills
21-Jul,36081003700,4003700,3375,40696,44071,Queens,4154203.051,Queensbridge-Ravenswood-Dutch Kills
19-Aug,36081003700,4003700,3113,77160,80273,Queens,4154203.051,Queensbridge-Ravenswood-Dutch Kills
21-Aug,36081003700,4003700,5232,115014,120246,Queens,4154203.051,Queensbridge-Ravenswood-Dutch Kills
19-May,36061023804,1023804,10431,81966,92397,Manhattan,2625975.482,Upper East Side-Lenox Hill-Roosevelt Island
21-May,36061023804,1023804,4089,24923,29012,Manhattan,2625975.482,Upper East Side-Lenox Hill-Roosevelt Island
19-Jun,36061023804,1023804,3423,134292,137715,Manhattan,2625975.482,Upper East Side-Lenox Hill-Roosevelt Island
21-Jun,36061023804,1023804,9660,25608,35268,Manhattan,2625975.482,Upper East Side-Lenox Hill-Roosevelt Island
19-Jul,36061023804,1023804,0,46891,46891,Manhattan,2625975.482,Upper East Side-Lenox Hill-Roosevelt Island
21-Jul,36061023804,1023804,6320,64664,70984,Manhattan,2625975.482,Upper East Side-Lenox Hill-Roosevelt Island
19-Aug,36061023804,1023804,7443,75872,83315,Manhattan,2625975.482,Upper East Side-Lenox Hill-Roosevelt Island
21-Aug,36061023804,1023804,3009,44785,47794,Manhattan,2625975.482,Upper East Side-Lenox Hill-Roosevelt Island
19-May,36061019200,1019200,7668,67460,75128,Manhattan,2038683.494,East Harlem (North)
21-May,36061019200,1019200,10385,71,10456,Manhattan,2038683.494,East Harlem (North)
19-Jun,36061019200,1019200,10692,31965,42657,Manhattan,2038683.494,East Harlem (North)
21-Jun,36061019200,1019200,7119,27273,34392,Manhattan,2038683.494,East Harlem (North)
19-Jul,36061019200,1019200,7811,153003,160814,Manhattan,2038683.494,East Harlem (North)
21-Jul,36061019200,1019200,4967,90082,95049,Manhattan,2038683.494,East Harlem (North)
19-Aug,36061019200,1019200,14071,11211,25282,Manhattan,2038683.494,East Harlem (North)
21-Aug,36061019200,1019200,9942,132760,142702,Manhattan,2038683.494,East Harlem (North)
19-May,36061024500,1024500,18825,94234,113059,Manhattan,2284357.758,Washington Heights (South)
21-May,36061024500,1024500,0,138381,138381,Manhattan,2284357.758,Washington Heights (South)
19-Jun,36061024500,1024500,6170,87791,93961,Manhattan,2284357.758,Washington Heights (South)
21-Jun,36061024500,1024500,11012,71607,82619,Manhattan,2284357.758,Washington Heights (South)
19-Jul,36061024500,1024500,0,49635,49635,Manhattan,2284357.758,Washington Heights (South)
21-Jul,36061024500,1024500,8516,32457,40973,Manhattan,2284357.758,Washington Heights (South)
19-Aug,36061024500,1024500,8406,113380,121786,Manhattan,2284357.758,Washington Heights (South)
21-Aug,36061024500,1024500,2561,70252,72813,Manhattan,2284357.758,Washington Heights (South)
19-May,36061025100,1025100,1518,44272,45790,Manhattan,1716083.596,Washington Heights (South)
21-May,36061025100,1025100,9361,23031,32392,Manhattan,1716083.596,Washington Heights (South)
19-Jun,36061025100,1025100,9825,94188,104013,Manhattan,1716083.596,Washington Heights (South)
21-Jun,36061025100,1025100,13400,85500,98900,Manhattan,1716083.596,Washington Heights (South)
19-Jul,36061025100,1025100,22102,76757,98859,Manhattan,1716083.596,Washington Heights (South)
21-Jul,36061025100,1025100,7577,65541,73118,Manhattan,1716083.596,Washington Heights (South)
19-Aug,36061025100,1025100,9439,88750,98189,Manhattan,1716083.596,Washington Heights (South)
21-Aug,36061025100,1025100,10107,29630,39737,Manhattan,1716083.596,Washington Heights (South)
19-May,36081029100,4029100,15897,69553,85450,Queens,2813950.594,Jackson Heights
21-May,36081029100,4029100,10328,71,10399,Queens,2813950.594,Jackson Heights
19-Jun,36081029100,4029100,10760,136007,146767,Queens,2813950.594,Jackson Heights
21-Jun,36081029100,4029100,14594,78505,93099,Queens,2813950.594,Jackson Heights
19-Jul,36081029100,4029100,4028,126236,130264,Queens,2813950.594,Jackson Heights
21-Jul,36081029100,4029100,9055,114000,123055,Queens,2813950.594,Jackson Heights
19-Aug,36081029100,4029100,6669,86870,93539,Queens,2813950.594,Jackson Heights
21-Aug,36081029100,4029100,6339,72456,78795,Queens,2813950.594,Jackson Heights
19-May,36081029300,4029300,3798,43358,47156,Queens,1628949.058,Woodside
21-May,36081029300,4029300,7740,88890,96630,Queens,1628949.058,Woodside
19-Jun,36081029300,4029300,3767,81848,85615,Queens,1628949.058,Woodside
21-Jun,36081029300,4029300,9555,114334,123889,Queens,1628949.058,Woodside
19-Jul,36081029300,4029300,7617,71,7688,Queens,1628949.058,Woodside
21-Jul,36081029300,4029300,12454,70528,82982,Queens,1628949.058,Woodside
19-Aug,36081029300,4029300,11656,8113,19769,Queens,1628949.058,Woodside
21-Aug,36081029300,4029300,0,71507,71507,Queens,1628949.058,Woodside
19-May,36047049900,3049900,20364,113673,134037,Brooklyn,1530256.86,Greenpoint
21-May,36047049900,3049900,0,64437,64437,Brooklyn,1530256.86,Greenpoint
19-Jun,36047049900,3049900,11045,45214,56259,Brooklyn,1530256.86,Greenpoint
21-Jun,36047049900,3049900,15454,64094,79548,Brooklyn,1530256.86,Greenpoint
19-Jul,36047049900,3049900,13450,125483,138933,Brooklyn,1530256.86,Greenpoint
21-Jul,36047049900,3049900,3102,92419,95521,Brooklyn,1530256.86,Greenpoint
19-Aug,36047049900,3049900,12313,82067,94380,Brooklyn,1530256.86,Greenpoint
21-Aug,36047049900,3049900,13169,35001,48170,Brooklyn,1530256.86,Greenpoint
19-May,36047050100,3050100,1730,54755,56485,Brooklyn,1857456.032,East Williamsburg
21-May,36047050100,3050100,15885,14517,30402,Brooklyn,1857456.032,East Williamsburg
19-Jun,36047050100,3050100,23783,93846,117629,Brooklyn,1857456.032,East Williamsburg
21-Jun,36047050100,3050100,5062,143855,148917,Brooklyn,1857456.032,East Williamsburg
19-Jul,36047050100,3050100,3462,87417,90879,Brooklyn,1857456.032,East Williamsburg
21-Jul,36047050100,3050100,7625,71394,79019,Brooklyn,1857456.032,East Williamsburg
19-Aug,36047050100,3050100,7124,47162,54286,Brooklyn,1857456.032,East Williamsburg
21-Aug,36047050100,3050100,14907,90403,105310,Brooklyn,1857456.032,East Williamsburg
19-May,36047051500,3051500,16421,9483,25904,Brooklyn,2013938.665,Williamsburg
21-May,36047051500,3051500,4521,71,4592,Brooklyn,2013938.665,Williamsburg
19-Jun,36047051500,3051500,8360,104190,112550,Brooklyn,2013938.665,Williamsburg
21-Jun,36047051500,3051500,12811,64784,77595,Brooklyn,2013938.665,Williamsburg
19-Jul,36047051500,3051500,8490,104006,112496,Brooklyn,2013938.665,Williamsburg
21-Jul,36047051500,3051500,9117,86219,95336,Brooklyn,2013938.665,Williamsburg
19-Aug,36047051500,3051500,8497,64806,73303,Brooklyn,2013938.665,Williamsburg
21-Aug,36047051500,3051500,15927,71,15998,Brooklyn,2013938.665,Williamsburg
19-May,36005040900,2040900,10572,44098,54670,Bronx,12556714.87,Bedford Park
21-May,36005040900,2040900,3093,81137,84230,Bronx,12556714.87,Bedford Park
19-Jun,36005040900,2040900,0,82265,82265,Bronx,12556714.87,Bedford Park
21-Jun,36005040900,2040900,14901,31084,45985,Bronx,12556714.87,Bedford Park
19-Jul,36005040900,2040900,14131,25347,39478,Bronx,12556714.87,Bedford Park
21-Jul,36005040900,2040900,8780,39486,48266,Bronx,12556714.87,Bedford Park
19-Aug,36005040900,2040900,3123,74289,77412,Bronx,12556714.87,Bedford Park
21-Aug,36005040900,2040900,7459,24798,32257,Bronx,12556714.87,Bedford Park
19-May,36005042100,2042100,6432,69956,76388,Bronx,2673341.918,Norwood
21-May,36005042100,2042100,7738,91909,99647,Bronx,2673341.918,Norwood
19-Jun,36005042100,2042100,6665,123793,130458,Bronx,2673341.918,Norwood
21-Jun,36005042100,2042100,13472,97667,111139,Bronx,2673341.918,Norwood
19-Jul,36005042100,2042100,0,93791,93791,Bronx,2673341.918,Norwood
21-Jul,36005042100,2042100,5430,58515,63945,Bronx,2673341.918,Norwood
19-Aug,36005042100,2042100,13228,58386,71614,Bronx,2673341.918,Norwood
21-Aug,36005042100,2042100,4485,102768,107253,Bronx,2673341.918,Norwood
19-May,36085015603,5015603,5019,152091,157110,Staten Island,10220108.41,Great Kills-Eltingville
21-May,36085015603,5015603,2344,69004,71348,Staten Island,10220108.41,Great Kills-Eltingville
19-Jun,36085015603,5015603,12844,75358,88202,Staten Island,10220108.41,Great Kills-Eltingville
21-Jun,36085015603,5015603,12770,54297,67067,Staten Island,10220108.41,Great Kills-Eltingville
19-Jul,36085015603,5015603,12059,74231,86290,Staten Island,10220108.41,Great Kills-Eltingville
21-Jul,36085015603,5015603,7927,9000,16927,Staten Island,10220108.41,Great Kills-Eltingville
19-Aug,36085015603,5015603,5173,87970,93143,Staten Island,10220108.41,Great Kills-Eltingville
21-Aug,36085015603,5015603,1724,31623,33347,Staten Island,10220108.41,Great Kills-Eltingville
19-May,36081047200,4047200,17319,45160,62479,Queens,5589561.628,Jamaica Estates-Holliswood
21-May,36081047200,4047200,9713,108033,117746,Queens,5589561.628,Jamaica Estates-Holliswood
19-Jun,36081047200,4047200,13723,93971,107694,Queens,5589561.628,Jamaica Estates-Holliswood
21-Jun,36081047200,4047200,10621,40501,51122,Queens,5589561.628,Jamaica Estates-Holliswood
19-Jul,36081047200,4047200,9387,64921,74308,Queens,5589561.628,Jamaica Estates-Holliswood
21-Jul,36081047200,4047200,11256,104976,116232,Queens,5589561.628,Jamaica Estates-Holliswood
19-Aug,36081047200,4047200,7341,49003,56344,Queens,5589561.628,Jamaica Estates-Holliswood
21-Aug,36081047200,4047200,7058,100027,107085,Queens,5589561.628,Jamaica Estates-Holliswood
19-May,36081047600,4047600,8598,69369,77967,Queens,5844452.799,Jamaica Estates-Holliswood
21-May,36081047600,4047600,10184,144601,154785,Queens,5844452.799,Jamaica Estates-Holliswood
19-Jun,36081047600,4047600,10905,112475,123380,Queens,5844452.799,Jamaica Estates-Holliswood
21-Jun,36081047600,4047600,14469,31310,45779,Queens,5844452.799,Jamaica Estates-Holliswood
19-Jul,36081047600,4047600,6536,74154,80690,Queens,5844452.799,Jamaica Estates-Holliswood
21-Jul,36081047600,4047600,7863,85300,93163,Queens,5844452.799,Jamaica Estates-Holliswood
19-Aug,36081047600,4047600,0,90388,90388,Queens,5844452.799,Jamaica Estates-Holliswood
21-Aug,36081047600,4047600,13020,3672,16692,Queens,5844452.799,Jamaica Estates-Holliswood
19-May,36005011502,2011502,2368,134695,137063,Bronx,3716262.022,Hunts Point
21-May,36005011502,2011502,9568,15452,25020,Bronx,3716262.022,Hunts Point
19-Jun,36005011502,2011502,11756,74937,86693,Bronx,3716262.022,Hunts Point
21-Jun,36005011502,2011502,16617,138289,154906,Bronx,3716262.022,Hunts Point
19-Jul,36005011502,2011502,5455,63134,68589,Bronx,3716262.022,Hunts Point
21-Jul,36005011502,2011502,7951,106667,114618,Bronx,3716262.022,Hunts Point
19-Aug,36005011502,2011502,12834,10406,23240,Bronx,3716262.022,Hunts Point
21-Aug,36005011502,2011502,7017,67626,74643,Bronx,3716262.022,Hunts Point
19-May,36081077905,4077905,0,71,71,Queens,2932214.216,Kew Gardens Hills
21-May,36081077905,4077905,10953,50589,61542,Queens,2932214.216,Kew Gardens Hills
19-Jun,36081077905,4077905,6549,110968,117517,Queens,2932214.216,Kew Gardens Hills
21-Jun,36081077905,4077905,7244,27297,34541,Queens,2932214.216,Kew Gardens Hills
19-Jul,36081077905,4077905,4532,67980,72512,Queens,2932214.216,Kew Gardens Hills
21-Jul,36081077905,4077905,7018,41926,48944,Queens,2932214.216,Kew Gardens Hills
19-Aug,36081077905,4077905,14257,77979,92236,Queens,2932214.216,Kew Gardens Hills
21-Aug,36081077905,4077905,15474,62353,77827,Queens,2932214.216,Kew Gardens Hills
19-May,36081118900,4118900,17451,116839,134290,Queens,2176995.518,East Flushing
21-May,36081118900,4118900,9022,18587,27609,Queens,2176995.518,East Flushing
19-Jun,36081118900,4118900,7047,102195,109242,Queens,2176995.518,East Flushing
21-Jun,36081118900,4118900,18052,6134,24186,Queens,2176995.518,East Flushing
19-Jul,36081118900,4118900,10135,105798,115933,Queens,2176995.518,East Flushing
21-Jul,36081118900,4118900,5423,85210,90633,Queens,2176995.518,East Flushing
19-Aug,36081118900,4118900,14138,40682,54820,Queens,2176995.518,East Flushing
21-Aug,36081118900,4118900,11039,209984,221023,Queens,2176995.518,East Flushing
19-May,36047093400,3093400,8161,16661,24822,Brooklyn,1913424.712,East Flatbush-Remsen Village
21-May,36047093400,3093400,3208,133143,136351,Brooklyn,1913424.712,East Flatbush-Remsen Village
19-Jun,36047093400,3093400,9054,47595,56649,Brooklyn,1913424.712,East Flatbush-Remsen Village
21-Jun,36047093400,3093400,11924,103208,115132,Brooklyn,1913424.712,East Flatbush-Remsen Village
19-Jul,36047093400,3093400,7534,59305,66839,Brooklyn,1913424.712,East Flatbush-Remsen Village
21-Jul,36047093400,3093400,1178,36595,37773,Brooklyn,1913424.712,East Flatbush-Remsen Village
19-Aug,36047093400,3093400,16892,51536,68428,Brooklyn,1913424.712,East Flatbush-Remsen Village
21-Aug,36047093400,3093400,12412,49838,62250,Brooklyn,1913424.712,East Flatbush-Remsen Village
19-May,36047093600,3093600,8402,93279,101681,Brooklyn,1777145.294,East Flatbush-Rugby
21-May,36047093600,3093600,5992,38645,44637,Brooklyn,1777145.294,East Flatbush-Rugby
19-Jun,36047093600,3093600,13050,77863,90913,Brooklyn,1777145.294,East Flatbush-Rugby
21-Jun,36047093600,3093600,6496,143161,149657,Brooklyn,1777145.294,East Flatbush-Rugby
19-Jul,36047093600,3093600,10091,57841,67932,Brooklyn,1777145.294,East Flatbush-Rugby
21-Jul,36047093600,3093600,6260,78723,84983,Brooklyn,1777145.294,East Flatbush-Rugby
19-Aug,36047093600,3093600,3475,61726,65201,Brooklyn,1777145.294,East Flatbush-Rugby
21-Aug,36047093600,3093600,8329,41817,50146,Brooklyn,1777145.294,East Flatbush-Rugby
19-May,36047092200,3092200,12166,70899,83065,Brooklyn,1742724.002,Brownsville
21-May,36047092200,3092200,8818,85170,93988,Brooklyn,1742724.002,Brownsville
19-Jun,36047092200,3092200,886,136102,136988,Brooklyn,1742724.002,Brownsville
21-Jun,36047092200,3092200,8274,130930,139204,Brooklyn,1742724.002,Brownsville
19-Jul,36047092200,3092200,7373,71,7444,Brooklyn,1742724.002,Brownsville
21-Jul,36047092200,3092200,9674,74000,83674,Brooklyn,1742724.002,Brownsville
19-Aug,36047092200,3092200,0,92975,92975,Brooklyn,1742724.002,Brownsville
21-Aug,36047092200,3092200,6284,93739,100023,Brooklyn,1742724.002,Brownsville
19-May,36047092800,3092800,10471,83730,94201,Brooklyn,1691579.211,East Flatbush-Remsen Village
21-May,36047092800,3092800,9818,65183,75001,Brooklyn,1691579.211,East Flatbush-Remsen Village
19-Jun,36047092800,3092800,6423,32044,38467,Brooklyn,1691579.211,East Flatbush-Remsen Village
21-Jun,36047092800,3092800,0,61146,61146,Brooklyn,1691579.211,East Flatbush-Remsen Village
19-Jul,36047092800,3092800,10413,71,10484,Brooklyn,1691579.211,East Flatbush-Remsen Village
21-Jul,36047092800,3092800,13376,24800,38176,Brooklyn,1691579.211,East Flatbush-Remsen Village
19-Aug,36047092800,3092800,4274,2259,6533,Brooklyn,1691579.211,East Flatbush-Remsen Village
21-Aug,36047092800,3092800,12798,127988,140786,Brooklyn,1691579.211,East Flatbush-Remsen Village
19-May,36081121100,4121100,10148,72879,83027,Queens,11016228.23,Kissena Park
21-May,36081121100,4121100,8614,67096,75710,Queens,11016228.23,Kissena Park
19-Jun,36081121100,4121100,7468,28220,35688,Queens,11016228.23,Kissena Park
21-Jun,36081121100,4121100,0,51299,51299,Queens,11016228.23,Kissena Park
19-Jul,36081121100,4121100,4389,86135,90524,Queens,11016228.23,Kissena Park
21-Jul,36081121100,4121100,6841,30366,37207,Queens,11016228.23,Kissena Park
19-Aug,36081121100,4121100,4673,44225,48898,Queens,11016228.23,Kissena Park
21-Aug,36081121100,4121100,9259,80666,89925,Queens,11016228.23,Kissena Park
19-May,36081141700,4141700,17726,113899,131625,Queens,9607744.966,Auburndale
21-May,36081141700,4141700,2962,77521,80483,Queens,9607744.966,Auburndale
19-Jun,36081141700,4141700,2778,9265,12043,Queens,9607744.966,Auburndale
21-Jun,36081141700,4141700,14917,12996,27913,Queens,9607744.966,Auburndale
19-Jul,36081141700,4141700,12437,77653,90090,Queens,9607744.966,Auburndale
21-Jul,36081141700,4141700,8631,29862,38493,Queens,9607744.966,Auburndale
19-Aug,36081141700,4141700,2167,139579,141746,Queens,9607744.966,Auburndale
21-Aug,36081141700,4141700,12390,127539,139929,Queens,9607744.966,Auburndale
19-May,36005023100,2023100,9506,23457,32963,Bronx,1274640.793,Mount Hope
21-May,36005023100,2023100,0,14740,14740,Bronx,1274640.793,Mount Hope
19-Jun,36005023100,2023100,4992,71853,76845,Bronx,1274640.793,Mount Hope
21-Jun,36005023100,2023100,15503,58756,74259,Bronx,1274640.793,Mount Hope
19-Jul,36005023100,2023100,19540,103507,123047,Bronx,1274640.793,Mount Hope
21-Jul,36005023100,2023100,1553,104405,105958,Bronx,1274640.793,Mount Hope
19-Aug,36005023100,2023100,9797,88064,97861,Bronx,1274640.793,Mount Hope
21-Aug,36005023100,2023100,5981,59957,65938,Bronx,1274640.793,Mount Hope
19-May,36005037900,2037900,9088,43385,52473,Bronx,2063169.901,Mount Hope
21-May,36005037900,2037900,15090,23441,38531,Bronx,2063169.901,Mount Hope
19-Jun,36005037900,2037900,5939,71,6010,Bronx,2063169.901,Mount Hope
21-Jun,36005037900,2037900,8244,88875,97119,Bronx,2063169.901,Mount Hope
19-Jul,36005037900,2037900,10381,38840,49221,Bronx,2063169.901,Mount Hope
21-Jul,36005037900,2037900,15360,42163,57523,Bronx,2063169.901,Mount Hope
19-Aug,36005037900,2037900,4947,81297,86244,Bronx,2063169.901,Mount Hope
21-Aug,36005037900,2037900,9219,54799,64018,Bronx,2063169.901,Mount Hope
19-May,36005038100,2038100,7121,29982,37103,Bronx,1623054.772,Mount Hope
21-May,36005038100,2038100,9279,26669,35948,Bronx,1623054.772,Mount Hope
19-Jun,36005038100,2038100,8489,87908,96397,Bronx,1623054.772,Mount Hope
21-Jun,36005038100,2038100,5944,67113,73057,Bronx,1623054.772,Mount Hope
19-Jul,36005038100,2038100,0,78826,78826,Bronx,1623054.772,Mount Hope
21-Jul,36005038100,2038100,800,71132,71932,Bronx,1623054.772,Mount Hope
19-Aug,36005038100,2038100,842,44802,45644,Bronx,1623054.772,Mount Hope
21-Aug,36005038100,2038100,2836,92062,94898,Bronx,1623054.772,Mount Hope
19-May,36081050500,4050500,0,68973,68973,Queens,1254233.823,Middle Village
21-May,36081050500,4050500,8027,35515,43542,Queens,1254233.823,Middle Village
19-Jun,36081050500,4050500,0,159980,159980,Queens,1254233.823,Middle Village
21-Jun,36081050500,4050500,13340,55598,68938,Queens,1254233.823,Middle Village
19-Jul,36081050500,4050500,6416,86331,92747,Queens,1254233.823,Middle Village
21-Jul,36081050500,4050500,4449,112089,116538,Queens,1254233.823,Middle Village
19-Aug,36081050500,4050500,12494,93070,105564,Queens,1254233.823,Middle Village
21-Aug,36081050500,4050500,5730,101974,107704,Queens,1254233.823,Middle Village
19-May,36081068700,4068700,8682,130053,138735,Queens,2999985.09,Rego Park
21-May,36081068700,4068700,893,68661,69554,Queens,2999985.09,Rego Park
19-Jun,36081068700,4068700,6365,152936,159301,Queens,2999985.09,Rego Park
21-Jun,36081068700,4068700,475,11450,11925,Queens,2999985.09,Rego Park
19-Jul,36081068700,4068700,7219,1971,9190,Queens,2999985.09,Rego Park
21-Jul,36081068700,4068700,12040,42356,54396,Queens,2999985.09,Rego Park
19-Aug,36081068700,4068700,7786,71886,79672,Queens,2999985.09,Rego Park
21-Aug,36081068700,4068700,6841,61036,67877,Queens,2999985.09,Rego Park
19-May,36047066600,3066600,11810,87269,99079,Brooklyn,43267148.13,Marine Park-Plumb Island
21-May,36047066600,3066600,586,78391,78977,Brooklyn,43267148.13,Marine Park-Plumb Island
19-Jun,36047066600,3066600,4936,71378,76314,Brooklyn,43267148.13,Marine Park-Plumb Island
21-Jun,36047066600,3066600,0,122631,122631,Brooklyn,43267148.13,Marine Park-Plumb Island
19-Jul,36047066600,3066600,5636,138539,144175,Brooklyn,43267148.13,Marine Park-Plumb Island
21-Jul,36047066600,3066600,2245,83839,86084,Brooklyn,43267148.13,Marine Park-Plumb Island
19-Aug,36047066600,3066600,5302,90947,96249,Brooklyn,43267148.13,Marine Park-Plumb Island
21-Aug,36047066600,3066600,2682,70911,73593,Brooklyn,43267148.13,Marine Park-Plumb Island
19-May,36005008300,2008300,5423,132477,137900,Bronx,2303688.046,Longwood
21-May,36005008300,2008300,0,68739,68739,Bronx,2303688.046,Longwood
19-Jun,36005008300,2008300,9199,19919,29118,Bronx,2303688.046,Longwood
21-Jun,36005008300,2008300,11131,66934,78065,Bronx,2303688.046,Longwood
19-Jul,36005008300,2008300,11098,98765,109863,Bronx,2303688.046,Longwood
21-Jul,36005008300,2008300,0,83060,83060,Bronx,2303688.046,Longwood
19-Aug,36005008300,2008300,5233,55887,61120,Bronx,2303688.046,Longwood
21-Aug,36005008300,2008300,9255,84316,93571,Bronx,2303688.046,Longwood
19-May,36061016002,1016002,5779,95067,100846,Manhattan,554133.1902,East Harlem (South)
21-May,36061016002,1016002,10187,103748,113935,Manhattan,554133.1902,East Harlem (South)
19-Jun,36061016002,1016002,10850,42112,52962,Manhattan,554133.1902,East Harlem (South)
21-Jun,36061016002,1016002,1531,77366,78897,Manhattan,554133.1902,East Harlem (South)
19-Jul,36061016002,1016002,11821,68455,80276,Manhattan,554133.1902,East Harlem (South)
21-Jul,36061016002,1016002,8480,11192,19672,Manhattan,554133.1902,East Harlem (South)
19-Aug,36061016002,1016002,5508,80640,86148,Manhattan,554133.1902,East Harlem (South)
21-Aug,36061016002,1016002,0,113219,113219,Manhattan,554133.1902,East Harlem (South)
19-May,36061016800,1016800,0,79117,79117,Manhattan,2151969.43,East Harlem (South)
21-May,36061016800,1016800,2017,100844,102861,Manhattan,2151969.43,East Harlem (South)
19-Jun,36061016800,1016800,4183,86031,90214,Manhattan,2151969.43,East Harlem (South)
21-Jun,36061016800,1016800,8400,53949,62349,Manhattan,2151969.43,East Harlem (South)
19-Jul,36061016800,1016800,8927,71,8998,Manhattan,2151969.43,East Harlem (South)
21-Jul,36061016800,1016800,9916,97340,107256,Manhattan,2151969.43,East Harlem (South)
19-Aug,36061016800,1016800,9318,84473,93791,Manhattan,2151969.43,East Harlem (South)
21-Aug,36061016800,1016800,16312,71556,87868,Manhattan,2151969.43,East Harlem (South)
19-May,36061007900,1007900,11313,55866,67179,Manhattan,2986116.294,West Village
21-May,36061007900,1007900,3880,65914,69794,Manhattan,2986116.294,West Village
19-Jun,36061007900,1007900,2093,77161,79254,Manhattan,2986116.294,West Village
21-Jun,36061007900,1007900,0,121370,121370,Manhattan,2986116.294,West Village
19-Jul,36061007900,1007900,11662,57722,69384,Manhattan,2986116.294,West Village
21-Jul,36061007900,1007900,7567,50322,57889,Manhattan,2986116.294,West Village
19-Aug,36061007900,1007900,16500,135458,151958,Manhattan,2986116.294,West Village
21-Aug,36061007900,1007900,5734,126480,132214,Manhattan,2986116.294,West Village
19-May,36061006900,1006900,15752,13519,29271,Manhattan,2362610.047,West Village
21-May,36061006900,1006900,7692,64091,71783,Manhattan,2362610.047,West Village
19-Jun,36061006900,1006900,22602,28581,51183,Manhattan,2362610.047,West Village
21-Jun,36061006900,1006900,11456,23012,34468,Manhattan,2362610.047,West Village
19-Jul,36061006900,1006900,5041,84254,89295,Manhattan,2362610.047,West Village
21-Jul,36061006900,1006900,7987,48708,56695,Manhattan,2362610.047,West Village
19-Aug,36061006900,1006900,10020,120769,130789,Manhattan,2362610.047,West Village
21-Aug,36061006900,1006900,15817,68218,84035,Manhattan,2362610.047,West Village
19-May,36061007500,1007500,9079,38676,47755,Manhattan,1778285.53,West Village
21-May,36061007500,1007500,1304,51718,53022,Manhattan,1778285.53,West Village
19-Jun,36061007500,1007500,0,32086,32086,Manhattan,1778285.53,West Village
21-Jun,36061007500,1007500,0,53857,53857,Manhattan,1778285.53,West Village
19-Jul,36061007500,1007500,11458,63973,75431,Manhattan,1778285.53,West Village
21-Jul,36061007500,1007500,4876,54285,59161,Manhattan,1778285.53,West Village
19-Aug,36061007500,1007500,3918,64324,68242,Manhattan,1778285.53,West Village
21-Aug,36061007500,1007500,2025,91389,93414,Manhattan,1778285.53,West Village
19-May,36047014101,3014101,13387,105151,118538,Brooklyn,816606.7809,Park Slope
21-May,36047014101,3014101,2091,153243,155334,Brooklyn,816606.7809,Park Slope
19-Jun,36047014101,3014101,7211,116087,123298,Brooklyn,816606.7809,Park Slope
21-Jun,36047014101,3014101,9836,53266,63102,Brooklyn,816606.7809,Park Slope
19-Jul,36047014101,3014101,0,33983,33983,Brooklyn,816606.7809,Park Slope
21-Jul,36047014101,3014101,5202,83861,89063,Brooklyn,816606.7809,Park Slope
19-Aug,36047014101,3014101,6132,57448,63580,Brooklyn,816606.7809,Park Slope
21-Aug,36047014101,3014101,17821,123587,141408,Brooklyn,816606.7809,Park Slope
19-May,36047014102,3014102,14466,90223,104689,Brooklyn,970475.0538,Windsor Terrace-South Slope
21-May,36047014102,3014102,17018,13368,30386,Brooklyn,970475.0538,Windsor Terrace-South Slope
19-Jun,36047014102,3014102,12257,91552,103809,Brooklyn,970475.0538,Windsor Terrace-South Slope
21-Jun,36047014102,3014102,0,71,71,Brooklyn,970475.0538,Windsor Terrace-South Slope
19-Jul,36047014102,3014102,16469,87936,104405,Brooklyn,970475.0538,Windsor Terrace-South Slope
21-Jul,36047014102,3014102,6353,60528,66881,Brooklyn,970475.0538,Windsor Terrace-South Slope
19-Aug,36047014102,3014102,2896,14138,17034,Brooklyn,970475.0538,Windsor Terrace-South Slope
21-Aug,36047014102,3014102,9194,76249,85443,Brooklyn,970475.0538,Windsor Terrace-South Slope
19-May,36081064102,4064102,8880,9490,18370,Queens,24010776.93,Forest Park
21-May,36081064102,4064102,3012,14185,17197,Queens,24010776.93,Forest Park
19-Jun,36081064102,4064102,11792,82110,93902,Queens,24010776.93,Forest Park
21-Jun,36081064102,4064102,5758,99562,105320,Queens,24010776.93,Forest Park
19-Jul,36081064102,4064102,5795,137665,143460,Queens,24010776.93,Forest Park
21-Jul,36081064102,4064102,17994,76532,94526,Queens,24010776.93,Forest Park
19-Aug,36081064102,4064102,2821,62888,65709,Queens,24010776.93,Forest Park
21-Aug,36081064102,4064102,14031,95846,109877,Queens,24010776.93,Forest Park
19-May,36081077300,4077300,3652,141691,145343,Queens,3012875.413,Kew Gardens
21-May,36081077300,4077300,0,65659,65659,Queens,3012875.413,Kew Gardens
19-Jun,36081077300,4077300,11308,93612,104920,Queens,3012875.413,Kew Gardens
21-Jun,36081077300,4077300,4818,137618,142436,Queens,3012875.413,Kew Gardens
19-Jul,36081077300,4077300,918,43743,44661,Queens,3012875.413,Kew Gardens
21-Jul,36081077300,4077300,8826,71,8897,Queens,3012875.413,Kew Gardens
19-Aug,36081077300,4077300,5528,81615,87143,Queens,3012875.413,Kew Gardens
21-Aug,36081077300,4077300,20034,123920,143954,Queens,3012875.413,Kew Gardens
19-May,36005015100,2015100,0,74968,74968,Bronx,2253623.728,Morrisania
21-May,36005015100,2015100,13967,25014,38981,Bronx,2253623.728,Morrisania
19-Jun,36005015100,2015100,9595,116646,126241,Bronx,2253623.728,Morrisania
21-Jun,36005015100,2015100,4677,23274,27951,Bronx,2253623.728,Morrisania
19-Jul,36005015100,2015100,1259,83967,85226,Bronx,2253623.728,Morrisania
21-Jul,36005015100,2015100,11908,48847,60755,Bronx,2253623.728,Morrisania
19-Aug,36005015100,2015100,0,35071,35071,Bronx,2253623.728,Morrisania
21-Aug,36005015100,2015100,13065,41369,54434,Bronx,2253623.728,Morrisania
19-May,36061009800,1009800,11738,55496,67234,Manhattan,1906396.561,East Midtown-Turtle Bay
21-May,36061009800,1009800,3298,130075,133373,Manhattan,1906396.561,East Midtown-Turtle Bay
19-Jun,36061009800,1009800,6235,11285,17520,Manhattan,1906396.561,East Midtown-Turtle Bay
21-Jun,36061009800,1009800,8178,68772,76950,Manhattan,1906396.561,East Midtown-Turtle Bay
19-Jul,36061009800,1009800,13683,82627,96310,Manhattan,1906396.561,East Midtown-Turtle Bay
21-Jul,36061009800,1009800,239,23499,23738,Manhattan,1906396.561,East Midtown-Turtle Bay
19-Aug,36061009800,1009800,5549,73002,78551,Manhattan,1906396.561,East Midtown-Turtle Bay
21-Aug,36061009800,1009800,15095,58136,73231,Manhattan,1906396.561,East Midtown-Turtle Bay
19-May,36061008603,1008603,1931,154555,156486,Manhattan,1252406.908,East Midtown-Turtle Bay
21-May,36061008603,1008603,10112,96834,106946,Manhattan,1252406.908,East Midtown-Turtle Bay
19-Jun,36061008603,1008603,8375,101118,109493,Manhattan,1252406.908,East Midtown-Turtle Bay
21-Jun,36061008603,1008603,14436,116593,131029,Manhattan,1252406.908,East Midtown-Turtle Bay
19-Jul,36061008603,1008603,5017,82670,87687,Manhattan,1252406.908,East Midtown-Turtle Bay
21-Jul,36061008603,1008603,11730,24758,36488,Manhattan,1252406.908,East Midtown-Turtle Bay
19-Aug,36061008603,1008603,7055,74188,81243,Manhattan,1252406.908,East Midtown-Turtle Bay
21-Aug,36061008603,1008603,10697,89741,100438,Manhattan,1252406.908,East Midtown-Turtle Bay
19-May,36061009000,1009000,7505,51804,59309,Manhattan,1882584.353,East Midtown-Turtle Bay
21-May,36061009000,1009000,12008,117987,129995,Manhattan,1882584.353,East Midtown-Turtle Bay
19-Jun,36061009000,1009000,5967,71,6038,Manhattan,1882584.353,East Midtown-Turtle Bay
21-Jun,36061009000,1009000,10401,89795,100196,Manhattan,1882584.353,East Midtown-Turtle Bay
19-Jul,36061009000,1009000,9857,64806,74663,Manhattan,1882584.353,East Midtown-Turtle Bay
21-Jul,36061009000,1009000,0,82802,82802,Manhattan,1882584.353,East Midtown-Turtle Bay
19-Aug,36061009000,1009000,7782,103005,110787,Manhattan,1882584.353,East Midtown-Turtle Bay
21-Aug,36061009000,1009000,9869,60752,70621,Manhattan,1882584.353,East Midtown-Turtle Bay
19-May,36085031901,5031901,14536,48009,62545,Staten Island,4127906.428,Mariner's Harbor-Arlington-Graniteville
21-May,36085031901,5031901,11938,90997,102935,Staten Island,4127906.428,Mariner's Harbor-Arlington-Graniteville
19-Jun,36085031901,5031901,8998,22346,31344,Staten Island,4127906.428,Mariner's Harbor-Arlington-Graniteville
21-Jun,36085031901,5031901,12013,77370,89383,Staten Island,4127906.428,Mariner's Harbor-Arlington-Graniteville
19-Jul,36085031901,5031901,0,20605,20605,Staten Island,4127906.428,Mariner's Harbor-Arlington-Graniteville
21-Jul,36085031901,5031901,10946,72710,83656,Staten Island,4127906.428,Mariner's Harbor-Arlington-Graniteville
19-Aug,36085031901,5031901,12514,119662,132176,Staten Island,4127906.428,Mariner's Harbor-Arlington-Graniteville
21-Aug,36085031901,5031901,3888,21488,25376,Staten Island,4127906.428,Mariner's Harbor-Arlington-Graniteville
19-May,36081086100,4086100,6058,42053,48111,Queens,1605948.169,East Flushing
21-May,36081086100,4086100,12773,43163,55936,Queens,1605948.169,East Flushing
19-Jun,36081086100,4086100,8738,69272,78010,Queens,1605948.169,East Flushing
21-Jun,36081086100,4086100,12899,75609,88508,Queens,1605948.169,East Flushing
19-Jul,36081086100,4086100,8943,77603,86546,Queens,1605948.169,East Flushing
21-Jul,36081086100,4086100,0,79715,79715,Queens,1605948.169,East Flushing
19-Aug,36081086100,4086100,10281,104506,114787,Queens,1605948.169,East Flushing
21-Aug,36081086100,4086100,0,61382,61382,Queens,1605948.169,East Flushing
19-May,36081120100,4120100,8152,57293,65445,Queens,1753647.134,East Flushing
21-May,36081120100,4120100,13973,66925,80898,Queens,1753647.134,East Flushing
19-Jun,36081120100,4120100,9740,71,9811,Queens,1753647.134,East Flushing
21-Jun,36081120100,4120100,10991,64944,75935,Queens,1753647.134,East Flushing
19-Jul,36081120100,4120100,9190,127885,137075,Queens,1753647.134,East Flushing
21-Jul,36081120100,4120100,0,127751,127751,Queens,1753647.134,East Flushing
19-Aug,36081120100,4120100,13560,13795,27355,Queens,1753647.134,East Flushing
21-Aug,36081120100,4120100,2799,65087,67886,Queens,1753647.134,East Flushing
19-May,36081081400,4081400,5948,67007,72955,Queens,3973225.724,South Ozone Park
21-May,36081081400,4081400,3952,56675,60627,Queens,3973225.724,South Ozone Park
19-Jun,36081081400,4081400,8219,81551,89770,Queens,3973225.724,South Ozone Park
21-Jun,36081081400,4081400,7290,50033,57323,Queens,3973225.724,South Ozone Park
19-Jul,36081081400,4081400,10666,41467,52133,Queens,3973225.724,South Ozone Park
21-Jul,36081081400,4081400,17086,141654,158740,Queens,3973225.724,South Ozone Park
19-Aug,36081081400,4081400,11737,8073,19810,Queens,3973225.724,South Ozone Park
21-Aug,36081081400,4081400,5447,137204,142651,Queens,3973225.724,South Ozone Park
19-May,36005023703,2023703,3138,150325,153463,Bronx,1071852.084,Fordham Heights
21-May,36005023703,2023703,5978,10839,16817,Bronx,1071852.084,Fordham Heights
19-Jun,36005023703,2023703,2050,152400,154450,Bronx,1071852.084,Fordham Heights
21-Jun,36005023703,2023703,13578,34422,48000,Bronx,1071852.084,Fordham Heights
19-Jul,36005023703,2023703,8811,71,8882,Bronx,1071852.084,Fordham Heights
21-Jul,36005023703,2023703,2851,121725,124576,Bronx,1071852.084,Fordham Heights
19-Aug,36005023703,2023703,16360,76371,92731,Bronx,1071852.084,Fordham Heights
21-Aug,36005023703,2023703,11628,53633,65261,Bronx,1071852.084,Fordham Heights
19-May,36081055200,4055200,10890,63793,74683,Queens,4495891.023,Queens Village
21-May,36081055200,4055200,8110,142605,150715,Queens,4495891.023,Queens Village
19-Jun,36081055200,4055200,12382,84168,96550,Queens,4495891.023,Queens Village
21-Jun,36081055200,4055200,20538,55115,75653,Queens,4495891.023,Queens Village
19-Jul,36081055200,4055200,1150,92632,93782,Queens,4495891.023,Queens Village
21-Jul,36081055200,4055200,15098,73178,88276,Queens,4495891.023,Queens Village
19-Aug,36081055200,4055200,8629,26888,35517,Queens,4495891.023,Queens Village
21-Aug,36081055200,4055200,6959,32665,39624,Queens,4495891.023,Queens Village
19-May,36081130100,4130100,4990,77575,82565,Queens,7518443.873,Bellerose
21-May,36081130100,4130100,7323,40135,47458,Queens,7518443.873,Bellerose
19-Jun,36081130100,4130100,4638,106595,111233,Queens,7518443.873,Bellerose
21-Jun,36081130100,4130100,17878,74879,92757,Queens,7518443.873,Bellerose
19-Jul,36081130100,4130100,6476,44173,50649,Queens,7518443.873,Bellerose
21-Jul,36081130100,4130100,11560,71288,82848,Queens,7518443.873,Bellerose
19-Aug,36081130100,4130100,11187,122642,133829,Queens,7518443.873,Bellerose
21-Aug,36081130100,4130100,14159,12178,26337,Queens,7518443.873,Bellerose
19-May,36005023501,2023501,2114,71,2185,Bronx,736577.687,Mount Hope
21-May,36005023501,2023501,7016,71,7087,Bronx,736577.687,Mount Hope
19-Jun,36005023501,2023501,0,59152,59152,Bronx,736577.687,Mount Hope
21-Jun,36005023501,2023501,13812,19606,33418,Bronx,736577.687,Mount Hope
19-Jul,36005023501,2023501,11303,21724,33027,Bronx,736577.687,Mount Hope
21-Jul,36005023501,2023501,6854,54974,61828,Bronx,736577.687,Mount Hope
19-Aug,36005023501,2023501,4676,2510,7186,Bronx,736577.687,Mount Hope
21-Aug,36005023501,2023501,6667,45069,51736,Bronx,736577.687,Mount Hope
19-May,36005023502,2023502,16251,145981,162232,Bronx,1034853.341,Mount Hope
21-May,36005023502,2023502,8220,148781,157001,Bronx,1034853.341,Mount Hope
19-Jun,36005023502,2023502,5032,24276,29308,Bronx,1034853.341,Mount Hope
21-Jun,36005023502,2023502,6171,19228,25399,Bronx,1034853.341,Mount Hope
19-Jul,36005023502,2023502,6761,99389,106150,Bronx,1034853.341,Mount Hope
21-Jul,36005023502,2023502,4038,56258,60296,Bronx,1034853.341,Mount Hope
19-Aug,36005023502,2023502,14804,141416,156220,Bronx,1034853.341,Mount Hope
21-Aug,36005023502,2023502,3476,95006,98482,Bronx,1034853.341,Mount Hope
19-May,36047111800,3111800,9542,20400,29942,Brooklyn,1749948.977,East New York-New Lots
21-May,36047111800,3111800,4257,93441,97698,Brooklyn,1749948.977,East New York-New Lots
19-Jun,36047111800,3111800,2948,80760,83708,Brooklyn,1749948.977,East New York-New Lots
21-Jun,36047111800,3111800,3938,89494,93432,Brooklyn,1749948.977,East New York-New Lots
19-Jul,36047111800,3111800,4976,164612,169588,Brooklyn,1749948.977,East New York-New Lots
21-Jul,36047111800,3111800,2843,49715,52558,Brooklyn,1749948.977,East New York-New Lots
19-Aug,36047111800,3111800,20825,41622,62447,Brooklyn,1749948.977,East New York-New Lots
21-Aug,36047111800,3111800,2705,92193,94898,Brooklyn,1749948.977,East New York-New Lots
19-May,36047112000,3112000,7845,128455,136300,Brooklyn,1857817.183,East New York-New Lots
21-May,36047112000,3112000,3242,96669,99911,Brooklyn,1857817.183,East New York-New Lots
19-Jun,36047112000,3112000,11090,68335,79425,Brooklyn,1857817.183,East New York-New Lots
21-Jun,36047112000,3112000,0,90195,90195,Brooklyn,1857817.183,East New York-New Lots
19-Jul,36047112000,3112000,5088,94336,99424,Brooklyn,1857817.183,East New York-New Lots
21-Jul,36047112000,3112000,4264,46796,51060,Brooklyn,1857817.183,East New York-New Lots
19-Aug,36047112000,3112000,4399,87125,91524,Brooklyn,1857817.183,East New York-New Lots
21-Aug,36047112000,3112000,12684,98979,111663,Brooklyn,1857817.183,East New York-New Lots
19-May,36081059600,4059600,4327,90394,94721,Queens,2094112.207,Cambria Heights
21-May,36081059600,4059600,9288,47087,56375,Queens,2094112.207,Cambria Heights
19-Jun,36081059600,4059600,19574,613,20187,Queens,2094112.207,Cambria Heights
21-Jun,36081059600,4059600,456,59983,60439,Queens,2094112.207,Cambria Heights
19-Jul,36081059600,4059600,7817,141173,148990,Queens,2094112.207,Cambria Heights
21-Jul,36081059600,4059600,16370,64877,81247,Queens,2094112.207,Cambria Heights
19-Aug,36081059600,4059600,12408,71,12479,Queens,2094112.207,Cambria Heights
21-Aug,36081059600,4059600,7797,36415,44212,Queens,2094112.207,Cambria Heights
19-May,36081070900,4070900,1117,93430,94547,Queens,2364591.168,Forest Hills
21-May,36081070900,4070900,15429,27662,43091,Queens,2364591.168,Forest Hills
19-Jun,36081070900,4070900,10268,71102,81370,Queens,2364591.168,Forest Hills
21-Jun,36081070900,4070900,2985,98879,101864,Queens,2364591.168,Forest Hills
19-Jul,36081070900,4070900,12073,137931,150004,Queens,2364591.168,Forest Hills
21-Jul,36081070900,4070900,2911,25443,28354,Queens,2364591.168,Forest Hills
19-Aug,36081070900,4070900,7430,142652,150082,Queens,2364591.168,Forest Hills
21-Aug,36081070900,4070900,13823,161997,175820,Queens,2364591.168,Forest Hills
19-May,36081071100,4071100,11958,81677,93635,Queens,3951135.964,Forest Hills
21-May,36081071100,4071100,15,80368,80383,Queens,3951135.964,Forest Hills
19-Jun,36081071100,4071100,11755,67622,79377,Queens,3951135.964,Forest Hills
21-Jun,36081071100,4071100,15904,71,15975,Queens,3951135.964,Forest Hills
19-Jul,36081071100,4071100,8905,44203,53108,Queens,3951135.964,Forest Hills
21-Jul,36081071100,4071100,3979,113789,117768,Queens,3951135.964,Forest Hills
19-Aug,36081071100,4071100,7885,62331,70216,Queens,3951135.964,Forest Hills
21-Aug,36081071100,4071100,5596,72080,77676,Queens,3951135.964,Forest Hills
19-May,36081060000,4060000,756,74682,75438,Queens,1902339.615,Cambria Heights
21-May,36081060000,4060000,2943,31389,34332,Queens,1902339.615,Cambria Heights
19-Jun,36081060000,4060000,9152,110036,119188,Queens,1902339.615,Cambria Heights
21-Jun,36081060000,4060000,11573,75302,86875,Queens,1902339.615,Cambria Heights
19-Jul,36081060000,4060000,10769,57264,68033,Queens,1902339.615,Cambria Heights
21-Jul,36081060000,4060000,15661,25239,40900,Queens,1902339.615,Cambria Heights
19-Aug,36081060000,4060000,9559,102465,112024,Queens,1902339.615,Cambria Heights
21-Aug,36081060000,4060000,4826,37151,41977,Queens,1902339.615,Cambria Heights
19-May,36081062200,4062200,12192,120599,132791,Queens,4707833.006,Cambria Heights
21-May,36081062200,4062200,13760,19043,32803,Queens,4707833.006,Cambria Heights
19-Jun,36081062200,4062200,10171,42511,52682,Queens,4707833.006,Cambria Heights
21-Jun,36081062200,4062200,5572,65750,71322,Queens,4707833.006,Cambria Heights
19-Jul,36081062200,4062200,11919,56844,68763,Queens,4707833.006,Cambria Heights
21-Jul,36081062200,4062200,12510,103088,115598,Queens,4707833.006,Cambria Heights
19-Aug,36081062200,4062200,10377,71,10448,Queens,4707833.006,Cambria Heights
21-Aug,36081062200,4062200,4504,63813,68317,Queens,4707833.006,Cambria Heights
19-May,36081016300,4016300,4850,18247,23097,Queens,2353270.043,Astoria (East)-Woodside (North)
21-May,36081016300,4016300,7339,67091,74430,Queens,2353270.043,Astoria (East)-Woodside (North)
19-Jun,36081016300,4016300,11716,63443,75159,Queens,2353270.043,Astoria (East)-Woodside (North)
21-Jun,36081016300,4016300,13864,18376,32240,Queens,2353270.043,Astoria (East)-Woodside (North)
19-Jul,36081016300,4016300,3857,49656,53513,Queens,2353270.043,Astoria (East)-Woodside (North)
21-Jul,36081016300,4016300,5419,24771,30190,Queens,2353270.043,Astoria (East)-Woodside (North)
19-Aug,36081016300,4016300,20172,94056,114228,Queens,2353270.043,Astoria (East)-Woodside (North)
21-Aug,36081016300,4016300,10957,67298,78255,Queens,2353270.043,Astoria (East)-Woodside (North)
19-May,36081029500,4029500,9010,9344,18354,Queens,1968262.685,Astoria (East)-Woodside (North)
21-May,36081029500,4029500,0,107790,107790,Queens,1968262.685,Astoria (East)-Woodside (North)
19-Jun,36081029500,4029500,17016,79831,96847,Queens,1968262.685,Astoria (East)-Woodside (North)
21-Jun,36081029500,4029500,12335,13399,25734,Queens,1968262.685,Astoria (East)-Woodside (North)
19-Jul,36081029500,4029500,8054,84950,93004,Queens,1968262.685,Astoria (East)-Woodside (North)
21-Jul,36081029500,4029500,4106,36214,40320,Queens,1968262.685,Astoria (East)-Woodside (North)
19-Aug,36081029500,4029500,1802,86305,88107,Queens,1968262.685,Astoria (East)-Woodside (North)
21-Aug,36081029500,4029500,13297,14650,27947,Queens,1968262.685,Astoria (East)-Woodside (North)
19-May,36081059200,4059200,4631,33834,38465,Queens,2441978.007,Cambria Heights
21-May,36081059200,4059200,5398,67565,72963,Queens,2441978.007,Cambria Heights
19-Jun,36081059200,4059200,8041,36742,44783,Queens,2441978.007,Cambria Heights
21-Jun,36081059200,4059200,6815,97092,103907,Queens,2441978.007,Cambria Heights
19-Jul,36081059200,4059200,1725,41803,43528,Queens,2441978.007,Cambria Heights
21-Jul,36081059200,4059200,13963,125264,139227,Queens,2441978.007,Cambria Heights
19-Aug,36081059200,4059200,14197,39472,53669,Queens,2441978.007,Cambria Heights
21-Aug,36081059200,4059200,7601,76058,83659,Queens,2441978.007,Cambria Heights
19-May,36081059400,4059400,10750,84892,95642,Queens,2389902.164,Cambria Heights
21-May,36081059400,4059400,5965,35925,41890,Queens,2389902.164,Cambria Heights
19-Jun,36081059400,4059400,6786,154378,161164,Queens,2389902.164,Cambria Heights
21-Jun,36081059400,4059400,1036,113213,114249,Queens,2389902.164,Cambria Heights
19-Jul,36081059400,4059400,8930,85487,94417,Queens,2389902.164,Cambria Heights
21-Jul,36081059400,4059400,2868,52512,55380,Queens,2389902.164,Cambria Heights
19-Aug,36081059400,4059400,14519,81049,95568,Queens,2389902.164,Cambria Heights
21-Aug,36081059400,4059400,11047,65474,76521,Queens,2389902.164,Cambria Heights
19-May,36081070300,4070300,0,59272,59272,Queens,2596327.232,Rego Park
21-May,36081070300,4070300,18520,103596,122116,Queens,2596327.232,Rego Park
19-Jun,36081070300,4070300,6430,94134,100564,Queens,2596327.232,Rego Park
21-Jun,36081070300,4070300,10466,19385,29851,Queens,2596327.232,Rego Park
19-Jul,36081070300,4070300,5077,155589,160666,Queens,2596327.232,Rego Park
21-Jul,36081070300,4070300,15378,110584,125962,Queens,2596327.232,Rego Park
19-Aug,36081070300,4070300,11499,89670,101169,Queens,2596327.232,Rego Park
21-Aug,36081070300,4070300,0,60856,60856,Queens,2596327.232,Rego Park
19-May,36081013600,4013600,4473,89078,93551,Queens,1632351.043,Kew Gardens
21-May,36081013600,4013600,15566,60489,76055,Queens,1632351.043,Kew Gardens
19-Jun,36081013600,4013600,11796,85285,97081,Queens,1632351.043,Kew Gardens
21-Jun,36081013600,4013600,7574,104721,112295,Queens,1632351.043,Kew Gardens
19-Jul,36081013600,4013600,18122,106541,124663,Queens,1632351.043,Kew Gardens
21-Jul,36081013600,4013600,398,45158,45556,Queens,1632351.043,Kew Gardens
19-Aug,36081013600,4013600,10281,8902,19183,Queens,1632351.043,Kew Gardens
21-Aug,36081013600,4013600,665,101563,102228,Queens,1632351.043,Kew Gardens
19-May,36081013800,4013800,18793,75941,94734,Queens,1828864.045,Kew Gardens
21-May,36081013800,4013800,8621,19167,27788,Queens,1828864.045,Kew Gardens
19-Jun,36081013800,4013800,0,92590,92590,Queens,1828864.045,Kew Gardens
21-Jun,36081013800,4013800,11517,61014,72531,Queens,1828864.045,Kew Gardens
19-Jul,36081013800,4013800,4920,63706,68626,Queens,1828864.045,Kew Gardens
21-Jul,36081013800,4013800,9448,90710,100158,Queens,1828864.045,Kew Gardens
19-Aug,36081013800,4013800,9508,122635,132143,Queens,1828864.045,Kew Gardens
21-Aug,36081013800,4013800,13642,34203,47845,Queens,1828864.045,Kew Gardens
19-May,36081067900,4067900,14759,71462,86221,Queens,2726931.607,Middle Village
21-May,36081067900,4067900,2535,81619,84154,Queens,2726931.607,Middle Village
19-Jun,36081067900,4067900,11575,17714,29289,Queens,2726931.607,Middle Village
21-Jun,36081067900,4067900,7153,47124,54277,Queens,2726931.607,Middle Village
19-Jul,36081067900,4067900,2229,29876,32105,Queens,2726931.607,Middle Village
21-Jul,36081067900,4067900,3507,104473,107980,Queens,2726931.607,Middle Village
19-Aug,36081067900,4067900,8037,108427,116464,Queens,2726931.607,Middle Village
21-Aug,36081067900,4067900,987,100653,101640,Queens,2726931.607,Middle Village
19-May,36081069702,4069702,14169,56904,71073,Queens,4839044.787,Rego Park
21-May,36081069702,4069702,14791,73676,88467,Queens,4839044.787,Rego Park
19-Jun,36081069702,4069702,3999,119654,123653,Queens,4839044.787,Rego Park
21-Jun,36081069702,4069702,8159,59610,67769,Queens,4839044.787,Rego Park
19-Jul,36081069702,4069702,6177,126996,133173,Queens,4839044.787,Rego Park
21-Jul,36081069702,4069702,14973,89456,104429,Queens,4839044.787,Rego Park
19-Aug,36081069702,4069702,18378,23633,42011,Queens,4839044.787,Rego Park
21-Aug,36081069702,4069702,9721,39173,48894,Queens,4839044.787,Rego Park
19-May,36081053401,4053401,7348,45386,52734,Queens,2799985.404,Cambria Heights
21-May,36081053401,4053401,12103,123968,136071,Queens,2799985.404,Cambria Heights
19-Jun,36081053401,4053401,4025,66388,70413,Queens,2799985.404,Cambria Heights
21-Jun,36081053401,4053401,12691,80854,93545,Queens,2799985.404,Cambria Heights
19-Jul,36081053401,4053401,4182,61951,66133,Queens,2799985.404,Cambria Heights
21-Jul,36081053401,4053401,4610,61972,66582,Queens,2799985.404,Cambria Heights
19-Aug,36081053401,4053401,2418,70371,72789,Queens,2799985.404,Cambria Heights
21-Aug,36081053401,4053401,10006,51836,61842,Queens,2799985.404,Cambria Heights
19-May,36081059800,4059800,10551,49021,59572,Queens,2227865.422,Cambria Heights
21-May,36081059800,4059800,7804,96460,104264,Queens,2227865.422,Cambria Heights
19-Jun,36081059800,4059800,4673,113039,117712,Queens,2227865.422,Cambria Heights
21-Jun,36081059800,4059800,8145,83318,91463,Queens,2227865.422,Cambria Heights
19-Jul,36081059800,4059800,2571,71,2642,Queens,2227865.422,Cambria Heights
21-Jul,36081059800,4059800,13702,114842,128544,Queens,2227865.422,Cambria Heights
19-Aug,36081059800,4059800,23939,93146,117085,Queens,2227865.422,Cambria Heights
21-Aug,36081059800,4059800,2378,49479,51857,Queens,2227865.422,Cambria Heights
19-May,36047016200,3016200,3904,107632,111536,Brooklyn,2542366.487,Bay Ridge
21-May,36047016200,3016200,3194,64167,67361,Brooklyn,2542366.487,Bay Ridge
19-Jun,36047016200,3016200,12386,56246,68632,Brooklyn,2542366.487,Bay Ridge
21-Jun,36047016200,3016200,13234,91134,104368,Brooklyn,2542366.487,Bay Ridge
19-Jul,36047016200,3016200,12282,10602,22884,Brooklyn,2542366.487,Bay Ridge
21-Jul,36047016200,3016200,0,120575,120575,Brooklyn,2542366.487,Bay Ridge
19-Aug,36047016200,3016200,14392,84628,99020,Brooklyn,2542366.487,Bay Ridge
21-Aug,36047016200,3016200,2347,89686,92033,Brooklyn,2542366.487,Bay Ridge
19-May,36047016400,3016400,5498,86767,92265,Brooklyn,8464620.161,Fort Hamilton
21-May,36047016400,3016400,9971,30632,40603,Brooklyn,8464620.161,Fort Hamilton
19-Jun,36047016400,3016400,10071,83909,93980,Brooklyn,8464620.161,Fort Hamilton
21-Jun,36047016400,3016400,10876,118550,129426,Brooklyn,8464620.161,Fort Hamilton
19-Jul,36047016400,3016400,2638,10367,13005,Brooklyn,8464620.161,Fort Hamilton
21-Jul,36047016400,3016400,7217,77025,84242,Brooklyn,8464620.161,Fort Hamilton
19-Aug,36047016400,3016400,9141,118280,127421,Brooklyn,8464620.161,Fort Hamilton
21-Aug,36047016400,3016400,10181,93068,103249,Brooklyn,8464620.161,Fort Hamilton
19-May,36005046000,2046000,4566,49833,54399,Bronx,3096852.863,Eastchester-Edenwald-Baychester
21-May,36005046000,2046000,2792,56325,59117,Bronx,3096852.863,Eastchester-Edenwald-Baychester
19-Jun,36005046000,2046000,7417,39658,47075,Bronx,3096852.863,Eastchester-Edenwald-Baychester
21-Jun,36005046000,2046000,6762,34999,41761,Bronx,3096852.863,Eastchester-Edenwald-Baychester
19-Jul,36005046000,2046000,5620,88558,94178,Bronx,3096852.863,Eastchester-Edenwald-Baychester
21-Jul,36005046000,2046000,1720,71,1791,Bronx,3096852.863,Eastchester-Edenwald-Baychester
19-Aug,36005046000,2046000,0,74371,74371,Bronx,3096852.863,Eastchester-Edenwald-Baychester
21-Aug,36005046000,2046000,8031,119799,127830,Bronx,3096852.863,Eastchester-Edenwald-Baychester
19-May,36061029700,1029700,9425,104910,114335,Manhattan,10007466.95,Inwood Hill Park
21-May,36061029700,1029700,8680,83162,91842,Manhattan,10007466.95,Inwood Hill Park
19-Jun,36061029700,1029700,6930,52041,58971,Manhattan,10007466.95,Inwood Hill Park
21-Jun,36061029700,1029700,13765,43808,57573,Manhattan,10007466.95,Inwood Hill Park
19-Jul,36061029700,1029700,14594,50597,65191,Manhattan,10007466.95,Inwood Hill Park
21-Jul,36061029700,1029700,15355,29892,45247,Manhattan,10007466.95,Inwood Hill Park
19-Aug,36061029700,1029700,9311,9611,18922,Manhattan,10007466.95,Inwood Hill Park
21-Aug,36061029700,1029700,15336,71377,86713,Manhattan,10007466.95,Inwood Hill Park
19-May,36081156700,4156700,17578,133609,151187,Queens,15837098.93,Bellerose
21-May,36081156700,4156700,5534,32102,37636,Queens,15837098.93,Bellerose
19-Jun,36081156700,4156700,14013,69574,83587,Queens,15837098.93,Bellerose
21-Jun,36081156700,4156700,7407,127323,134730,Queens,15837098.93,Bellerose
19-Jul,36081156700,4156700,6699,96364,103063,Queens,15837098.93,Bellerose
21-Jul,36081156700,4156700,3206,32157,35363,Queens,15837098.93,Bellerose
19-Aug,36081156700,4156700,5887,12871,18758,Queens,15837098.93,Bellerose
21-Aug,36081156700,4156700,12029,111650,123679,Queens,15837098.93,Bellerose
19-May,36081162100,4162100,6710,38129,44839,Queens,7760741.429,Bellerose
21-May,36081162100,4162100,2940,50376,53316,Queens,7760741.429,Bellerose
19-Jun,36081162100,4162100,10192,131769,141961,Queens,7760741.429,Bellerose
21-Jun,36081162100,4162100,4298,83208,87506,Queens,7760741.429,Bellerose
19-Jul,36081162100,4162100,11602,97716,109318,Queens,7760741.429,Bellerose
21-Jul,36081162100,4162100,10544,100222,110766,Queens,7760741.429,Bellerose
19-Aug,36081162100,4162100,9820,86542,96362,Queens,7760741.429,Bellerose
21-Aug,36081162100,4162100,10717,38574,49291,Queens,7760741.429,Bellerose
19-May,36061031704,1031704,6576,136643,143219,Manhattan,2411839.492,Financial District-Battery Park City
21-May,36061031704,1031704,5785,35532,41317,Manhattan,2411839.492,Financial District-Battery Park City
19-Jun,36061031704,1031704,5916,49562,55478,Manhattan,2411839.492,Financial District-Battery Park City
21-Jun,36061031704,1031704,6241,39439,45680,Manhattan,2411839.492,Financial District-Battery Park City
19-Jul,36061031704,1031704,5708,70696,76404,Manhattan,2411839.492,Financial District-Battery Park City
21-Jul,36061031704,1031704,8400,33554,41954,Manhattan,2411839.492,Financial District-Battery Park City
19-Aug,36061031704,1031704,10767,20220,30987,Manhattan,2411839.492,Financial District-Battery Park City
21-Aug,36061031704,1031704,11277,24075,35352,Manhattan,2411839.492,Financial District-Battery Park City
19-May,36081098100,4098100,15192,44022,59214,Queens,6966183.651,Whitestone-Beechhurst
21-May,36081098100,4098100,8580,34756,43336,Queens,6966183.651,Whitestone-Beechhurst
19-Jun,36081098100,4098100,0,56778,56778,Queens,6966183.651,Whitestone-Beechhurst
21-Jun,36081098100,4098100,8352,28147,36499,Queens,6966183.651,Whitestone-Beechhurst
19-Jul,36081098100,4098100,6098,106230,112328,Queens,6966183.651,Whitestone-Beechhurst
21-Jul,36081098100,4098100,5298,55083,60381,Queens,6966183.651,Whitestone-Beechhurst
19-Aug,36081098100,4098100,13598,110832,124430,Queens,6966183.651,Whitestone-Beechhurst
21-Aug,36081098100,4098100,1517,71,1588,Queens,6966183.651,Whitestone-Beechhurst
19-May,36081098700,4098700,7636,44821,52457,Queens,7208254.602,Whitestone-Beechhurst
21-May,36081098700,4098700,11199,28316,39515,Queens,7208254.602,Whitestone-Beechhurst
19-Jun,36081098700,4098700,9173,114801,123974,Queens,7208254.602,Whitestone-Beechhurst
21-Jun,36081098700,4098700,9137,93503,102640,Queens,7208254.602,Whitestone-Beechhurst
19-Jul,36081098700,4098700,10269,100712,110981,Queens,7208254.602,Whitestone-Beechhurst
21-Jul,36081098700,4098700,7178,88520,95698,Queens,7208254.602,Whitestone-Beechhurst
19-Aug,36081098700,4098700,759,29596,30355,Queens,7208254.602,Whitestone-Beechhurst
21-Aug,36081098700,4098700,3446,17289,20735,Queens,7208254.602,Whitestone-Beechhurst
19-May,36005031000,2031000,10047,62065,72112,Bronx,6884023.257,Pelham Gardens
21-May,36005031000,2031000,2247,34691,36938,Bronx,6884023.257,Pelham Gardens
19-Jun,36005031000,2031000,9315,52428,61743,Bronx,6884023.257,Pelham Gardens
21-Jun,36005031000,2031000,10094,104621,114715,Bronx,6884023.257,Pelham Gardens
19-Jul,36005031000,2031000,5325,96112,101437,Bronx,6884023.257,Pelham Gardens
21-Jul,36005031000,2031000,9396,7524,16920,Bronx,6884023.257,Pelham Gardens
19-Aug,36005031000,2031000,9503,37650,47153,Bronx,6884023.257,Pelham Gardens
21-Aug,36005031000,2031000,3902,113166,117068,Bronx,6884023.257,Pelham Gardens
19-May,36005035600,2035600,9874,44028,53902,Bronx,4342980.082,Eastchester-Edenwald-Baychester
21-May,36005035600,2035600,4981,85578,90559,Bronx,4342980.082,Eastchester-Edenwald-Baychester
19-Jun,36005035600,2035600,10233,51758,61991,Bronx,4342980.082,Eastchester-Edenwald-Baychester
21-Jun,36005035600,2035600,6764,47086,53850,Bronx,4342980.082,Eastchester-Edenwald-Baychester
19-Jul,36005035600,2035600,5779,74807,80586,Bronx,4342980.082,Eastchester-Edenwald-Baychester
21-Jul,36005035600,2035600,4252,12400,16652,Bronx,4342980.082,Eastchester-Edenwald-Baychester
19-Aug,36005035600,2035600,1338,17495,18833,Bronx,4342980.082,Eastchester-Edenwald-Baychester
21-Aug,36005035600,2035600,7984,44331,52315,Bronx,4342980.082,Eastchester-Edenwald-Baychester
19-May,36005026400,2026400,5267,148858,154125,Bronx,4598804.154,Throgs Neck-Schuylerville
21-May,36005026400,2026400,4215,103304,107519,Bronx,4598804.154,Throgs Neck-Schuylerville
19-Jun,36005026400,2026400,10440,39786,50226,Bronx,4598804.154,Throgs Neck-Schuylerville
21-Jun,36005026400,2026400,4539,70430,74969,Bronx,4598804.154,Throgs Neck-Schuylerville
19-Jul,36005026400,2026400,10605,124983,135588,Bronx,4598804.154,Throgs Neck-Schuylerville
21-Jul,36005026400,2026400,13156,176158,189314,Bronx,4598804.154,Throgs Neck-Schuylerville
19-Aug,36005026400,2026400,3626,4389,8015,Bronx,4598804.154,Throgs Neck-Schuylerville
21-Aug,36005026400,2026400,7202,43754,50956,Bronx,4598804.154,Throgs Neck-Schuylerville
19-May,36005019400,2019400,10566,57244,67810,Bronx,8674375.318,Throgs Neck-Schuylerville
21-May,36005019400,2019400,12023,79883,91906,Bronx,8674375.318,Throgs Neck-Schuylerville
19-Jun,36005019400,2019400,9790,40544,50334,Bronx,8674375.318,Throgs Neck-Schuylerville
21-Jun,36005019400,2019400,19973,102077,122050,Bronx,8674375.318,Throgs Neck-Schuylerville
19-Jul,36005019400,2019400,9075,92839,101914,Bronx,8674375.318,Throgs Neck-Schuylerville
21-Jul,36005019400,2019400,8711,119332,128043,Bronx,8674375.318,Throgs Neck-Schuylerville
19-Aug,36005019400,2019400,9806,66323,76129,Bronx,8674375.318,Throgs Neck-Schuylerville
21-Aug,36005019400,2019400,6327,54933,61260,Bronx,8674375.318,Throgs Neck-Schuylerville
19-May,36005045102,2045102,6161,96599,102760,Bronx,2286399.95,Wakefield-Woodlawn
21-May,36005045102,2045102,9499,89521,99020,Bronx,2286399.95,Wakefield-Woodlawn
19-Jun,36005045102,2045102,7581,73234,80815,Bronx,2286399.95,Wakefield-Woodlawn
21-Jun,36005045102,2045102,11240,99808,111048,Bronx,2286399.95,Wakefield-Woodlawn
19-Jul,36005045102,2045102,0,62441,62441,Bronx,2286399.95,Wakefield-Woodlawn
21-Jul,36005045102,2045102,13788,59176,72964,Bronx,2286399.95,Wakefield-Woodlawn
19-Aug,36005045102,2045102,4254,85638,89892,Bronx,2286399.95,Wakefield-Woodlawn
21-Aug,36005045102,2045102,16195,27936,44131,Bronx,2286399.95,Wakefield-Woodlawn
19-May,36081061602,4061602,9323,87760,97083,Queens,4552904.453,Rosedale
21-May,36081061602,4061602,14155,62180,76335,Queens,4552904.453,Rosedale
19-Jun,36081061602,4061602,4047,87223,91270,Queens,4552904.453,Rosedale
21-Jun,36081061602,4061602,11237,119296,130533,Queens,4552904.453,Rosedale
19-Jul,36081061602,4061602,9275,23375,32650,Queens,4552904.453,Rosedale
21-Jul,36081061602,4061602,1406,157043,158449,Queens,4552904.453,Rosedale
19-Aug,36081061602,4061602,14884,112725,127609,Queens,4552904.453,Rosedale
21-Aug,36081061602,4061602,13002,25559,38561,Queens,4552904.453,Rosedale
19-May,36081063800,4063800,12941,55893,68834,Queens,7406880.942,Rosedale
21-May,36081063800,4063800,12112,31843,43955,Queens,7406880.942,Rosedale
19-Jun,36081063800,4063800,11425,42622,54047,Queens,7406880.942,Rosedale
21-Jun,36081063800,4063800,14377,52796,67173,Queens,7406880.942,Rosedale
19-Jul,36081063800,4063800,14630,119056,133686,Queens,7406880.942,Rosedale
21-Jul,36081063800,4063800,14479,113444,127923,Queens,7406880.942,Rosedale
19-Aug,36081063800,4063800,4401,99890,104291,Queens,7406880.942,Rosedale
21-Aug,36081063800,4063800,13242,107922,121164,Queens,7406880.942,Rosedale
19-May,36047002300,3002300,3973,57581,61554,Brooklyn,1961474.099,Downtown Brooklyn-DUMBO-Boerum Hill
21-May,36047002300,3002300,4020,86593,90613,Brooklyn,1961474.099,Downtown Brooklyn-DUMBO-Boerum Hill
19-Jun,36047002300,3002300,3732,9745,13477,Brooklyn,1961474.099,Downtown Brooklyn-DUMBO-Boerum Hill
21-Jun,36047002300,3002300,10874,65428,76302,Brooklyn,1961474.099,Downtown Brooklyn-DUMBO-Boerum Hill
19-Jul,36047002300,3002300,5771,38960,44731,Brooklyn,1961474.099,Downtown Brooklyn-DUMBO-Boerum Hill
21-Jul,36047002300,3002300,16457,94673,111130,Brooklyn,1961474.099,Downtown Brooklyn-DUMBO-Boerum Hill
19-Aug,36047002300,3002300,16485,123341,139826,Brooklyn,1961474.099,Downtown Brooklyn-DUMBO-Boerum Hill
21-Aug,36047002300,3002300,9817,108414,118231,Brooklyn,1961474.099,Downtown Brooklyn-DUMBO-Boerum Hill
19-May,36061019400,1019400,6649,117393,124042,Manhattan,1882581.73,East Harlem (North)
21-May,36061019400,1019400,10322,81295,91617,Manhattan,1882581.73,East Harlem (North)
19-Jun,36061019400,1019400,2152,116113,118265,Manhattan,1882581.73,East Harlem (North)
21-Jun,36061019400,1019400,7257,130392,137649,Manhattan,1882581.73,East Harlem (North)
19-Jul,36061019400,1019400,21191,58723,79914,Manhattan,1882581.73,East Harlem (North)
21-Jul,36061019400,1019400,9291,95562,104853,Manhattan,1882581.73,East Harlem (North)
19-Aug,36061019400,1019400,1455,58235,59690,Manhattan,1882581.73,East Harlem (North)
21-Aug,36061019400,1019400,10301,71,10372,Manhattan,1882581.73,East Harlem (North)
19-May,36061024200,1024200,13320,7636,20956,Manhattan,3716549.84,East Harlem (North)
21-May,36061024200,1024200,14281,103028,117309,Manhattan,3716549.84,East Harlem (North)
19-Jun,36061024200,1024200,6777,29921,36698,Manhattan,3716549.84,East Harlem (North)
21-Jun,36061024200,1024200,6771,39386,46157,Manhattan,3716549.84,East Harlem (North)
19-Jul,36061024200,1024200,7071,26790,33861,Manhattan,3716549.84,East Harlem (North)
21-Jul,36061024200,1024200,11683,114686,126369,Manhattan,3716549.84,East Harlem (North)
19-Aug,36061024200,1024200,4940,56009,60949,Manhattan,3716549.84,East Harlem (North)
21-Aug,36061024200,1024200,11744,105992,117736,Manhattan,3716549.84,East Harlem (North)
19-May,36005005200,2005200,8033,60452,68485,Bronx,2011352.117,Soundview-Bruckner-Bronx River
21-May,36005005200,2005200,11818,83551,95369,Bronx,2011352.117,Soundview-Bruckner-Bronx River
19-Jun,36005005200,2005200,11375,97112,108487,Bronx,2011352.117,Soundview-Bruckner-Bronx River
21-Jun,36005005200,2005200,5273,93454,98727,Bronx,2011352.117,Soundview-Bruckner-Bronx River
19-Jul,36005005200,2005200,0,68606,68606,Bronx,2011352.117,Soundview-Bruckner-Bronx River
21-Jul,36005005200,2005200,4152,46875,51027,Bronx,2011352.117,Soundview-Bruckner-Bronx River
19-Aug,36005005200,2005200,243,130468,130711,Bronx,2011352.117,Soundview-Bruckner-Bronx River
21-Aug,36005005200,2005200,7702,107957,115659,Bronx,2011352.117,Soundview-Bruckner-Bronx River
19-May,36005012300,2012300,8863,131307,140170,Bronx,3207261.205,Crotona Park East
21-May,36005012300,2012300,12615,111546,124161,Bronx,3207261.205,Crotona Park East
19-Jun,36005012300,2012300,1788,117156,118944,Bronx,3207261.205,Crotona Park East
21-Jun,36005012300,2012300,3834,23825,27659,Bronx,3207261.205,Crotona Park East
19-Jul,36005012300,2012300,14587,68131,82718,Bronx,3207261.205,Crotona Park East
21-Jul,36005012300,2012300,276,94307,94583,Bronx,3207261.205,Crotona Park East
19-Aug,36005012300,2012300,1578,139709,141287,Bronx,3207261.205,Crotona Park East
21-Aug,36005012300,2012300,17311,30135,47446,Bronx,3207261.205,Crotona Park East
19-May,36047055100,3055100,14023,102583,116606,Brooklyn,2510822.123,Williamsburg
21-May,36047055100,3055100,1673,77342,79015,Brooklyn,2510822.123,Williamsburg
19-Jun,36047055100,3055100,5688,46144,51832,Brooklyn,2510822.123,Williamsburg
21-Jun,36047055100,3055100,10230,31389,41619,Brooklyn,2510822.123,Williamsburg
19-Jul,36047055100,3055100,2376,20697,23073,Brooklyn,2510822.123,Williamsburg
21-Jul,36047055100,3055100,8211,64710,72921,Brooklyn,2510822.123,Williamsburg
19-Aug,36047055100,3055100,14798,88097,102895,Brooklyn,2510822.123,Williamsburg
21-Aug,36047055100,3055100,3671,57349,61020,Brooklyn,2510822.123,Williamsburg
19-May,36047055500,3055500,7196,32950,40146,Brooklyn,2830476.763,Williamsburg
21-May,36047055500,3055500,11027,128949,139976,Brooklyn,2830476.763,Williamsburg
19-Jun,36047055500,3055500,1214,83264,84478,Brooklyn,2830476.763,Williamsburg
21-Jun,36047055500,3055500,14331,90277,104608,Brooklyn,2830476.763,Williamsburg
19-Jul,36047055500,3055500,11220,77682,88902,Brooklyn,2830476.763,Williamsburg
21-Jul,36047055500,3055500,9599,76865,86464,Brooklyn,2830476.763,Williamsburg
19-Aug,36047055500,3055500,7062,88819,95881,Brooklyn,2830476.763,Williamsburg
21-Aug,36047055500,3055500,7457,70143,77600,Brooklyn,2830476.763,Williamsburg
19-May,36005022701,2022701,13480,93133,106613,Bronx,1257526.851,Mount Hope
21-May,36005022701,2022701,10307,63130,73437,Bronx,1257526.851,Mount Hope
19-Jun,36005022701,2022701,7346,93082,100428,Bronx,1257526.851,Mount Hope
21-Jun,36005022701,2022701,12564,105688,118252,Bronx,1257526.851,Mount Hope
19-Jul,36005022701,2022701,13020,67119,80139,Bronx,1257526.851,Mount Hope
21-Jul,36005022701,2022701,10041,4925,14966,Bronx,1257526.851,Mount Hope
19-Aug,36005022701,2022701,7417,93781,101198,Bronx,1257526.851,Mount Hope
21-Aug,36005022701,2022701,1313,103359,104672,Bronx,1257526.851,Mount Hope
19-May,36085030301,5030301,12289,78390,90679,Staten Island,7766659.732,Mariner's Harbor-Arlington-Graniteville
21-May,36085030301,5030301,14338,157565,171903,Staten Island,7766659.732,Mariner's Harbor-Arlington-Graniteville
19-Jun,36085030301,5030301,5848,80956,86804,Staten Island,7766659.732,Mariner's Harbor-Arlington-Graniteville
21-Jun,36085030301,5030301,0,122985,122985,Staten Island,7766659.732,Mariner's Harbor-Arlington-Graniteville
19-Jul,36085030301,5030301,6996,31645,38641,Staten Island,7766659.732,Mariner's Harbor-Arlington-Graniteville
21-Jul,36085030301,5030301,9576,111509,121085,Staten Island,7766659.732,Mariner's Harbor-Arlington-Graniteville
19-Aug,36085030301,5030301,1699,37036,38735,Staten Island,7766659.732,Mariner's Harbor-Arlington-Graniteville
21-Aug,36085030301,5030301,12382,93246,105628,Staten Island,7766659.732,Mariner's Harbor-Arlington-Graniteville
19-May,36085032300,5032300,13368,61076,74444,Staten Island,41626574,Mariner's Harbor-Arlington-Graniteville
21-May,36085032300,5032300,10526,46644,57170,Staten Island,41626574,Mariner's Harbor-Arlington-Graniteville
19-Jun,36085032300,5032300,2460,124905,127365,Staten Island,41626574,Mariner's Harbor-Arlington-Graniteville
21-Jun,36085032300,5032300,1692,16747,18439,Staten Island,41626574,Mariner's Harbor-Arlington-Graniteville
19-Jul,36085032300,5032300,17566,112632,130198,Staten Island,41626574,Mariner's Harbor-Arlington-Graniteville
21-Jul,36085032300,5032300,6248,69656,75904,Staten Island,41626574,Mariner's Harbor-Arlington-Graniteville
19-Aug,36085032300,5032300,7307,101486,108793,Staten Island,41626574,Mariner's Harbor-Arlington-Graniteville
21-Aug,36085032300,5032300,4811,131944,136755,Staten Island,41626574,Mariner's Harbor-Arlington-Graniteville
19-May,36005008900,2008900,5032,51929,56961,Bronx,1174411.453,Hunts Point
21-May,36005008900,2008900,0,78037,78037,Bronx,1174411.453,Hunts Point
19-Jun,36005008900,2008900,3829,113637,117466,Bronx,1174411.453,Hunts Point
21-Jun,36005008900,2008900,9476,106755,116231,Bronx,1174411.453,Hunts Point
19-Jul,36005008900,2008900,9116,118663,127779,Bronx,1174411.453,Hunts Point
21-Jul,36005008900,2008900,12046,88859,100905,Bronx,1174411.453,Hunts Point
19-Aug,36005008900,2008900,3503,71,3574,Bronx,1174411.453,Hunts Point
21-Aug,36005008900,2008900,14746,56559,71305,Bronx,1174411.453,Hunts Point
19-May,36005001903,2001903,3075,87858,90933,Bronx,9738246.545,Mott Haven-Port Morris
21-May,36005001903,2001903,11440,28490,39930,Bronx,9738246.545,Mott Haven-Port Morris
19-Jun,36005001903,2001903,7680,83757,91437,Bronx,9738246.545,Mott Haven-Port Morris
21-Jun,36005001903,2001903,4062,70260,74322,Bronx,9738246.545,Mott Haven-Port Morris
19-Jul,36005001903,2001903,10765,46852,57617,Bronx,9738246.545,Mott Haven-Port Morris
21-Jul,36005001903,2001903,5069,14498,19567,Bronx,9738246.545,Mott Haven-Port Morris
19-Aug,36005001903,2001903,11021,18279,29300,Bronx,9738246.545,Mott Haven-Port Morris
21-Aug,36005001903,2001903,11703,28837,40540,Bronx,9738246.545,Mott Haven-Port Morris
19-May,36005003100,2003100,5026,122272,127298,Bronx,1680016.492,Mott Haven-Port Morris
21-May,36005003100,2003100,7178,146289,153467,Bronx,1680016.492,Mott Haven-Port Morris
19-Jun,36005003100,2003100,6303,62925,69228,Bronx,1680016.492,Mott Haven-Port Morris
21-Jun,36005003100,2003100,7409,57296,64705,Bronx,1680016.492,Mott Haven-Port Morris
19-Jul,36005003100,2003100,7981,88876,96857,Bronx,1680016.492,Mott Haven-Port Morris
21-Jul,36005003100,2003100,18570,32513,51083,Bronx,1680016.492,Mott Haven-Port Morris
19-Aug,36005003100,2003100,15615,25927,41542,Bronx,1680016.492,Mott Haven-Port Morris
21-Aug,36005003100,2003100,6282,36255,42537,Bronx,1680016.492,Mott Haven-Port Morris
19-May,36005023000,2023000,2391,71493,73884,Bronx,1716002.12,Pelham Parkway-Van Nest
21-May,36005023000,2023000,12063,71,12134,Bronx,1716002.12,Pelham Parkway-Van Nest
19-Jun,36005023000,2023000,18001,16251,34252,Bronx,1716002.12,Pelham Parkway-Van Nest
21-Jun,36005023000,2023000,9844,80164,90008,Bronx,1716002.12,Pelham Parkway-Van Nest
19-Jul,36005023000,2023000,10013,84279,94292,Bronx,1716002.12,Pelham Parkway-Van Nest
21-Jul,36005023000,2023000,11592,33313,44905,Bronx,1716002.12,Pelham Parkway-Van Nest
19-Aug,36005023000,2023000,15379,56074,71453,Bronx,1716002.12,Pelham Parkway-Van Nest
21-Aug,36005023000,2023000,7591,18740,26331,Bronx,1716002.12,Pelham Parkway-Van Nest
19-May,36005033400,2033400,11513,44183,55696,Bronx,33461137.72,Bronx Park
21-May,36005033400,2033400,1590,128387,129977,Bronx,33461137.72,Bronx Park
19-Jun,36005033400,2033400,11882,79465,91347,Bronx,33461137.72,Bronx Park
21-Jun,36005033400,2033400,5102,42919,48021,Bronx,33461137.72,Bronx Park
19-Jul,36005033400,2033400,11944,59880,71824,Bronx,33461137.72,Bronx Park
21-Jul,36005033400,2033400,9988,67173,77161,Bronx,33461137.72,Bronx Park
19-Aug,36005033400,2033400,13579,21038,34617,Bronx,33461137.72,Bronx Park
21-Aug,36005033400,2033400,4221,159663,163884,Bronx,33461137.72,Bronx Park
19-May,36085022602,5022602,2347,61367,63714,Staten Island,67473889.36,Tottenville-Charleston
21-May,36085022602,5022602,5471,53856,59327,Staten Island,67473889.36,Tottenville-Charleston
19-Jun,36085022602,5022602,9159,14225,23384,Staten Island,67473889.36,Tottenville-Charleston
21-Jun,36085022602,5022602,20169,57654,77823,Staten Island,67473889.36,Tottenville-Charleston
19-Jul,36085022602,5022602,6560,85628,92188,Staten Island,67473889.36,Tottenville-Charleston
21-Jul,36085022602,5022602,8996,148494,157490,Staten Island,67473889.36,Tottenville-Charleston
19-Aug,36085022602,5022602,17820,61070,78890,Staten Island,67473889.36,Tottenville-Charleston
21-Aug,36085022602,5022602,6771,90643,97414,Staten Island,67473889.36,Tottenville-Charleston
19-May,36085024800,5024800,12907,129828,142735,Staten Island,17600970.32,Tottenville-Charleston
21-May,36085024800,5024800,10254,90314,100568,Staten Island,17600970.32,Tottenville-Charleston
19-Jun,36085024800,5024800,0,31231,31231,Staten Island,17600970.32,Tottenville-Charleston
21-Jun,36085024800,5024800,7069,58570,65639,Staten Island,17600970.32,Tottenville-Charleston
19-Jul,36085024800,5024800,8651,38886,47537,Staten Island,17600970.32,Tottenville-Charleston
21-Jul,36085024800,5024800,2180,52970,55150,Staten Island,17600970.32,Tottenville-Charleston
19-Aug,36085024800,5024800,10870,74450,85320,Staten Island,17600970.32,Tottenville-Charleston
21-Aug,36085024800,5024800,7162,67919,75081,Staten Island,17600970.32,Tottenville-Charleston
19-May,36081003400,4003400,6343,86535,92878,Queens,2303269.718,Ozone Park (North)
21-May,36081003400,4003400,9149,90415,99564,Queens,2303269.718,Ozone Park (North)
19-Jun,36081003400,4003400,10011,11557,21568,Queens,2303269.718,Ozone Park (North)
21-Jun,36081003400,4003400,11381,51617,62998,Queens,2303269.718,Ozone Park (North)
19-Jul,36081003400,4003400,13964,71,14035,Queens,2303269.718,Ozone Park (North)
21-Jul,36081003400,4003400,4440,39012,43452,Queens,2303269.718,Ozone Park (North)
19-Aug,36081003400,4003400,13287,104349,117636,Queens,2303269.718,Ozone Park (North)
21-Aug,36081003400,4003400,5469,100980,106449,Queens,2303269.718,Ozone Park (North)
19-May,36047118600,3118600,19933,88848,108781,Brooklyn,1415207.506,East New York-City Line
21-May,36047118600,3118600,5133,78275,83408,Brooklyn,1415207.506,East New York-City Line
19-Jun,36047118600,3118600,11077,79791,90868,Brooklyn,1415207.506,East New York-City Line
21-Jun,36047118600,3118600,13989,71,14060,Brooklyn,1415207.506,East New York-City Line
19-Jul,36047118600,3118600,7171,53752,60923,Brooklyn,1415207.506,East New York-City Line
21-Jul,36047118600,3118600,5035,73605,78640,Brooklyn,1415207.506,East New York-City Line
19-Aug,36047118600,3118600,6697,31092,37789,Brooklyn,1415207.506,East New York-City Line
21-Aug,36047118600,3118600,17233,73647,90880,Brooklyn,1415207.506,East New York-City Line
19-May,36005007800,2007800,8865,144415,153280,Bronx,3356614.719,Castle Hill-Unionport
21-May,36005007800,2007800,6617,30323,36940,Bronx,3356614.719,Castle Hill-Unionport
19-Jun,36005007800,2007800,13708,77397,91105,Bronx,3356614.719,Castle Hill-Unionport
21-Jun,36005007800,2007800,11014,51718,62732,Bronx,3356614.719,Castle Hill-Unionport
19-Jul,36005007800,2007800,10001,112512,122513,Bronx,3356614.719,Castle Hill-Unionport
21-Jul,36005007800,2007800,7324,77906,85230,Bronx,3356614.719,Castle Hill-Unionport
19-Aug,36005007800,2007800,15538,115619,131157,Bronx,3356614.719,Castle Hill-Unionport
21-Aug,36005007800,2007800,12694,71,12765,Bronx,3356614.719,Castle Hill-Unionport
19-May,36005009800,2009800,0,57806,57806,Bronx,5571662.885,Castle Hill-Unionport
21-May,36005009800,2009800,7140,102125,109265,Bronx,5571662.885,Castle Hill-Unionport
19-Jun,36005009800,2009800,4917,113762,118679,Bronx,5571662.885,Castle Hill-Unionport
21-Jun,36005009800,2009800,17681,80500,98181,Bronx,5571662.885,Castle Hill-Unionport
19-Jul,36005009800,2009800,8268,49944,58212,Bronx,5571662.885,Castle Hill-Unionport
21-Jul,36005009800,2009800,3633,59302,62935,Bronx,5571662.885,Castle Hill-Unionport
19-Aug,36005009800,2009800,1978,79732,81710,Bronx,5571662.885,Castle Hill-Unionport
21-Aug,36005009800,2009800,3680,104921,108601,Bronx,5571662.885,Castle Hill-Unionport
19-May,36081008100,4008100,16496,60161,76657,Queens,1209106.354,Old Astoria-Hallets Point
21-May,36081008100,4008100,1466,46418,47884,Queens,1209106.354,Old Astoria-Hallets Point
19-Jun,36081008100,4008100,15068,88356,103424,Queens,1209106.354,Old Astoria-Hallets Point
21-Jun,36081008100,4008100,7912,63552,71464,Queens,1209106.354,Old Astoria-Hallets Point
19-Jul,36081008100,4008100,274,42463,42737,Queens,1209106.354,Old Astoria-Hallets Point
21-Jul,36081008100,4008100,3731,43055,46786,Queens,1209106.354,Old Astoria-Hallets Point
19-Aug,36081008100,4008100,4645,126686,131331,Queens,1209106.354,Old Astoria-Hallets Point
21-Aug,36081008100,4008100,0,36556,36556,Queens,1209106.354,Old Astoria-Hallets Point
19-May,36081008700,4008700,2613,65578,68191,Queens,2724467.432,Old Astoria-Hallets Point
21-May,36081008700,4008700,391,66565,66956,Queens,2724467.432,Old Astoria-Hallets Point
19-Jun,36081008700,4008700,14961,68982,83943,Queens,2724467.432,Old Astoria-Hallets Point
21-Jun,36081008700,4008700,10118,124979,135097,Queens,2724467.432,Old Astoria-Hallets Point
19-Jul,36081008700,4008700,7399,110297,117696,Queens,2724467.432,Old Astoria-Hallets Point
21-Jul,36081008700,4008700,8744,31219,39963,Queens,2724467.432,Old Astoria-Hallets Point
19-Aug,36081008700,4008700,9546,49613,59159,Queens,2724467.432,Old Astoria-Hallets Point
21-Aug,36081008700,4008700,4820,97684,102504,Queens,2724467.432,Old Astoria-Hallets Point
19-May,36005022901,2022901,9409,39141,48550,Bronx,1298013.063,Mount Hope
21-May,36005022901,2022901,11596,43160,54756,Bronx,1298013.063,Mount Hope
19-Jun,36005022901,2022901,3147,82726,85873,Bronx,1298013.063,Mount Hope
21-Jun,36005022901,2022901,6633,85811,92444,Bronx,1298013.063,Mount Hope
19-Jul,36005022901,2022901,12850,101552,114402,Bronx,1298013.063,Mount Hope
21-Jul,36005022901,2022901,9573,49172,58745,Bronx,1298013.063,Mount Hope
19-Aug,36005022901,2022901,7183,38094,45277,Bronx,1298013.063,Mount Hope
21-Aug,36005022901,2022901,17177,146296,163473,Bronx,1298013.063,Mount Hope
19-May,36005023302,2023302,7259,134395,141654,Bronx,681178.6094,Mount Hope
21-May,36005023302,2023302,4332,61419,65751,Bronx,681178.6094,Mount Hope
19-Jun,36005023302,2023302,6191,112817,119008,Bronx,681178.6094,Mount Hope
21-Jun,36005023302,2023302,10081,72777,82858,Bronx,681178.6094,Mount Hope
19-Jul,36005023302,2023302,8582,71,8653,Bronx,681178.6094,Mount Hope
21-Jul,36005023302,2023302,5237,65211,70448,Bronx,681178.6094,Mount Hope
19-Aug,36005023302,2023302,7526,80740,88266,Bronx,681178.6094,Mount Hope
21-Aug,36005023302,2023302,262,51847,52109,Bronx,681178.6094,Mount Hope
19-May,36005020000,2020000,11498,44464,55962,Bronx,3681108.438,Westchester Square
21-May,36005020000,2020000,2046,79808,81854,Bronx,3681108.438,Westchester Square
19-Jun,36005020000,2020000,5558,43756,49314,Bronx,3681108.438,Westchester Square
21-Jun,36005020000,2020000,21275,48317,69592,Bronx,3681108.438,Westchester Square
19-Jul,36005020000,2020000,6914,66976,73890,Bronx,3681108.438,Westchester Square
21-Jul,36005020000,2020000,8087,71,8158,Bronx,3681108.438,Westchester Square
19-Aug,36005020000,2020000,1436,98490,99926,Bronx,3681108.438,Westchester Square
21-Aug,36005020000,2020000,650,25485,26135,Bronx,3681108.438,Westchester Square
19-May,36005009600,2009600,8090,53648,61738,Bronx,7271108.353,Westchester Square
21-May,36005009600,2009600,8778,106922,115700,Bronx,7271108.353,Westchester Square
19-Jun,36005009600,2009600,8247,92209,100456,Bronx,7271108.353,Westchester Square
21-Jun,36005009600,2009600,3277,50930,54207,Bronx,7271108.353,Westchester Square
19-Jul,36005009600,2009600,583,60653,61236,Bronx,7271108.353,Westchester Square
21-Jul,36005009600,2009600,13234,71,13305,Bronx,7271108.353,Westchester Square
19-Aug,36005009600,2009600,1005,15026,16031,Bronx,7271108.353,Westchester Square
21-Aug,36005009600,2009600,5724,45520,51244,Bronx,7271108.353,Westchester Square
19-May,36005028400,2028400,11187,84832,96019,Bronx,12190146.28,Hutchinson Metro Center
21-May,36005028400,2028400,9279,26269,35548,Bronx,12190146.28,Hutchinson Metro Center
19-Jun,36005028400,2028400,915,93107,94022,Bronx,12190146.28,Hutchinson Metro Center
21-Jun,36005028400,2028400,8173,51137,59310,Bronx,12190146.28,Hutchinson Metro Center
19-Jul,36005028400,2028400,18158,95505,113663,Bronx,12190146.28,Hutchinson Metro Center
21-Jul,36005028400,2028400,11718,71,11789,Bronx,12190146.28,Hutchinson Metro Center
19-Aug,36005028400,2028400,2494,13404,15898,Bronx,12190146.28,Hutchinson Metro Center
21-Aug,36005028400,2028400,10045,60518,70563,Bronx,12190146.28,Hutchinson Metro Center
19-May,36061001300,1001300,9445,33686,43131,Manhattan,3413079.234,Financial District-Battery Park City
21-May,36061001300,1001300,3162,73694,76856,Manhattan,3413079.234,Financial District-Battery Park City
19-Jun,36061001300,1001300,13785,141794,155579,Manhattan,3413079.234,Financial District-Battery Park City
21-Jun,36061001300,1001300,946,53963,54909,Manhattan,3413079.234,Financial District-Battery Park City
19-Jul,36061001300,1001300,8976,60866,69842,Manhattan,3413079.234,Financial District-Battery Park City
21-Jul,36061001300,1001300,15056,29193,44249,Manhattan,3413079.234,Financial District-Battery Park City
19-Aug,36061001300,1001300,8638,56239,64877,Manhattan,3413079.234,Financial District-Battery Park City
21-Aug,36061001300,1001300,3590,77214,80804,Manhattan,3413079.234,Financial District-Battery Park City
19-May,36061002100,1002100,11827,51581,63408,Manhattan,2560061.42,Tribeca-Civic Center
21-May,36061002100,1002100,7548,85753,93301,Manhattan,2560061.42,Tribeca-Civic Center
19-Jun,36061002100,1002100,9167,132109,141276,Manhattan,2560061.42,Tribeca-Civic Center
21-Jun,36061002100,1002100,5597,105848,111445,Manhattan,2560061.42,Tribeca-Civic Center
19-Jul,36061002100,1002100,6337,79742,86079,Manhattan,2560061.42,Tribeca-Civic Center
21-Jul,36061002100,1002100,14231,75488,89719,Manhattan,2560061.42,Tribeca-Civic Center
19-Aug,36061002100,1002100,9434,43657,53091,Manhattan,2560061.42,Tribeca-Civic Center
21-Aug,36061002100,1002100,6682,148131,154813,Manhattan,2560061.42,Tribeca-Civic Center
19-May,36005025500,2025500,12320,86294,98614,Bronx,1804882.094,University Heights (North)-Fordham
21-May,36005025500,2025500,6848,15110,21958,Bronx,1804882.094,University Heights (North)-Fordham
19-Jun,36005025500,2025500,13383,79674,93057,Bronx,1804882.094,University Heights (North)-Fordham
21-Jun,36005025500,2025500,8586,75043,83629,Bronx,1804882.094,University Heights (North)-Fordham
19-Jul,36005025500,2025500,13956,125545,139501,Bronx,1804882.094,University Heights (North)-Fordham
21-Jul,36005025500,2025500,8592,45878,54470,Bronx,1804882.094,University Heights (North)-Fordham
19-Aug,36005025500,2025500,7786,61195,68981,Bronx,1804882.094,University Heights (North)-Fordham
21-Aug,36005025500,2025500,8378,118594,126972,Bronx,1804882.094,University Heights (North)-Fordham
19-May,36005026100,2026100,9850,83985,93835,Bronx,1883009.605,University Heights (North)-Fordham
21-May,36005026100,2026100,11789,86987,98776,Bronx,1883009.605,University Heights (North)-Fordham
19-Jun,36005026100,2026100,9246,42312,51558,Bronx,1883009.605,University Heights (North)-Fordham
21-Jun,36005026100,2026100,16385,38620,55005,Bronx,1883009.605,University Heights (North)-Fordham
19-Jul,36005026100,2026100,5706,91954,97660,Bronx,1883009.605,University Heights (North)-Fordham
21-Jul,36005026100,2026100,9582,42564,52146,Bronx,1883009.605,University Heights (North)-Fordham
19-Aug,36005026100,2026100,10377,79795,90172,Bronx,1883009.605,University Heights (North)-Fordham
21-Aug,36005026100,2026100,15054,83828,98882,Bronx,1883009.605,University Heights (North)-Fordham
19-May,36005026300,2026300,12018,71809,83827,Bronx,1717613.866,University Heights (North)-Fordham
21-May,36005026300,2026300,12285,154220,166505,Bronx,1717613.866,University Heights (North)-Fordham
19-Jun,36005026300,2026300,8568,171974,180542,Bronx,1717613.866,University Heights (North)-Fordham
21-Jun,36005026300,2026300,514,99877,100391,Bronx,1717613.866,University Heights (North)-Fordham
19-Jul,36005026300,2026300,8008,95463,103471,Bronx,1717613.866,University Heights (North)-Fordham
21-Jul,36005026300,2026300,14966,72406,87372,Bronx,1717613.866,University Heights (North)-Fordham
19-Aug,36005026300,2026300,4428,71,4499,Bronx,1717613.866,University Heights (North)-Fordham
21-Aug,36005026300,2026300,848,102908,103756,Bronx,1717613.866,University Heights (North)-Fordham
19-May,36005009000,2009000,11581,131729,143310,Bronx,11318415.34,Castle Hill-Unionport
21-May,36005009000,2009000,9826,17065,26891,Bronx,11318415.34,Castle Hill-Unionport
19-Jun,36005009000,2009000,5538,113946,119484,Bronx,11318415.34,Castle Hill-Unionport
21-Jun,36005009000,2009000,9419,48074,57493,Bronx,11318415.34,Castle Hill-Unionport
19-Jul,36005009000,2009000,10613,32083,42696,Bronx,11318415.34,Castle Hill-Unionport
21-Jul,36005009000,2009000,7325,38496,45821,Bronx,11318415.34,Castle Hill-Unionport
19-Aug,36005009000,2009000,3581,99366,102947,Bronx,11318415.34,Castle Hill-Unionport
21-Aug,36005009000,2009000,19602,64002,83604,Bronx,11318415.34,Castle Hill-Unionport
19-May,36005011000,2011000,6217,85074,91291,Bronx,21745194.39,Ferry Point Park-St. Raymond Cemetery
21-May,36005011000,2011000,3669,64029,67698,Bronx,21745194.39,Ferry Point Park-St. Raymond Cemetery
19-Jun,36005011000,2011000,3733,121612,125345,Bronx,21745194.39,Ferry Point Park-St. Raymond Cemetery
21-Jun,36005011000,2011000,0,96427,96427,Bronx,21745194.39,Ferry Point Park-St. Raymond Cemetery
19-Jul,36005011000,2011000,13938,88105,102043,Bronx,21745194.39,Ferry Point Park-St. Raymond Cemetery
21-Jul,36005011000,2011000,6487,69775,76262,Bronx,21745194.39,Ferry Point Park-St. Raymond Cemetery
19-Aug,36005011000,2011000,15782,44821,60603,Bronx,21745194.39,Ferry Point Park-St. Raymond Cemetery
21-Aug,36005011000,2011000,10424,55777,66201,Bronx,21745194.39,Ferry Point Park-St. Raymond Cemetery
19-May,36085003900,5003900,11390,113830,125220,Staten Island,6298384.521,West New Brighton-Silver Lake-Grymes Hill
21-May,36085003900,5003900,8949,6890,15839,Staten Island,6298384.521,West New Brighton-Silver Lake-Grymes Hill
19-Jun,36085003900,5003900,5136,116995,122131,Staten Island,6298384.521,West New Brighton-Silver Lake-Grymes Hill
21-Jun,36085003900,5003900,5212,135567,140779,Staten Island,6298384.521,West New Brighton-Silver Lake-Grymes Hill
19-Jul,36085003900,5003900,2310,74827,77137,Staten Island,6298384.521,West New Brighton-Silver Lake-Grymes Hill
21-Jul,36085003900,5003900,11798,144143,155941,Staten Island,6298384.521,West New Brighton-Silver Lake-Grymes Hill
19-Aug,36085003900,5003900,12689,36550,49239,Staten Island,6298384.521,West New Brighton-Silver Lake-Grymes Hill
21-Aug,36085003900,5003900,4316,93370,97686,Staten Island,6298384.521,West New Brighton-Silver Lake-Grymes Hill
19-May,36085005902,5005902,9978,46829,56807,Staten Island,4821650.489,West New Brighton-Silver Lake-Grymes Hill
21-May,36085005902,5005902,933,95199,96132,Staten Island,4821650.489,West New Brighton-Silver Lake-Grymes Hill
19-Jun,36085005902,5005902,16006,49987,65993,Staten Island,4821650.489,West New Brighton-Silver Lake-Grymes Hill
21-Jun,36085005902,5005902,13812,82823,96635,Staten Island,4821650.489,West New Brighton-Silver Lake-Grymes Hill
19-Jul,36085005902,5005902,7673,135903,143576,Staten Island,4821650.489,West New Brighton-Silver Lake-Grymes Hill
21-Jul,36085005902,5005902,0,104507,104507,Staten Island,4821650.489,West New Brighton-Silver Lake-Grymes Hill
19-Aug,36085005902,5005902,3240,112510,115750,Staten Island,4821650.489,West New Brighton-Silver Lake-Grymes Hill
21-Aug,36085005902,5005902,3967,96432,100399,Staten Island,4821650.489,West New Brighton-Silver Lake-Grymes Hill
19-May,36081019903,4019903,11499,40149,51648,Queens,7101350.528,Sunnyside
21-May,36081019903,4019903,20903,46386,67289,Queens,7101350.528,Sunnyside
19-Jun,36081019903,4019903,10887,64950,75837,Queens,7101350.528,Sunnyside
21-Jun,36081019903,4019903,11645,77168,88813,Queens,7101350.528,Sunnyside
19-Jul,36081019903,4019903,8150,65039,73189,Queens,7101350.528,Sunnyside
21-Jul,36081019903,4019903,10169,109628,119797,Queens,7101350.528,Sunnyside
19-Aug,36081019903,4019903,518,116264,116782,Queens,7101350.528,Sunnyside
21-Aug,36081019903,4019903,10562,110124,120686,Queens,7101350.528,Sunnyside
19-May,36081020500,4020500,6260,157599,163859,Queens,6088418.745,Sunnyside
21-May,36081020500,4020500,11329,70251,81580,Queens,6088418.745,Sunnyside
19-Jun,36081020500,4020500,11042,65390,76432,Queens,6088418.745,Sunnyside
21-Jun,36081020500,4020500,1922,88744,90666,Queens,6088418.745,Sunnyside
19-Jul,36081020500,4020500,11693,65006,76699,Queens,6088418.745,Sunnyside
21-Jul,36081020500,4020500,21086,72862,93948,Queens,6088418.745,Sunnyside
19-Aug,36081020500,4020500,18040,111326,129366,Queens,6088418.745,Sunnyside
21-Aug,36081020500,4020500,2411,57043,59454,Queens,6088418.745,Sunnyside
19-May,36005037800,2037800,10693,71,10764,Bronx,1433329.896,Williamsbridge-Olinville
21-May,36005037800,2037800,5554,90910,96464,Bronx,1433329.896,Williamsbridge-Olinville
19-Jun,36005037800,2037800,13329,125976,139305,Bronx,1433329.896,Williamsbridge-Olinville
21-Jun,36005037800,2037800,16934,73714,90648,Bronx,1433329.896,Williamsbridge-Olinville
19-Jul,36005037800,2037800,6444,21505,27949,Bronx,1433329.896,Williamsbridge-Olinville
21-Jul,36005037800,2037800,4642,88344,92986,Bronx,1433329.896,Williamsbridge-Olinville
19-Aug,36005037800,2037800,10956,67682,78638,Bronx,1433329.896,Williamsbridge-Olinville
21-Aug,36005037800,2037800,6931,32341,39272,Bronx,1433329.896,Williamsbridge-Olinville
19-May,36005038000,2038000,13410,59547,72957,Bronx,2283171.516,Williamsbridge-Olinville
21-May,36005038000,2038000,7337,59040,66377,Bronx,2283171.516,Williamsbridge-Olinville
19-Jun,36005038000,2038000,9067,71788,80855,Bronx,2283171.516,Williamsbridge-Olinville
21-Jun,36005038000,2038000,16775,64793,81568,Bronx,2283171.516,Williamsbridge-Olinville
19-Jul,36005038000,2038000,8670,17165,25835,Bronx,2283171.516,Williamsbridge-Olinville
21-Jul,36005038000,2038000,12978,96696,109674,Bronx,2283171.516,Williamsbridge-Olinville
19-Aug,36005038000,2038000,9661,77074,86735,Bronx,2283171.516,Williamsbridge-Olinville
21-Aug,36005038000,2038000,6280,73326,79606,Bronx,2283171.516,Williamsbridge-Olinville
19-May,36005025700,2025700,0,28077,28077,Bronx,1670305.644,University Heights (North)-Fordham
21-May,36005025700,2025700,7358,108538,115896,Bronx,1670305.644,University Heights (North)-Fordham
19-Jun,36005025700,2025700,13421,129020,142441,Bronx,1670305.644,University Heights (North)-Fordham
21-Jun,36005025700,2025700,8358,72997,81355,Bronx,1670305.644,University Heights (North)-Fordham
19-Jul,36005025700,2025700,12627,117184,129811,Bronx,1670305.644,University Heights (North)-Fordham
21-Jul,36005025700,2025700,2478,49813,52291,Bronx,1670305.644,University Heights (North)-Fordham
19-Aug,36005025700,2025700,5067,61004,66071,Bronx,1670305.644,University Heights (North)-Fordham
21-Aug,36005025700,2025700,0,34025,34025,Bronx,1670305.644,University Heights (North)-Fordham
19-May,36005026900,2026900,14167,71,14238,Bronx,4241425.472,University Heights (North)-Fordham
21-May,36005026900,2026900,15761,37011,52772,Bronx,4241425.472,University Heights (North)-Fordham
19-Jun,36005026900,2026900,10296,76427,86723,Bronx,4241425.472,University Heights (North)-Fordham
21-Jun,36005026900,2026900,1284,24890,26174,Bronx,4241425.472,University Heights (North)-Fordham
19-Jul,36005026900,2026900,6761,104605,111366,Bronx,4241425.472,University Heights (North)-Fordham
21-Jul,36005026900,2026900,12084,48931,61015,Bronx,4241425.472,University Heights (North)-Fordham
19-Aug,36005026900,2026900,6232,43163,49395,Bronx,4241425.472,University Heights (North)-Fordham
21-Aug,36005026900,2026900,3452,67218,70670,Bronx,4241425.472,University Heights (North)-Fordham
19-May,36081128300,4128300,3402,55155,58557,Queens,21304892.32,Cunningham Park
21-May,36081128300,4128300,3958,79046,83004,Queens,21304892.32,Cunningham Park
19-Jun,36081128300,4128300,6289,130277,136566,Queens,21304892.32,Cunningham Park
21-Jun,36081128300,4128300,524,94007,94531,Queens,21304892.32,Cunningham Park
19-Jul,36081128300,4128300,7840,40974,48814,Queens,21304892.32,Cunningham Park
21-Jul,36081128300,4128300,8438,88586,97024,Queens,21304892.32,Cunningham Park
19-Aug,36081128300,4128300,7328,34341,41669,Queens,21304892.32,Cunningham Park
21-Aug,36081128300,4128300,16089,45377,61466,Queens,21304892.32,Cunningham Park
19-May,36081129102,4129102,10807,110705,121512,Queens,10674558.71,Oakland Gardens-Hollis Hills
21-May,36081129102,4129102,2764,52687,55451,Queens,10674558.71,Oakland Gardens-Hollis Hills
19-Jun,36081129102,4129102,7892,9079,16971,Queens,10674558.71,Oakland Gardens-Hollis Hills
21-Jun,36081129102,4129102,16199,92741,108940,Queens,10674558.71,Oakland Gardens-Hollis Hills
19-Jul,36081129102,4129102,6686,76137,82823,Queens,10674558.71,Oakland Gardens-Hollis Hills
21-Jul,36081129102,4129102,7479,79388,86867,Queens,10674558.71,Oakland Gardens-Hollis Hills
19-Aug,36081129102,4129102,11010,57976,68986,Queens,10674558.71,Oakland Gardens-Hollis Hills
21-Aug,36081129102,4129102,12559,124648,137207,Queens,10674558.71,Oakland Gardens-Hollis Hills
19-May,36005009301,2009301,10296,5389,15685,Bronx,6151422.202,Hunts Point
21-May,36005009301,2009301,10963,75823,86786,Bronx,6151422.202,Hunts Point
19-Jun,36005009301,2009301,6912,50648,57560,Bronx,6151422.202,Hunts Point
21-Jun,36005009301,2009301,6683,71,6754,Bronx,6151422.202,Hunts Point
19-Jul,36005009301,2009301,7513,42673,50186,Bronx,6151422.202,Hunts Point
21-Jul,36005009301,2009301,2028,71,2099,Bronx,6151422.202,Hunts Point
19-Aug,36005009301,2009301,3404,68761,72165,Bronx,6151422.202,Hunts Point
21-Aug,36005009301,2009301,5046,71,5117,Bronx,6151422.202,Hunts Point
19-May,36005009302,2009302,7851,90702,98553,Bronx,19097339.7,Hunts Point
21-May,36005009302,2009302,6312,73557,79869,Bronx,19097339.7,Hunts Point
19-Jun,36005009302,2009302,7777,117873,125650,Bronx,19097339.7,Hunts Point
21-Jun,36005009302,2009302,8156,9846,18002,Bronx,19097339.7,Hunts Point
19-Jul,36005009302,2009302,14631,41748,56379,Bronx,19097339.7,Hunts Point
21-Jul,36005009302,2009302,17628,53912,71540,Bronx,19097339.7,Hunts Point
19-Aug,36005009302,2009302,6459,91233,97692,Bronx,19097339.7,Hunts Point
21-Aug,36005009302,2009302,0,66444,66444,Bronx,19097339.7,Hunts Point
19-May,36005011701,2011701,1722,137473,139195,Bronx,2404622.832,Hunts Point
21-May,36005011701,2011701,3713,109911,113624,Bronx,2404622.832,Hunts Point
19-Jun,36005011701,2011701,6237,156627,162864,Bronx,2404622.832,Hunts Point
21-Jun,36005011701,2011701,0,125665,125665,Bronx,2404622.832,Hunts Point
19-Jul,36005011701,2011701,12207,32479,44686,Bronx,2404622.832,Hunts Point
21-Jul,36005011701,2011701,0,84572,84572,Bronx,2404622.832,Hunts Point
19-Aug,36005011701,2011701,8804,134120,142924,Bronx,2404622.832,Hunts Point
21-Aug,36005011701,2011701,5534,91732,97266,Bronx,2404622.832,Hunts Point
19-May,36085006400,5006400,17167,49735,66902,Staten Island,7635280.867,Grasmere-Arrochar-South Beach-Dongan Hills
21-May,36085006400,5006400,11982,71844,83826,Staten Island,7635280.867,Grasmere-Arrochar-South Beach-Dongan Hills
19-Jun,36085006400,5006400,11888,36177,48065,Staten Island,7635280.867,Grasmere-Arrochar-South Beach-Dongan Hills
21-Jun,36085006400,5006400,5893,79339,85232,Staten Island,7635280.867,Grasmere-Arrochar-South Beach-Dongan Hills
19-Jul,36085006400,5006400,20395,71,20466,Staten Island,7635280.867,Grasmere-Arrochar-South Beach-Dongan Hills
21-Jul,36085006400,5006400,12152,88451,100603,Staten Island,7635280.867,Grasmere-Arrochar-South Beach-Dongan Hills
19-Aug,36085006400,5006400,5036,99086,104122,Staten Island,7635280.867,Grasmere-Arrochar-South Beach-Dongan Hills
21-Aug,36085006400,5006400,5849,96151,102000,Staten Island,7635280.867,Grasmere-Arrochar-South Beach-Dongan Hills
19-May,36085007002,5007002,12844,150211,163055,Staten Island,23647565.04,Grasmere-Arrochar-South Beach-Dongan Hills
21-May,36085007002,5007002,8573,32236,40809,Staten Island,23647565.04,Grasmere-Arrochar-South Beach-Dongan Hills
19-Jun,36085007002,5007002,11267,65057,76324,Staten Island,23647565.04,Grasmere-Arrochar-South Beach-Dongan Hills
21-Jun,36085007002,5007002,7881,104868,112749,Staten Island,23647565.04,Grasmere-Arrochar-South Beach-Dongan Hills
19-Jul,36085007002,5007002,7458,115320,122778,Staten Island,23647565.04,Grasmere-Arrochar-South Beach-Dongan Hills
21-Jul,36085007002,5007002,7571,35103,42674,Staten Island,23647565.04,Grasmere-Arrochar-South Beach-Dongan Hills
19-Aug,36085007002,5007002,3969,93722,97691,Staten Island,23647565.04,Grasmere-Arrochar-South Beach-Dongan Hills
21-Aug,36085007002,5007002,20050,24457,44507,Staten Island,23647565.04,Grasmere-Arrochar-South Beach-Dongan Hills
19-May,36081069000,4069000,2460,124281,126741,Queens,3750746.322,Springfield Gardens (South)-Brookville
21-May,36081069000,4069000,9220,71,9291,Queens,3750746.322,Springfield Gardens (South)-Brookville
19-Jun,36081069000,4069000,13576,69152,82728,Queens,3750746.322,Springfield Gardens (South)-Brookville
21-Jun,36081069000,4069000,8624,68128,76752,Queens,3750746.322,Springfield Gardens (South)-Brookville
19-Jul,36081069000,4069000,17549,92349,109898,Queens,3750746.322,Springfield Gardens (South)-Brookville
21-Jul,36081069000,4069000,5918,102064,107982,Queens,3750746.322,Springfield Gardens (South)-Brookville
19-Aug,36081069000,4069000,989,59383,60372,Queens,3750746.322,Springfield Gardens (South)-Brookville
21-Aug,36081069000,4069000,8841,55341,64182,Queens,3750746.322,Springfield Gardens (South)-Brookville
19-May,36081069400,4069400,9301,99911,109212,Queens,5640435.351,Springfield Gardens (South)-Brookville
21-May,36081069400,4069400,206,94121,94327,Queens,5640435.351,Springfield Gardens (South)-Brookville
19-Jun,36081069400,4069400,4350,154463,158813,Queens,5640435.351,Springfield Gardens (South)-Brookville
21-Jun,36081069400,4069400,12135,14909,27044,Queens,5640435.351,Springfield Gardens (South)-Brookville
19-Jul,36081069400,4069400,9719,32578,42297,Queens,5640435.351,Springfield Gardens (South)-Brookville
21-Jul,36081069400,4069400,14340,19389,33729,Queens,5640435.351,Springfield Gardens (South)-Brookville
19-Aug,36081069400,4069400,4223,80896,85119,Queens,5640435.351,Springfield Gardens (South)-Brookville
21-Aug,36081069400,4069400,15333,23402,38735,Queens,5640435.351,Springfield Gardens (South)-Brookville
19-May,36047114201,3114201,6660,93290,99950,Brooklyn,3224257.511,Cypress Hills
21-May,36047114201,3114201,1572,20157,21729,Brooklyn,3224257.511,Cypress Hills
19-Jun,36047114201,3114201,6476,158728,165204,Brooklyn,3224257.511,Cypress Hills
21-Jun,36047114201,3114201,4515,104256,108771,Brooklyn,3224257.511,Cypress Hills
19-Jul,36047114201,3114201,5218,66272,71490,Brooklyn,3224257.511,Cypress Hills
21-Jul,36047114201,3114201,4161,101729,105890,Brooklyn,3224257.511,Cypress Hills
19-Aug,36047114201,3114201,7972,79765,87737,Brooklyn,3224257.511,Cypress Hills
21-Aug,36047114201,3114201,9699,115193,124892,Brooklyn,3224257.511,Cypress Hills
19-May,36047114600,3114600,15647,60409,76056,Brooklyn,1725972.861,Cypress Hills
21-May,36047114600,3114600,10837,59381,70218,Brooklyn,1725972.861,Cypress Hills
19-Jun,36047114600,3114600,633,92639,93272,Brooklyn,1725972.861,Cypress Hills
21-Jun,36047114600,3114600,13998,74505,88503,Brooklyn,1725972.861,Cypress Hills
19-Jul,36047114600,3114600,9414,63596,73010,Brooklyn,1725972.861,Cypress Hills
21-Jul,36047114600,3114600,10706,50753,61459,Brooklyn,1725972.861,Cypress Hills
19-Aug,36047114600,3114600,5705,44448,50153,Brooklyn,1725972.861,Cypress Hills
21-Aug,36047114600,3114600,16804,123812,140616,Brooklyn,1725972.861,Cypress Hills
19-May,36085029104,5029104,11934,40764,52698,Staten Island,16604603.34,New Springville-Willowbrook-Bulls Head-Travis
21-May,36085029104,5029104,11515,59027,70542,Staten Island,16604603.34,New Springville-Willowbrook-Bulls Head-Travis
19-Jun,36085029104,5029104,19575,122389,141964,Staten Island,16604603.34,New Springville-Willowbrook-Bulls Head-Travis
21-Jun,36085029104,5029104,7590,91810,99400,Staten Island,16604603.34,New Springville-Willowbrook-Bulls Head-Travis
19-Jul,36085029104,5029104,5005,69731,74736,Staten Island,16604603.34,New Springville-Willowbrook-Bulls Head-Travis
21-Jul,36085029104,5029104,12590,138356,150946,Staten Island,16604603.34,New Springville-Willowbrook-Bulls Head-Travis
19-Aug,36085029104,5029104,13827,48145,61972,Staten Island,16604603.34,New Springville-Willowbrook-Bulls Head-Travis
21-Aug,36085029104,5029104,8601,5079,13680,Staten Island,16604603.34,New Springville-Willowbrook-Bulls Head-Travis
19-May,36047086400,3086400,8766,139394,148160,Brooklyn,1617955.921,East Flatbush-Rugby
21-May,36047086400,3086400,9647,51733,61380,Brooklyn,1617955.921,East Flatbush-Rugby
19-Jun,36047086400,3086400,11452,47657,59109,Brooklyn,1617955.921,East Flatbush-Rugby
21-Jun,36047086400,3086400,8010,103115,111125,Brooklyn,1617955.921,East Flatbush-Rugby
19-Jul,36047086400,3086400,1489,71,1560,Brooklyn,1617955.921,East Flatbush-Rugby
21-Jul,36047086400,3086400,12323,56750,69073,Brooklyn,1617955.921,East Flatbush-Rugby
19-Aug,36047086400,3086400,3253,18810,22063,Brooklyn,1617955.921,East Flatbush-Rugby
21-Aug,36047086400,3086400,12405,29139,41544,Brooklyn,1617955.921,East Flatbush-Rugby
19-May,36047088600,3088600,14146,68178,82324,Brooklyn,1938602.57,East Flatbush-Remsen Village
21-May,36047088600,3088600,7170,68768,75938,Brooklyn,1938602.57,East Flatbush-Remsen Village
19-Jun,36047088600,3088600,5791,164128,169919,Brooklyn,1938602.57,East Flatbush-Remsen Village
21-Jun,36047088600,3088600,14038,75634,89672,Brooklyn,1938602.57,East Flatbush-Remsen Village
19-Jul,36047088600,3088600,0,117804,117804,Brooklyn,1938602.57,East Flatbush-Remsen Village
21-Jul,36047088600,3088600,14998,57722,72720,Brooklyn,1938602.57,East Flatbush-Remsen Village
19-Aug,36047088600,3088600,3513,103520,107033,Brooklyn,1938602.57,East Flatbush-Remsen Village
21-Aug,36047088600,3088600,1886,87221,89107,Brooklyn,1938602.57,East Flatbush-Remsen Village
19-May,36047090800,3090800,9001,53904,62905,Brooklyn,3194827.573,Brownsville
21-May,36047090800,3090800,9418,83954,93372,Brooklyn,3194827.573,Brownsville
19-Jun,36047090800,3090800,3092,71,3163,Brooklyn,3194827.573,Brownsville
21-Jun,36047090800,3090800,6502,85880,92382,Brooklyn,3194827.573,Brownsville
19-Jul,36047090800,3090800,6750,165377,172127,Brooklyn,3194827.573,Brownsville
21-Jul,36047090800,3090800,12038,66494,78532,Brooklyn,3194827.573,Brownsville
19-Aug,36047090800,3090800,8942,105256,114198,Brooklyn,3194827.573,Brownsville
21-Aug,36047090800,3090800,11295,30385,41680,Brooklyn,3194827.573,Brownsville
19-May,36047114400,3114400,13578,61839,75417,Brooklyn,4617590.288,East New York (North)
21-May,36047114400,3114400,8148,88225,96373,Brooklyn,4617590.288,East New York (North)
19-Jun,36047114400,3114400,15576,15166,30742,Brooklyn,4617590.288,East New York (North)
21-Jun,36047114400,3114400,2505,98717,101222,Brooklyn,4617590.288,East New York (North)
19-Jul,36047114400,3114400,13450,40189,53639,Brooklyn,4617590.288,East New York (North)
21-Jul,36047114400,3114400,12400,123526,135926,Brooklyn,4617590.288,East New York (North)
19-Aug,36047114400,3114400,8941,65998,74939,Brooklyn,4617590.288,East New York (North)
21-Aug,36047114400,3114400,4167,32866,37033,Brooklyn,4617590.288,East New York (North)
19-May,36005024700,2024700,12066,104295,116361,Bronx,1577722.97,University Heights (South)-Morris Heights
21-May,36005024700,2024700,6310,53394,59704,Bronx,1577722.97,University Heights (South)-Morris Heights
19-Jun,36005024700,2024700,9903,107821,117724,Bronx,1577722.97,University Heights (South)-Morris Heights
21-Jun,36005024700,2024700,9264,102320,111584,Bronx,1577722.97,University Heights (South)-Morris Heights
19-Jul,36005024700,2024700,10528,108851,119379,Bronx,1577722.97,University Heights (South)-Morris Heights
21-Jul,36005024700,2024700,15789,34565,50354,Bronx,1577722.97,University Heights (South)-Morris Heights
19-Aug,36005024700,2024700,11057,47333,58390,Bronx,1577722.97,University Heights (South)-Morris Heights
21-Aug,36005024700,2024700,4607,44294,48901,Bronx,1577722.97,University Heights (South)-Morris Heights
19-May,36005018900,2018900,0,214373,214373,Bronx,3924064.969,Highbridge
21-May,36005018900,2018900,6752,57061,63813,Bronx,3924064.969,Highbridge
19-Jun,36005018900,2018900,1827,60204,62031,Bronx,3924064.969,Highbridge
21-Jun,36005018900,2018900,614,97420,98034,Bronx,3924064.969,Highbridge
19-Jul,36005018900,2018900,8231,44644,52875,Bronx,3924064.969,Highbridge
21-Jul,36005018900,2018900,7930,59164,67094,Bronx,3924064.969,Highbridge
19-Aug,36005018900,2018900,14101,123440,137541,Bronx,3924064.969,Highbridge
21-Aug,36005018900,2018900,8705,97217,105922,Bronx,3924064.969,Highbridge
19-May,36005019300,2019300,157,74629,74786,Bronx,2587522.516,Highbridge
21-May,36005019300,2019300,12283,93306,105589,Bronx,2587522.516,Highbridge
19-Jun,36005019300,2019300,10049,80239,90288,Bronx,2587522.516,Highbridge
21-Jun,36005019300,2019300,11495,91667,103162,Bronx,2587522.516,Highbridge
19-Jul,36005019300,2019300,3358,20215,23573,Bronx,2587522.516,Highbridge
21-Jul,36005019300,2019300,22756,53316,76072,Bronx,2587522.516,Highbridge
19-Aug,36005019300,2019300,12287,108493,120780,Bronx,2587522.516,Highbridge
21-Aug,36005019300,2019300,1740,49029,50769,Bronx,2587522.516,Highbridge
19-May,36005017701,2017701,12187,71602,83789,Bronx,1147218.69,Concourse-Concourse Village
21-May,36005017701,2017701,5906,61180,67086,Bronx,1147218.69,Concourse-Concourse Village
19-Jun,36005017701,2017701,8059,34187,42246,Bronx,1147218.69,Concourse-Concourse Village
21-Jun,36005017701,2017701,6949,59728,66677,Bronx,1147218.69,Concourse-Concourse Village
19-Jul,36005017701,2017701,4937,65700,70637,Bronx,1147218.69,Concourse-Concourse Village
21-Jul,36005017701,2017701,11747,61650,73397,Bronx,1147218.69,Concourse-Concourse Village
19-Aug,36005017701,2017701,11759,106635,118394,Bronx,1147218.69,Concourse-Concourse Village
21-Aug,36005017701,2017701,16022,213638,229660,Bronx,1147218.69,Concourse-Concourse Village
19-May,36005017702,2017702,4662,115216,119878,Bronx,1516149.574,Mount Eden-Claremont (West)
21-May,36005017702,2017702,904,66811,67715,Bronx,1516149.574,Mount Eden-Claremont (West)
19-Jun,36005017702,2017702,4267,142762,147029,Bronx,1516149.574,Mount Eden-Claremont (West)
21-Jun,36005017702,2017702,7851,58259,66110,Bronx,1516149.574,Mount Eden-Claremont (West)
19-Jul,36005017702,2017702,6329,89146,95475,Bronx,1516149.574,Mount Eden-Claremont (West)
21-Jul,36005017702,2017702,12178,6803,18981,Bronx,1516149.574,Mount Eden-Claremont (West)
19-Aug,36005017702,2017702,4707,71901,76608,Bronx,1516149.574,Mount Eden-Claremont (West)
21-Aug,36005017702,2017702,4039,8226,12265,Bronx,1516149.574,Mount Eden-Claremont (West)
19-May,36005019900,2019900,7980,116272,124252,Bronx,1908129.231,Highbridge
21-May,36005019900,2019900,10042,130583,140625,Bronx,1908129.231,Highbridge
19-Jun,36005019900,2019900,487,28452,28939,Bronx,1908129.231,Highbridge
21-Jun,36005019900,2019900,6698,18025,24723,Bronx,1908129.231,Highbridge
19-Jul,36005019900,2019900,11781,101772,113553,Bronx,1908129.231,Highbridge
21-Jul,36005019900,2019900,16353,144004,160357,Bronx,1908129.231,Highbridge
19-Aug,36005019900,2019900,8902,37079,45981,Bronx,1908129.231,Highbridge
21-Aug,36005019900,2019900,5499,75557,81056,Bronx,1908129.231,Highbridge
19-May,36005021100,2021100,11753,78784,90537,Bronx,1643928.601,Highbridge
21-May,36005021100,2021100,7310,117379,124689,Bronx,1643928.601,Highbridge
19-Jun,36005021100,2021100,8485,17423,25908,Bronx,1643928.601,Highbridge
21-Jun,36005021100,2021100,1520,58733,60253,Bronx,1643928.601,Highbridge
19-Jul,36005021100,2021100,5678,40121,45799,Bronx,1643928.601,Highbridge
21-Jul,36005021100,2021100,10833,96726,107559,Bronx,1643928.601,Highbridge
19-Aug,36005021100,2021100,4293,55479,59772,Bronx,1643928.601,Highbridge
21-Aug,36005021100,2021100,11162,144901,156063,Bronx,1643928.601,Highbridge
19-May,36005029302,2029302,21404,69402,90806,Bronx,4681742.677,Riverdale-Spuyten Duyvil
21-May,36005029302,2029302,3147,10377,13524,Bronx,4681742.677,Riverdale-Spuyten Duyvil
19-Jun,36005029302,2029302,4338,65237,69575,Bronx,4681742.677,Riverdale-Spuyten Duyvil
21-Jun,36005029302,2029302,7283,143425,150708,Bronx,4681742.677,Riverdale-Spuyten Duyvil
19-Jul,36005029302,2029302,14074,70465,84539,Bronx,4681742.677,Riverdale-Spuyten Duyvil
21-Jul,36005029302,2029302,13756,51996,65752,Bronx,4681742.677,Riverdale-Spuyten Duyvil
19-Aug,36005029302,2029302,7246,66629,73875,Bronx,4681742.677,Riverdale-Spuyten Duyvil
21-Aug,36005029302,2029302,8808,65690,74498,Bronx,4681742.677,Riverdale-Spuyten Duyvil
19-May,36061027300,1027300,3691,95179,98870,Manhattan,1904895.765,Washington Heights (North)
21-May,36061027300,1027300,12555,79644,92199,Manhattan,1904895.765,Washington Heights (North)
19-Jun,36061027300,1027300,12608,81211,93819,Manhattan,1904895.765,Washington Heights (North)
21-Jun,36061027300,1027300,16937,9111,26048,Manhattan,1904895.765,Washington Heights (North)
19-Jul,36061027300,1027300,12368,95260,107628,Manhattan,1904895.765,Washington Heights (North)
21-Jul,36061027300,1027300,14275,47802,62077,Manhattan,1904895.765,Washington Heights (North)
19-Aug,36061027300,1027300,9845,61890,71735,Manhattan,1904895.765,Washington Heights (North)
21-Aug,36061027300,1027300,7191,91392,98583,Manhattan,1904895.765,Washington Heights (North)
19-May,36061028100,1028100,12273,101523,113796,Manhattan,972223.4764,Washington Heights (North)
21-May,36061028100,1028100,13238,84060,97298,Manhattan,972223.4764,Washington Heights (North)
19-Jun,36061028100,1028100,6999,110852,117851,Manhattan,972223.4764,Washington Heights (North)
21-Jun,36061028100,1028100,4915,86311,91226,Manhattan,972223.4764,Washington Heights (North)
19-Jul,36061028100,1028100,1821,150456,152277,Manhattan,972223.4764,Washington Heights (North)
21-Jul,36061028100,1028100,4677,71109,75786,Manhattan,972223.4764,Washington Heights (North)
19-Aug,36061028100,1028100,13366,133780,147146,Manhattan,972223.4764,Washington Heights (North)
21-Aug,36061028100,1028100,0,64524,64524,Manhattan,972223.4764,Washington Heights (North)
19-May,36005029500,2029500,6094,59430,65524,Bronx,2525167.19,Riverdale-Spuyten Duyvil
21-May,36005029500,2029500,15367,20542,35909,Bronx,2525167.19,Riverdale-Spuyten Duyvil
19-Jun,36005029500,2029500,11709,109296,121005,Bronx,2525167.19,Riverdale-Spuyten Duyvil
21-Jun,36005029500,2029500,5341,107546,112887,Bronx,2525167.19,Riverdale-Spuyten Duyvil
19-Jul,36005029500,2029500,10384,61609,71993,Bronx,2525167.19,Riverdale-Spuyten Duyvil
21-Jul,36005029500,2029500,8545,38251,46796,Bronx,2525167.19,Riverdale-Spuyten Duyvil
19-Aug,36005029500,2029500,14401,50294,64695,Bronx,2525167.19,Riverdale-Spuyten Duyvil
21-Aug,36005029500,2029500,5725,27053,32778,Bronx,2525167.19,Riverdale-Spuyten Duyvil
19-May,36005029700,2029700,3002,131170,134172,Bronx,2505844.986,Riverdale-Spuyten Duyvil
21-May,36005029700,2029700,13440,43812,57252,Bronx,2505844.986,Riverdale-Spuyten Duyvil
19-Jun,36005029700,2029700,14291,115595,129886,Bronx,2505844.986,Riverdale-Spuyten Duyvil
21-Jun,36005029700,2029700,12965,68459,81424,Bronx,2505844.986,Riverdale-Spuyten Duyvil
19-Jul,36005029700,2029700,2382,100548,102930,Bronx,2505844.986,Riverdale-Spuyten Duyvil
21-Jul,36005029700,2029700,13826,1623,15449,Bronx,2505844.986,Riverdale-Spuyten Duyvil
19-Aug,36005029700,2029700,17299,111670,128969,Bronx,2505844.986,Riverdale-Spuyten Duyvil
21-Aug,36005029700,2029700,5220,107528,112748,Bronx,2505844.986,Riverdale-Spuyten Duyvil
19-May,36005006000,2006000,8601,36748,45349,Bronx,3643501.614,West Farms
21-May,36005006000,2006000,3006,185507,188513,Bronx,3643501.614,West Farms
19-Jun,36005006000,2006000,3547,21728,25275,Bronx,3643501.614,West Farms
21-Jun,36005006000,2006000,1885,91508,93393,Bronx,3643501.614,West Farms
19-Jul,36005006000,2006000,1008,122897,123905,Bronx,3643501.614,West Farms
21-Jul,36005006000,2006000,11359,79510,90869,Bronx,3643501.614,West Farms
19-Aug,36005006000,2006000,5900,98119,104019,Bronx,3643501.614,West Farms
21-Aug,36005006000,2006000,8649,79200,87849,Bronx,3643501.614,West Farms
19-May,36061024100,1024100,9350,38561,47911,Manhattan,1909667.106,Washington Heights (South)
21-May,36061024100,1024100,7593,75627,83220,Manhattan,1909667.106,Washington Heights (South)
19-Jun,36061024100,1024100,5298,26066,31364,Manhattan,1909667.106,Washington Heights (South)
21-Jun,36061024100,1024100,6572,103079,109651,Manhattan,1909667.106,Washington Heights (South)
19-Jul,36061024100,1024100,6340,40443,46783,Manhattan,1909667.106,Washington Heights (South)
21-Jul,36061024100,1024100,12086,92962,105048,Manhattan,1909667.106,Washington Heights (South)
19-Aug,36061024100,1024100,13892,13887,27779,Manhattan,1909667.106,Washington Heights (South)
21-Aug,36061024100,1024100,14532,67421,81953,Manhattan,1909667.106,Washington Heights (South)
19-May,36061024700,1024700,9261,85605,94866,Manhattan,2731880.534,Washington Heights (South)
21-May,36061024700,1024700,8853,59591,68444,Manhattan,2731880.534,Washington Heights (South)
19-Jun,36061024700,1024700,4314,24057,28371,Manhattan,2731880.534,Washington Heights (South)
21-Jun,36061024700,1024700,10848,59043,69891,Manhattan,2731880.534,Washington Heights (South)
19-Jul,36061024700,1024700,7881,22650,30531,Manhattan,2731880.534,Washington Heights (South)
21-Jul,36061024700,1024700,10708,78172,88880,Manhattan,2731880.534,Washington Heights (South)
19-Aug,36061024700,1024700,5529,83877,89406,Manhattan,2731880.534,Washington Heights (South)
21-Aug,36061024700,1024700,8984,96524,105508,Manhattan,2731880.534,Washington Heights (South)
19-May,36081030600,4030600,10410,109570,119980,Queens,14534803.36,Springfield Gardens (South)-Brookville
21-May,36081030600,4030600,5177,125212,130389,Queens,14534803.36,Springfield Gardens (South)-Brookville
19-Jun,36081030600,4030600,12218,41478,53696,Queens,14534803.36,Springfield Gardens (South)-Brookville
21-Jun,36081030600,4030600,16355,63191,79546,Queens,14534803.36,Springfield Gardens (South)-Brookville
19-Jul,36081030600,4030600,11839,63016,74855,Queens,14534803.36,Springfield Gardens (South)-Brookville
21-Jul,36081030600,4030600,6115,136929,143044,Queens,14534803.36,Springfield Gardens (South)-Brookville
19-Aug,36081030600,4030600,16522,70705,87227,Queens,14534803.36,Springfield Gardens (South)-Brookville
21-Aug,36081030600,4030600,0,69060,69060,Queens,14534803.36,Springfield Gardens (South)-Brookville
19-May,36081071600,4071600,5432,51209,56641,Queens,197189855.8,John F. Kennedy International Airport
21-May,36081071600,4071600,8119,133630,141749,Queens,197189855.8,John F. Kennedy International Airport
19-Jun,36081071600,4071600,3183,130655,133838,Queens,197189855.8,John F. Kennedy International Airport
21-Jun,36081071600,4071600,8890,32425,41315,Queens,197189855.8,John F. Kennedy International Airport
19-Jul,36081071600,4071600,5156,50443,55599,Queens,197189855.8,John F. Kennedy International Airport
21-Jul,36081071600,4071600,6571,93989,100560,Queens,197189855.8,John F. Kennedy International Airport
19-Aug,36081071600,4071600,7916,16980,24896,Queens,197189855.8,John F. Kennedy International Airport
21-Aug,36081071600,4071600,452,84792,85244,Queens,197189855.8,John F. Kennedy International Airport
19-May,36081084602,4084602,6560,86894,93454,Queens,7743160.341,South Ozone Park
21-May,36081084602,4084602,16379,83471,99850,Queens,7743160.341,South Ozone Park
19-Jun,36081084602,4084602,5131,59927,65058,Queens,7743160.341,South Ozone Park
21-Jun,36081084602,4084602,4702,40140,44842,Queens,7743160.341,South Ozone Park
19-Jul,36081084602,4084602,12726,44373,57099,Queens,7743160.341,South Ozone Park
21-Jul,36081084602,4084602,14120,56350,70470,Queens,7743160.341,South Ozone Park
19-Aug,36081084602,4084602,5123,94625,99748,Queens,7743160.341,South Ozone Park
21-Aug,36081084602,4084602,9290,56325,65615,Queens,7743160.341,South Ozone Park
19-May,36005018501,2018501,8836,102857,111693,Bronx,1983331.834,Morrisania
21-May,36005018501,2018501,2378,62022,64400,Bronx,1983331.834,Morrisania
19-Jun,36005018501,2018501,7062,78818,85880,Bronx,1983331.834,Morrisania
21-Jun,36005018501,2018501,2235,45603,47838,Bronx,1983331.834,Morrisania
19-Jul,36005018501,2018501,5769,125026,130795,Bronx,1983331.834,Morrisania
21-Jul,36005018501,2018501,5844,56130,61974,Bronx,1983331.834,Morrisania
19-Aug,36005018501,2018501,0,75459,75459,Bronx,1983331.834,Morrisania
21-Aug,36005018501,2018501,7894,98436,106330,Bronx,1983331.834,Morrisania
19-May,36005018502,2018502,7546,71668,79214,Bronx,2447227.853,Morrisania
21-May,36005018502,2018502,295,55888,56183,Bronx,2447227.853,Morrisania
19-Jun,36005018502,2018502,529,131157,131686,Bronx,2447227.853,Morrisania
21-Jun,36005018502,2018502,10231,97,10328,Bronx,2447227.853,Morrisania
19-Jul,36005018502,2018502,6664,53767,60431,Bronx,2447227.853,Morrisania
21-Jul,36005018502,2018502,1548,93821,95369,Bronx,2447227.853,Morrisania
19-Aug,36005018502,2018502,10122,35553,45675,Bronx,2447227.853,Morrisania
21-Aug,36005018502,2018502,9649,102095,111744,Bronx,2447227.853,Morrisania
19-May,36081061900,4061900,7685,84269,91954,Queens,2553641.93,Middle Village
21-May,36081061900,4061900,9047,55903,64950,Queens,2553641.93,Middle Village
19-Jun,36081061900,4061900,0,129853,129853,Queens,2553641.93,Middle Village
21-Jun,36081061900,4061900,12118,20740,32858,Queens,2553641.93,Middle Village
19-Jul,36081061900,4061900,12532,15294,27826,Queens,2553641.93,Middle Village
21-Jul,36081061900,4061900,12509,48672,61181,Queens,2553641.93,Middle Village
19-Aug,36081061900,4061900,4309,146338,150647,Queens,2553641.93,Middle Village
21-Aug,36081061900,4061900,8506,29834,38340,Queens,2553641.93,Middle Village
19-May,36081063301,4063301,14727,50676,65403,Queens,1452390.753,Glendale
21-May,36081063301,4063301,1402,16798,18200,Queens,1452390.753,Glendale
19-Jun,36081063301,4063301,0,62724,62724,Queens,1452390.753,Glendale
21-Jun,36081063301,4063301,14854,79378,94232,Queens,1452390.753,Glendale
19-Jul,36081063301,4063301,12261,75207,87468,Queens,1452390.753,Glendale
21-Jul,36081063301,4063301,3390,76717,80107,Queens,1452390.753,Glendale
19-Aug,36081063301,4063301,8233,92655,100888,Queens,1452390.753,Glendale
21-Aug,36081063301,4063301,10020,189713,199733,Queens,1452390.753,Glendale
19-May,36081063302,4063302,0,120230,120230,Queens,1490799.019,Glendale
21-May,36081063302,4063302,8029,82943,90972,Queens,1490799.019,Glendale
19-Jun,36081063302,4063302,14771,103570,118341,Queens,1490799.019,Glendale
21-Jun,36081063302,4063302,6643,75613,82256,Queens,1490799.019,Glendale
19-Jul,36081063302,4063302,13000,84919,97919,Queens,1490799.019,Glendale
21-Jul,36081063302,4063302,0,121676,121676,Queens,1490799.019,Glendale
19-Aug,36081063302,4063302,13188,72400,85588,Queens,1490799.019,Glendale
21-Aug,36081063302,4063302,3811,21765,25576,Queens,1490799.019,Glendale
19-May,36081040102,4040102,4415,34997,39412,Queens,1336041.159,North Corona
21-May,36081040102,4040102,14809,28036,42845,Queens,1336041.159,North Corona
19-Jun,36081040102,4040102,0,104911,104911,Queens,1336041.159,North Corona
21-Jun,36081040102,4040102,6804,111097,117901,Queens,1336041.159,North Corona
19-Jul,36081040102,4040102,9412,61895,71307,Queens,1336041.159,North Corona
21-Jul,36081040102,4040102,6334,123753,130087,Queens,1336041.159,North Corona
19-Aug,36081040102,4040102,5914,76494,82408,Queens,1336041.159,North Corona
21-Aug,36081040102,4040102,14893,28879,43772,Queens,1336041.159,North Corona
19-May,36061019100,1019100,5417,64706,70123,Manhattan,2385202.729,Upper West Side-Manhattan Valley
21-May,36061019100,1019100,4242,40901,45143,Manhattan,2385202.729,Upper West Side-Manhattan Valley
19-Jun,36061019100,1019100,0,17620,17620,Manhattan,2385202.729,Upper West Side-Manhattan Valley
21-Jun,36061019100,1019100,12047,66308,78355,Manhattan,2385202.729,Upper West Side-Manhattan Valley
19-Jul,36061019100,1019100,3106,72804,75910,Manhattan,2385202.729,Upper West Side-Manhattan Valley
21-Jul,36061019100,1019100,14330,114809,129139,Manhattan,2385202.729,Upper West Side-Manhattan Valley
19-Aug,36061019100,1019100,8226,20311,28537,Manhattan,2385202.729,Upper West Side-Manhattan Valley
21-Aug,36061019100,1019100,9224,78471,87695,Manhattan,2385202.729,Upper West Side-Manhattan Valley
19-May,36061019500,1019500,16008,58456,74464,Manhattan,2338296.49,Upper West Side-Manhattan Valley
21-May,36061019500,1019500,3400,49597,52997,Manhattan,2338296.49,Upper West Side-Manhattan Valley
19-Jun,36061019500,1019500,2471,123082,125553,Manhattan,2338296.49,Upper West Side-Manhattan Valley
21-Jun,36061019500,1019500,6217,83699,89916,Manhattan,2338296.49,Upper West Side-Manhattan Valley
19-Jul,36061019500,1019500,13038,92282,105320,Manhattan,2338296.49,Upper West Side-Manhattan Valley
21-Jul,36061019500,1019500,15620,156385,172005,Manhattan,2338296.49,Upper West Side-Manhattan Valley
19-Aug,36061019500,1019500,9933,51347,61280,Manhattan,2338296.49,Upper West Side-Manhattan Valley
21-Aug,36061019500,1019500,8764,99451,108215,Manhattan,2338296.49,Upper West Side-Manhattan Valley
19-May,36005028100,2028100,2534,67517,70051,Bronx,1389942.432,Kingsbridge Heights-Van Cortlandt Village
21-May,36005028100,2028100,7091,72117,79208,Bronx,1389942.432,Kingsbridge Heights-Van Cortlandt Village
19-Jun,36005028100,2028100,2362,57800,60162,Bronx,1389942.432,Kingsbridge Heights-Van Cortlandt Village
21-Jun,36005028100,2028100,14883,113963,128846,Bronx,1389942.432,Kingsbridge Heights-Van Cortlandt Village
19-Jul,36005028100,2028100,0,120029,120029,Bronx,1389942.432,Kingsbridge Heights-Van Cortlandt Village
21-Jul,36005028100,2028100,8505,31054,39559,Bronx,1389942.432,Kingsbridge Heights-Van Cortlandt Village
19-Aug,36005028100,2028100,9940,93214,103154,Bronx,1389942.432,Kingsbridge Heights-Van Cortlandt Village
21-Aug,36005028100,2028100,5662,75718,81380,Bronx,1389942.432,Kingsbridge Heights-Van Cortlandt Village
19-May,36005043503,2043503,10270,71,10341,Bronx,50658600.29,Van Cortlandt Park
21-May,36005043503,2043503,2070,90049,92119,Bronx,50658600.29,Van Cortlandt Park
19-Jun,36005043503,2043503,187,96597,96784,Bronx,50658600.29,Van Cortlandt Park
21-Jun,36005043503,2043503,12926,42629,55555,Bronx,50658600.29,Van Cortlandt Park
19-Jul,36005043503,2043503,1291,73841,75132,Bronx,50658600.29,Van Cortlandt Park
21-Jul,36005043503,2043503,17084,138182,155266,Bronx,50658600.29,Van Cortlandt Park
19-Aug,36005043503,2043503,16511,85261,101772,Bronx,50658600.29,Van Cortlandt Park
21-Aug,36005043503,2043503,16222,87853,104075,Bronx,50658600.29,Van Cortlandt Park
19-May,36005020501,2020501,8939,5809,14748,Bronx,2963902.476,University Heights (South)-Morris Heights
21-May,36005020501,2020501,7215,134688,141903,Bronx,2963902.476,University Heights (South)-Morris Heights
19-Jun,36005020501,2020501,13400,103429,116829,Bronx,2963902.476,University Heights (South)-Morris Heights
21-Jun,36005020501,2020501,3267,77646,80913,Bronx,2963902.476,University Heights (South)-Morris Heights
19-Jul,36005020501,2020501,5688,59667,65355,Bronx,2963902.476,University Heights (South)-Morris Heights
21-Jul,36005020501,2020501,15798,58420,74218,Bronx,2963902.476,University Heights (South)-Morris Heights
19-Aug,36005020501,2020501,3425,145958,149383,Bronx,2963902.476,University Heights (South)-Morris Heights
21-Aug,36005020501,2020501,6607,105984,112591,Bronx,2963902.476,University Heights (South)-Morris Heights
19-May,36005020502,2020502,13186,46444,59630,Bronx,1087282.098,University Heights (South)-Morris Heights
21-May,36005020502,2020502,11579,101975,113554,Bronx,1087282.098,University Heights (South)-Morris Heights
19-Jun,36005020502,2020502,5086,93942,99028,Bronx,1087282.098,University Heights (South)-Morris Heights
21-Jun,36005020502,2020502,14426,44660,59086,Bronx,1087282.098,University Heights (South)-Morris Heights
19-Jul,36005020502,2020502,2547,30953,33500,Bronx,1087282.098,University Heights (South)-Morris Heights
21-Jul,36005020502,2020502,15681,53713,69394,Bronx,1087282.098,University Heights (South)-Morris Heights
19-Aug,36005020502,2020502,7179,49846,57025,Bronx,1087282.098,University Heights (South)-Morris Heights
21-Aug,36005020502,2020502,4027,46667,50694,Bronx,1087282.098,University Heights (South)-Morris Heights
19-May,36081035700,4035700,8181,49387,57568,Queens,6657282.135,East Elmhurst
21-May,36081035700,4035700,5355,94972,100327,Queens,6657282.135,East Elmhurst
19-Jun,36081035700,4035700,5353,46430,51783,Queens,6657282.135,East Elmhurst
21-Jun,36081035700,4035700,11269,96909,108178,Queens,6657282.135,East Elmhurst
19-Jul,36081035700,4035700,12179,36364,48543,Queens,6657282.135,East Elmhurst
21-Jul,36081035700,4035700,2121,51539,53660,Queens,6657282.135,East Elmhurst
19-Aug,36081035700,4035700,14509,45708,60217,Queens,6657282.135,East Elmhurst
21-Aug,36081035700,4035700,4486,43406,47892,Queens,6657282.135,East Elmhurst
19-May,36081037100,4037100,6716,58131,64847,Queens,2019733.207,East Elmhurst
21-May,36081037100,4037100,6544,22325,28869,Queens,2019733.207,East Elmhurst
19-Jun,36081037100,4037100,9747,128019,137766,Queens,2019733.207,East Elmhurst
21-Jun,36081037100,4037100,1251,112379,113630,Queens,2019733.207,East Elmhurst
19-Jul,36081037100,4037100,10720,103030,113750,Queens,2019733.207,East Elmhurst
21-Jul,36081037100,4037100,4465,148427,152892,Queens,2019733.207,East Elmhurst
19-Aug,36081037100,4037100,2430,71,2501,Queens,2019733.207,East Elmhurst
21-Aug,36081037100,4037100,5738,71,5809,Queens,2019733.207,East Elmhurst
19-May,36005035800,2035800,9024,94970,103994,Bronx,7018832.064,Eastchester-Edenwald-Baychester
21-May,36005035800,2035800,17069,58235,75304,Bronx,7018832.064,Eastchester-Edenwald-Baychester
19-Jun,36005035800,2035800,4279,131788,136067,Bronx,7018832.064,Eastchester-Edenwald-Baychester
21-Jun,36005035800,2035800,5821,156151,161972,Bronx,7018832.064,Eastchester-Edenwald-Baychester
19-Jul,36005035800,2035800,1988,23393,25381,Bronx,7018832.064,Eastchester-Edenwald-Baychester
21-Jul,36005035800,2035800,16295,48747,65042,Bronx,7018832.064,Eastchester-Edenwald-Baychester
19-Aug,36005035800,2035800,6319,70132,76451,Bronx,7018832.064,Eastchester-Edenwald-Baychester
21-Aug,36005035800,2035800,11748,43674,55422,Bronx,7018832.064,Eastchester-Edenwald-Baychester
19-May,36005046208,2046208,10752,78013,88765,Bronx,5212691.119,Eastchester-Edenwald-Baychester
21-May,36005046208,2046208,14419,46958,61377,Bronx,5212691.119,Eastchester-Edenwald-Baychester
19-Jun,36005046208,2046208,3907,92039,95946,Bronx,5212691.119,Eastchester-Edenwald-Baychester
21-Jun,36005046208,2046208,4512,24273,28785,Bronx,5212691.119,Eastchester-Edenwald-Baychester
19-Jul,36005046208,2046208,12047,71,12118,Bronx,5212691.119,Eastchester-Edenwald-Baychester
21-Jul,36005046208,2046208,0,40444,40444,Bronx,5212691.119,Eastchester-Edenwald-Baychester
19-Aug,36005046208,2046208,8088,87635,95723,Bronx,5212691.119,Eastchester-Edenwald-Baychester
21-Aug,36005046208,2046208,7521,46241,53762,Bronx,5212691.119,Eastchester-Edenwald-Baychester
19-May,36061027900,1027900,7246,68026,75272,Manhattan,1941500.063,Washington Heights (North)
21-May,36061027900,1027900,0,49738,49738,Manhattan,1941500.063,Washington Heights (North)
19-Jun,36061027900,1027900,11323,71,11394,Manhattan,1941500.063,Washington Heights (North)
21-Jun,36061027900,1027900,6407,66759,73166,Manhattan,1941500.063,Washington Heights (North)
19-Jul,36061027900,1027900,7073,144072,151145,Manhattan,1941500.063,Washington Heights (North)
21-Jul,36061027900,1027900,5205,95361,100566,Manhattan,1941500.063,Washington Heights (North)
19-Aug,36061027900,1027900,1865,33519,35384,Manhattan,1941500.063,Washington Heights (North)
21-Aug,36061027900,1027900,9761,89504,99265,Manhattan,1941500.063,Washington Heights (North)
19-May,36061028300,1028300,8801,106683,115484,Manhattan,1628091.197,Washington Heights (North)
21-May,36061028300,1028300,4472,37991,42463,Manhattan,1628091.197,Washington Heights (North)
19-Jun,36061028300,1028300,4248,69991,74239,Manhattan,1628091.197,Washington Heights (North)
21-Jun,36061028300,1028300,1377,51494,52871,Manhattan,1628091.197,Washington Heights (North)
19-Jul,36061028300,1028300,15373,71691,87064,Manhattan,1628091.197,Washington Heights (North)
21-Jul,36061028300,1028300,9404,86673,96077,Manhattan,1628091.197,Washington Heights (North)
19-Aug,36061028300,1028300,5898,47360,53258,Manhattan,1628091.197,Washington Heights (North)
21-Aug,36061028300,1028300,4080,78549,82629,Manhattan,1628091.197,Washington Heights (North)
19-May,36061030300,1030300,0,77659,77659,Manhattan,1685292.555,Inwood
21-May,36061030300,1030300,0,59940,59940,Manhattan,1685292.555,Inwood
19-Jun,36061030300,1030300,5456,128894,134350,Manhattan,1685292.555,Inwood
21-Jun,36061030300,1030300,12873,33168,46041,Manhattan,1685292.555,Inwood
19-Jul,36061030300,1030300,13226,83711,96937,Manhattan,1685292.555,Inwood
21-Jul,36061030300,1030300,9806,44277,54083,Manhattan,1685292.555,Inwood
19-Aug,36061030300,1030300,6410,84348,90758,Manhattan,1685292.555,Inwood
21-Aug,36061030300,1030300,12286,8834,21120,Manhattan,1685292.555,Inwood
19-May,36061030700,1030700,8082,150988,159070,Manhattan,905520.6379,Inwood
21-May,36061030700,1030700,12077,56925,69002,Manhattan,905520.6379,Inwood
19-Jun,36061030700,1030700,11783,76108,87891,Manhattan,905520.6379,Inwood
21-Jun,36061030700,1030700,5346,52305,57651,Manhattan,905520.6379,Inwood
19-Jul,36061030700,1030700,12186,17648,29834,Manhattan,905520.6379,Inwood
21-Jul,36061030700,1030700,15876,23519,39395,Manhattan,905520.6379,Inwood
19-Aug,36061030700,1030700,7383,81673,89056,Manhattan,905520.6379,Inwood
21-Aug,36061030700,1030700,5058,130118,135176,Manhattan,905520.6379,Inwood
19-May,36061024302,1024302,4962,39375,44337,Manhattan,2271883.499,Harlem (North)
21-May,36061024302,1024302,16305,57593,73898,Manhattan,2271883.499,Harlem (North)
19-Jun,36061024302,1024302,7673,81061,88734,Manhattan,2271883.499,Harlem (North)
21-Jun,36061024302,1024302,9699,65499,75198,Manhattan,2271883.499,Harlem (North)
19-Jul,36061024302,1024302,7200,86392,93592,Manhattan,2271883.499,Harlem (North)
21-Jul,36061024302,1024302,7305,57092,64397,Manhattan,2271883.499,Harlem (North)
19-Aug,36061024302,1024302,9891,147820,157711,Manhattan,2271883.499,Harlem (North)
21-Aug,36061024302,1024302,15847,113665,129512,Manhattan,2271883.499,Harlem (North)
19-May,36061031100,1031100,11054,104231,115285,Manhattan,7750592.358,Highbridge Park
21-May,36061031100,1031100,9326,29814,39140,Manhattan,7750592.358,Highbridge Park
19-Jun,36061031100,1031100,9924,85024,94948,Manhattan,7750592.358,Highbridge Park
21-Jun,36061031100,1031100,9551,132965,142516,Manhattan,7750592.358,Highbridge Park
19-Jul,36061031100,1031100,12525,45123,57648,Manhattan,7750592.358,Highbridge Park
21-Jul,36061031100,1031100,9462,138331,147793,Manhattan,7750592.358,Highbridge Park
19-Aug,36061031100,1031100,16296,18363,34659,Manhattan,7750592.358,Highbridge Park
21-Aug,36061031100,1031100,10516,41252,51768,Manhattan,7750592.358,Highbridge Park
19-May,36081029700,4029700,16301,54517,70818,Queens,5596630.581,Astoria (East)-Woodside (North)
21-May,36081029700,4029700,14979,28046,43025,Queens,5596630.581,Astoria (East)-Woodside (North)
19-Jun,36081029700,4029700,17480,87665,105145,Queens,5596630.581,Astoria (East)-Woodside (North)
21-Jun,36081029700,4029700,17021,95299,112320,Queens,5596630.581,Astoria (East)-Woodside (North)
19-Jul,36081029700,4029700,2061,128566,130627,Queens,5596630.581,Astoria (East)-Woodside (North)
21-Jul,36081029700,4029700,4555,54066,58621,Queens,5596630.581,Astoria (East)-Woodside (North)
19-Aug,36081029700,4029700,10020,170613,180633,Queens,5596630.581,Astoria (East)-Woodside (North)
21-Aug,36081029700,4029700,8619,71,8690,Queens,5596630.581,Astoria (East)-Woodside (North)
19-May,36081030906,4030906,6023,64453,70476,Queens,2332469.953,Jackson Heights
21-May,36081030906,4030906,5652,8864,14516,Queens,2332469.953,Jackson Heights
19-Jun,36081030906,4030906,19508,204533,224041,Queens,2332469.953,Jackson Heights
21-Jun,36081030906,4030906,12683,104527,117210,Queens,2332469.953,Jackson Heights
19-Jul,36081030906,4030906,9671,82886,92557,Queens,2332469.953,Jackson Heights
21-Jul,36081030906,4030906,2072,54607,56679,Queens,2332469.953,Jackson Heights
19-Aug,36081030906,4030906,2972,71928,74900,Queens,2332469.953,Jackson Heights
21-Aug,36081030906,4030906,11509,65294,76803,Queens,2332469.953,Jackson Heights
19-May,36047056100,3056100,1776,82129,83905,Brooklyn,3577848.234,Greenpoint
21-May,36047056100,3056100,17797,2840,20637,Brooklyn,3577848.234,Greenpoint
19-Jun,36047056100,3056100,15861,80198,96059,Brooklyn,3577848.234,Greenpoint
21-Jun,36047056100,3056100,15150,44666,59816,Brooklyn,3577848.234,Greenpoint
19-Jul,36047056100,3056100,12743,94940,107683,Brooklyn,3577848.234,Greenpoint
21-Jul,36047056100,3056100,7935,64030,71965,Brooklyn,3577848.234,Greenpoint
19-Aug,36047056100,3056100,11550,67789,79339,Brooklyn,3577848.234,Greenpoint
21-Aug,36047056100,3056100,538,52870,53408,Brooklyn,3577848.234,Greenpoint
19-May,36047056500,3056500,2533,105699,108232,Brooklyn,2557314.292,Greenpoint
21-May,36047056500,3056500,13036,76574,89610,Brooklyn,2557314.292,Greenpoint
19-Jun,36047056500,3056500,17188,68874,86062,Brooklyn,2557314.292,Greenpoint
21-Jun,36047056500,3056500,6207,74341,80548,Brooklyn,2557314.292,Greenpoint
19-Jul,36047056500,3056500,1778,90419,92197,Brooklyn,2557314.292,Greenpoint
21-Jul,36047056500,3056500,11401,67885,79286,Brooklyn,2557314.292,Greenpoint
19-Aug,36047056500,3056500,15558,15662,31220,Brooklyn,2557314.292,Greenpoint
21-Aug,36047056500,3056500,6883,62524,69407,Brooklyn,2557314.292,Greenpoint
19-May,36081037300,4037300,9302,17469,26771,Queens,2553731.066,East Elmhurst
21-May,36081037300,4037300,9493,139801,149294,Queens,2553731.066,East Elmhurst
19-Jun,36081037300,4037300,15224,79431,94655,Queens,2553731.066,East Elmhurst
21-Jun,36081037300,4037300,10946,71789,82735,Queens,2553731.066,East Elmhurst
19-Jul,36081037300,4037300,5746,52299,58045,Queens,2553731.066,East Elmhurst
21-Jul,36081037300,4037300,5907,61345,67252,Queens,2553731.066,East Elmhurst
19-Aug,36081037300,4037300,18356,130868,149224,Queens,2553731.066,East Elmhurst
21-Aug,36081037300,4037300,15653,65939,81592,Queens,2553731.066,East Elmhurst
19-May,36081038100,4038100,13759,35235,48994,Queens,3074856.084,North Corona
21-May,36081038100,4038100,6942,63186,70128,Queens,3074856.084,North Corona
19-Jun,36081038100,4038100,8610,83547,92157,Queens,3074856.084,North Corona
21-Jun,36081038100,4038100,8505,149056,157561,Queens,3074856.084,North Corona
19-Jul,36081038100,4038100,24,48478,48502,Queens,3074856.084,North Corona
21-Jul,36081038100,4038100,11919,85210,97129,Queens,3074856.084,North Corona
19-Aug,36081038100,4038100,1291,73289,74580,Queens,3074856.084,North Corona
21-Aug,36081038100,4038100,1720,164281,166001,Queens,3074856.084,North Corona
19-May,36085027702,5027702,14828,138285,153113,Staten Island,15700677.55,New Springville-Willowbrook-Bulls Head-Travis
21-May,36085027702,5027702,12672,68108,80780,Staten Island,15700677.55,New Springville-Willowbrook-Bulls Head-Travis
19-Jun,36085027702,5027702,4180,74289,78469,Staten Island,15700677.55,New Springville-Willowbrook-Bulls Head-Travis
21-Jun,36085027702,5027702,0,107566,107566,Staten Island,15700677.55,New Springville-Willowbrook-Bulls Head-Travis
19-Jul,36085027702,5027702,9253,98134,107387,Staten Island,15700677.55,New Springville-Willowbrook-Bulls Head-Travis
21-Jul,36085027702,5027702,4054,126898,130952,Staten Island,15700677.55,New Springville-Willowbrook-Bulls Head-Travis
19-Aug,36085027702,5027702,4199,88910,93109,Staten Island,15700677.55,New Springville-Willowbrook-Bulls Head-Travis
21-Aug,36085027702,5027702,4381,127147,131528,Staten Island,15700677.55,New Springville-Willowbrook-Bulls Head-Travis
19-May,36085027706,5027706,3872,21878,25750,Staten Island,4718053.43,New Springville-Willowbrook-Bulls Head-Travis
21-May,36085027706,5027706,10794,92053,102847,Staten Island,4718053.43,New Springville-Willowbrook-Bulls Head-Travis
19-Jun,36085027706,5027706,12905,60126,73031,Staten Island,4718053.43,New Springville-Willowbrook-Bulls Head-Travis
21-Jun,36085027706,5027706,12994,100707,113701,Staten Island,4718053.43,New Springville-Willowbrook-Bulls Head-Travis
19-Jul,36085027706,5027706,6495,130736,137231,Staten Island,4718053.43,New Springville-Willowbrook-Bulls Head-Travis
21-Jul,36085027706,5027706,0,4556,4556,Staten Island,4718053.43,New Springville-Willowbrook-Bulls Head-Travis
19-Aug,36085027706,5027706,14361,101582,115943,Staten Island,4718053.43,New Springville-Willowbrook-Bulls Head-Travis
21-Aug,36085027706,5027706,5844,44944,50788,Staten Island,4718053.43,New Springville-Willowbrook-Bulls Head-Travis
19-May,36085019800,5019800,22205,43723,65928,Staten Island,61325645.96,Annadale-Huguenot-Prince's Bay-Woodrow
21-May,36085019800,5019800,15241,8946,24187,Staten Island,61325645.96,Annadale-Huguenot-Prince's Bay-Woodrow
19-Jun,36085019800,5019800,9281,68320,77601,Staten Island,61325645.96,Annadale-Huguenot-Prince's Bay-Woodrow
21-Jun,36085019800,5019800,13634,44475,58109,Staten Island,61325645.96,Annadale-Huguenot-Prince's Bay-Woodrow
19-Jul,36085019800,5019800,4479,62475,66954,Staten Island,61325645.96,Annadale-Huguenot-Prince's Bay-Woodrow
21-Jul,36085019800,5019800,9234,54353,63587,Staten Island,61325645.96,Annadale-Huguenot-Prince's Bay-Woodrow
19-Aug,36085019800,5019800,7700,122060,129760,Staten Island,61325645.96,Annadale-Huguenot-Prince's Bay-Woodrow
21-Aug,36085019800,5019800,11081,157230,168311,Staten Island,61325645.96,Annadale-Huguenot-Prince's Bay-Woodrow
19-May,36085020803,5020803,10851,120719,131570,Staten Island,22624234.26,Annadale-Huguenot-Prince's Bay-Woodrow
21-May,36085020803,5020803,5592,30336,35928,Staten Island,22624234.26,Annadale-Huguenot-Prince's Bay-Woodrow
19-Jun,36085020803,5020803,7340,73377,80717,Staten Island,22624234.26,Annadale-Huguenot-Prince's Bay-Woodrow
21-Jun,36085020803,5020803,704,50411,51115,Staten Island,22624234.26,Annadale-Huguenot-Prince's Bay-Woodrow
19-Jul,36085020803,5020803,5548,38197,43745,Staten Island,22624234.26,Annadale-Huguenot-Prince's Bay-Woodrow
21-Jul,36085020803,5020803,4947,131706,136653,Staten Island,22624234.26,Annadale-Huguenot-Prince's Bay-Woodrow
19-Aug,36085020803,5020803,13403,76269,89672,Staten Island,22624234.26,Annadale-Huguenot-Prince's Bay-Woodrow
21-Aug,36085020803,5020803,11757,86550,98307,Staten Island,22624234.26,Annadale-Huguenot-Prince's Bay-Woodrow
19-May,36081022001,4022001,8207,73340,81547,Queens,4210341.597,Jamaica Hills-Briarwood
21-May,36081022001,4022001,13746,75479,89225,Queens,4210341.597,Jamaica Hills-Briarwood
19-Jun,36081022001,4022001,6775,70918,77693,Queens,4210341.597,Jamaica Hills-Briarwood
21-Jun,36081022001,4022001,12254,71662,83916,Queens,4210341.597,Jamaica Hills-Briarwood
19-Jul,36081022001,4022001,2980,69060,72040,Queens,4210341.597,Jamaica Hills-Briarwood
21-Jul,36081022001,4022001,12535,76777,89312,Queens,4210341.597,Jamaica Hills-Briarwood
19-Aug,36081022001,4022001,16901,96001,112902,Queens,4210341.597,Jamaica Hills-Briarwood
21-Aug,36081022001,4022001,7225,45929,53154,Queens,4210341.597,Jamaica Hills-Briarwood
19-May,36081038302,4038302,11339,89641,100980,Queens,55201416.89,Flushing Meadows-Corona Park
21-May,36081038302,4038302,4790,61227,66017,Queens,55201416.89,Flushing Meadows-Corona Park
19-Jun,36081038302,4038302,8275,78457,86732,Queens,55201416.89,Flushing Meadows-Corona Park
21-Jun,36081038302,4038302,708,107013,107721,Queens,55201416.89,Flushing Meadows-Corona Park
19-Jul,36081038302,4038302,7472,63966,71438,Queens,55201416.89,Flushing Meadows-Corona Park
21-Jul,36081038302,4038302,4412,36033,40445,Queens,55201416.89,Flushing Meadows-Corona Park
19-Aug,36081038302,4038302,2493,121861,124354,Queens,55201416.89,Flushing Meadows-Corona Park
21-Aug,36081038302,4038302,11390,27334,38724,Queens,55201416.89,Flushing Meadows-Corona Park
19-May,36081091800,4091800,10339,98600,108939,Queens,12097073.16,Jacob Riis Park-Fort Tilden-Breezy Point Tip
21-May,36081091800,4091800,6729,77198,83927,Queens,12097073.16,Jacob Riis Park-Fort Tilden-Breezy Point Tip
19-Jun,36081091800,4091800,11049,124433,135482,Queens,12097073.16,Jacob Riis Park-Fort Tilden-Breezy Point Tip
21-Jun,36081091800,4091800,7687,51632,59319,Queens,12097073.16,Jacob Riis Park-Fort Tilden-Breezy Point Tip
19-Jul,36081091800,4091800,13481,70282,83763,Queens,12097073.16,Jacob Riis Park-Fort Tilden-Breezy Point Tip
21-Jul,36081091800,4091800,0,73134,73134,Queens,12097073.16,Jacob Riis Park-Fort Tilden-Breezy Point Tip
19-Aug,36081091800,4091800,8552,71,8623,Queens,12097073.16,Jacob Riis Park-Fort Tilden-Breezy Point Tip
21-Aug,36081091800,4091800,5489,126859,132348,Queens,12097073.16,Jacob Riis Park-Fort Tilden-Breezy Point Tip
19-May,36081092200,4092200,15398,28806,44204,Queens,6859442.24,Breezy Point-Belle Harbor-Rockaway Park-Broad Channel
21-May,36081092200,4092200,9707,50284,59991,Queens,6859442.24,Breezy Point-Belle Harbor-Rockaway Park-Broad Channel
19-Jun,36081092200,4092200,4174,134933,139107,Queens,6859442.24,Breezy Point-Belle Harbor-Rockaway Park-Broad Channel
21-Jun,36081092200,4092200,14488,25325,39813,Queens,6859442.24,Breezy Point-Belle Harbor-Rockaway Park-Broad Channel
19-Jul,36081092200,4092200,10694,84393,95087,Queens,6859442.24,Breezy Point-Belle Harbor-Rockaway Park-Broad Channel
21-Jul,36081092200,4092200,7077,40018,47095,Queens,6859442.24,Breezy Point-Belle Harbor-Rockaway Park-Broad Channel
19-Aug,36081092200,4092200,8535,51376,59911,Queens,6859442.24,Breezy Point-Belle Harbor-Rockaway Park-Broad Channel
21-Aug,36081092200,4092200,3471,106670,110141,Queens,6859442.24,Breezy Point-Belle Harbor-Rockaway Park-Broad Channel
19-May,36085002001,5002001,0,73681,73681,Staten Island,5511201.602,Rosebank-Shore Acres-Park Hill
21-May,36085002001,5002001,6017,112993,119010,Staten Island,5511201.602,Rosebank-Shore Acres-Park Hill
19-Jun,36085002001,5002001,2373,97809,100182,Staten Island,5511201.602,Rosebank-Shore Acres-Park Hill
21-Jun,36085002001,5002001,10603,39480,50083,Staten Island,5511201.602,Rosebank-Shore Acres-Park Hill
19-Jul,36085002001,5002001,16154,87814,103968,Staten Island,5511201.602,Rosebank-Shore Acres-Park Hill
21-Jul,36085002001,5002001,15286,117230,132516,Staten Island,5511201.602,Rosebank-Shore Acres-Park Hill
19-Aug,36085002001,5002001,8983,70113,79096,Staten Island,5511201.602,Rosebank-Shore Acres-Park Hill
21-Aug,36085002001,5002001,7417,36755,44172,Staten Island,5511201.602,Rosebank-Shore Acres-Park Hill
19-May,36085003600,5003600,11904,71,11975,Staten Island,4416091.871,Rosebank-Shore Acres-Park Hill
21-May,36085003600,5003600,8162,40672,48834,Staten Island,4416091.871,Rosebank-Shore Acres-Park Hill
19-Jun,36085003600,5003600,675,84908,85583,Staten Island,4416091.871,Rosebank-Shore Acres-Park Hill
21-Jun,36085003600,5003600,8883,74808,83691,Staten Island,4416091.871,Rosebank-Shore Acres-Park Hill
19-Jul,36085003600,5003600,3744,67923,71667,Staten Island,4416091.871,Rosebank-Shore Acres-Park Hill
21-Jul,36085003600,5003600,3392,51102,54494,Staten Island,4416091.871,Rosebank-Shore Acres-Park Hill
19-Aug,36085003600,5003600,9513,106748,116261,Staten Island,4416091.871,Rosebank-Shore Acres-Park Hill
21-Aug,36085003600,5003600,11017,133650,144667,Staten Island,4416091.871,Rosebank-Shore Acres-Park Hill
19-May,36047042000,3042000,8941,130377,139318,Brooklyn,1820082.859,Gravesend (East)-Homecrest
21-May,36047042000,3042000,7588,92855,100443,Brooklyn,1820082.859,Gravesend (East)-Homecrest
19-Jun,36047042000,3042000,14829,107533,122362,Brooklyn,1820082.859,Gravesend (East)-Homecrest
21-Jun,36047042000,3042000,16179,112051,128230,Brooklyn,1820082.859,Gravesend (East)-Homecrest
19-Jul,36047042000,3042000,2539,103462,106001,Brooklyn,1820082.859,Gravesend (East)-Homecrest
21-Jul,36047042000,3042000,10461,86158,96619,Brooklyn,1820082.859,Gravesend (East)-Homecrest
19-Aug,36047042000,3042000,8094,102134,110228,Brooklyn,1820082.859,Gravesend (East)-Homecrest
21-Aug,36047042000,3042000,566,87165,87731,Brooklyn,1820082.859,Gravesend (East)-Homecrest
19-May,36047054200,3054200,5665,71,5736,Brooklyn,2036862.888,Midwood
21-May,36047054200,3054200,0,88208,88208,Brooklyn,2036862.888,Midwood
19-Jun,36047054200,3054200,13199,125121,138320,Brooklyn,2036862.888,Midwood
21-Jun,36047054200,3054200,13653,75053,88706,Brooklyn,2036862.888,Midwood
19-Jul,36047054200,3054200,6273,104274,110547,Brooklyn,2036862.888,Midwood
21-Jul,36047054200,3054200,13005,78365,91370,Brooklyn,2036862.888,Midwood
19-Aug,36047054200,3054200,6072,106735,112807,Brooklyn,2036862.888,Midwood
21-Aug,36047054200,3054200,9361,82073,91434,Brooklyn,2036862.888,Midwood
19-May,36047055400,3055400,4386,48444,52830,Brooklyn,1821858.649,Gravesend (East)-Homecrest
21-May,36047055400,3055400,1417,119595,121012,Brooklyn,1821858.649,Gravesend (East)-Homecrest
19-Jun,36047055400,3055400,15684,61779,77463,Brooklyn,1821858.649,Gravesend (East)-Homecrest
21-Jun,36047055400,3055400,6832,55108,61940,Brooklyn,1821858.649,Gravesend (East)-Homecrest
19-Jul,36047055400,3055400,115,5418,5533,Brooklyn,1821858.649,Gravesend (East)-Homecrest
21-Jul,36047055400,3055400,11443,53914,65357,Brooklyn,1821858.649,Gravesend (East)-Homecrest
19-Aug,36047055400,3055400,13487,39978,53465,Brooklyn,1821858.649,Gravesend (East)-Homecrest
21-Aug,36047055400,3055400,8426,86060,94486,Brooklyn,1821858.649,Gravesend (East)-Homecrest
19-May,36061028500,1028500,156,138916,139072,Manhattan,1312484.638,Washington Heights (North)
21-May,36061028500,1028500,5688,167660,173348,Manhattan,1312484.638,Washington Heights (North)
19-Jun,36061028500,1028500,7656,22680,30336,Manhattan,1312484.638,Washington Heights (North)
21-Jun,36061028500,1028500,9166,119114,128280,Manhattan,1312484.638,Washington Heights (North)
19-Jul,36061028500,1028500,14112,85503,99615,Manhattan,1312484.638,Washington Heights (North)
21-Jul,36061028500,1028500,11486,93932,105418,Manhattan,1312484.638,Washington Heights (North)
19-Aug,36061028500,1028500,20763,52359,73122,Manhattan,1312484.638,Washington Heights (North)
21-Aug,36061028500,1028500,1694,88304,89998,Manhattan,1312484.638,Washington Heights (North)
19-May,36061028700,1028700,5841,67851,73692,Manhattan,5714367.871,Washington Heights (North)
21-May,36061028700,1028700,5053,83864,88917,Manhattan,5714367.871,Washington Heights (North)
19-Jun,36061028700,1028700,6979,46730,53709,Manhattan,5714367.871,Washington Heights (North)
21-Jun,36061028700,1028700,13135,51138,64273,Manhattan,5714367.871,Washington Heights (North)
19-Jul,36061028700,1028700,4943,68976,73919,Manhattan,5714367.871,Washington Heights (North)
21-Jul,36061028700,1028700,6755,73361,80116,Manhattan,5714367.871,Washington Heights (North)
19-Aug,36061028700,1028700,13374,13215,26589,Manhattan,5714367.871,Washington Heights (North)
21-Aug,36061028700,1028700,5250,140193,145443,Manhattan,5714367.871,Washington Heights (North)
19-May,36005038303,2038303,18187,56728,74915,Bronx,809976.9082,Fordham Heights
21-May,36005038303,2038303,1846,108982,110828,Bronx,809976.9082,Fordham Heights
19-Jun,36005038303,2038303,14895,32984,47879,Bronx,809976.9082,Fordham Heights
21-Jun,36005038303,2038303,10303,120471,130774,Bronx,809976.9082,Fordham Heights
19-Jul,36005038303,2038303,9732,55846,65578,Bronx,809976.9082,Fordham Heights
21-Jul,36005038303,2038303,19285,49573,68858,Bronx,809976.9082,Fordham Heights
19-Aug,36005038303,2038303,3837,67359,71196,Bronx,809976.9082,Fordham Heights
21-Aug,36005038303,2038303,12328,100833,113161,Bronx,809976.9082,Fordham Heights
19-May,36005039902,2039902,15126,109549,124675,Bronx,1309646.331,Fordham Heights
21-May,36005039902,2039902,10182,83530,93712,Bronx,1309646.331,Fordham Heights
19-Jun,36005039902,2039902,11484,38603,50087,Bronx,1309646.331,Fordham Heights
21-Jun,36005039902,2039902,3558,16589,20147,Bronx,1309646.331,Fordham Heights
19-Jul,36005039902,2039902,15204,71,15275,Bronx,1309646.331,Fordham Heights
21-Jul,36005039902,2039902,12546,97316,109862,Bronx,1309646.331,Fordham Heights
19-Aug,36005039902,2039902,9785,86563,96348,Bronx,1309646.331,Fordham Heights
21-Aug,36005039902,2039902,16340,102217,118557,Bronx,1309646.331,Fordham Heights
19-May,36061023600,1023600,12862,71,12933,Manhattan,2825486.158,Harlem (North)
21-May,36061023600,1023600,12878,11815,24693,Manhattan,2825486.158,Harlem (North)
19-Jun,36061023600,1023600,7355,84223,91578,Manhattan,2825486.158,Harlem (North)
21-Jun,36061023600,1023600,7010,92495,99505,Manhattan,2825486.158,Harlem (North)
19-Jul,36061023600,1023600,6956,107163,114119,Manhattan,2825486.158,Harlem (North)
21-Jul,36061023600,1023600,6592,27239,33831,Manhattan,2825486.158,Harlem (North)
19-Aug,36061023600,1023600,2643,23684,26327,Manhattan,2825486.158,Harlem (North)
21-Aug,36061023600,1023600,5404,102980,108384,Manhattan,2825486.158,Harlem (North)
19-May,36005006301,2006301,10887,134976,145863,Bronx,8580997.026,Concourse-Concourse Village
21-May,36005006301,2006301,7236,42408,49644,Bronx,8580997.026,Concourse-Concourse Village
19-Jun,36005006301,2006301,6393,56265,62658,Bronx,8580997.026,Concourse-Concourse Village
21-Jun,36005006301,2006301,10292,44260,54552,Bronx,8580997.026,Concourse-Concourse Village
19-Jul,36005006301,2006301,1040,56232,57272,Bronx,8580997.026,Concourse-Concourse Village
21-Jul,36005006301,2006301,3505,71,3576,Bronx,8580997.026,Concourse-Concourse Village
19-Aug,36005006301,2006301,15818,134688,150506,Bronx,8580997.026,Concourse-Concourse Village
21-Aug,36005006301,2006301,3501,92599,96100,Bronx,8580997.026,Concourse-Concourse Village
19-May,36005028900,2028900,11262,39281,50543,Bronx,2069419.267,Kingsbridge-Marble Hill
21-May,36005028900,2028900,2709,101479,104188,Bronx,2069419.267,Kingsbridge-Marble Hill
19-Jun,36005028900,2028900,5747,78928,84675,Bronx,2069419.267,Kingsbridge-Marble Hill
21-Jun,36005028900,2028900,5638,45646,51284,Bronx,2069419.267,Kingsbridge-Marble Hill
19-Jul,36005028900,2028900,14679,76117,90796,Bronx,2069419.267,Kingsbridge-Marble Hill
21-Jul,36005028900,2028900,5985,72903,78888,Bronx,2069419.267,Kingsbridge-Marble Hill
19-Aug,36005028900,2028900,16144,151764,167908,Bronx,2069419.267,Kingsbridge-Marble Hill
21-Aug,36005028900,2028900,0,33591,33591,Bronx,2069419.267,Kingsbridge-Marble Hill
19-May,36061030900,1030900,0,79063,79063,Manhattan,3282243.1,Kingsbridge-Marble Hill
21-May,36061030900,1030900,19372,59829,79201,Manhattan,3282243.1,Kingsbridge-Marble Hill
19-Jun,36061030900,1030900,2935,118825,121760,Manhattan,3282243.1,Kingsbridge-Marble Hill
21-Jun,36061030900,1030900,4529,68056,72585,Manhattan,3282243.1,Kingsbridge-Marble Hill
19-Jul,36061030900,1030900,4035,94934,98969,Manhattan,3282243.1,Kingsbridge-Marble Hill
21-Jul,36061030900,1030900,6365,67262,73627,Manhattan,3282243.1,Kingsbridge-Marble Hill
19-Aug,36061030900,1030900,10371,25792,36163,Manhattan,3282243.1,Kingsbridge-Marble Hill
21-Aug,36061030900,1030900,6378,72170,78548,Manhattan,3282243.1,Kingsbridge-Marble Hill
19-May,36085002100,5002100,9181,55964,65145,Staten Island,9292914.517,Tompkinsville-Stapleton-Clifton-Fox Hills
21-May,36085002100,5002100,5447,78314,83761,Staten Island,9292914.517,Tompkinsville-Stapleton-Clifton-Fox Hills
19-Jun,36085002100,5002100,6085,108661,114746,Staten Island,9292914.517,Tompkinsville-Stapleton-Clifton-Fox Hills
21-Jun,36085002100,5002100,11128,86584,97712,Staten Island,9292914.517,Tompkinsville-Stapleton-Clifton-Fox Hills
19-Jul,36085002100,5002100,2501,8886,11387,Staten Island,9292914.517,Tompkinsville-Stapleton-Clifton-Fox Hills
21-Jul,36085002100,5002100,2898,126241,129139,Staten Island,9292914.517,Tompkinsville-Stapleton-Clifton-Fox Hills
19-Aug,36085002100,5002100,1884,46516,48400,Staten Island,9292914.517,Tompkinsville-Stapleton-Clifton-Fox Hills
21-Aug,36085002100,5002100,6449,80681,87130,Staten Island,9292914.517,Tompkinsville-Stapleton-Clifton-Fox Hills
19-May,36047004600,3004600,8865,79529,88394,Brooklyn,3099351.478,Bay Ridge
21-May,36047004600,3004600,6413,155883,162296,Brooklyn,3099351.478,Bay Ridge
19-Jun,36047004600,3004600,9061,59107,68168,Brooklyn,3099351.478,Bay Ridge
21-Jun,36047004600,3004600,9206,73393,82599,Brooklyn,3099351.478,Bay Ridge
19-Jul,36047004600,3004600,3580,143519,147099,Brooklyn,3099351.478,Bay Ridge
21-Jul,36047004600,3004600,7340,1403,8743,Brooklyn,3099351.478,Bay Ridge
19-Aug,36047004600,3004600,5059,38730,43789,Brooklyn,3099351.478,Bay Ridge
21-Aug,36047004600,3004600,15018,118104,133122,Brooklyn,3099351.478,Bay Ridge
19-May,36085990100,5990100,7712,102752,110464,Staten Island,635701.9676,Hoffman & Swinburne Islands
21-May,36085990100,5990100,30,52391,52421,Staten Island,635701.9676,Hoffman & Swinburne Islands
19-Jun,36085990100,5990100,3832,59051,62883,Staten Island,635701.9676,Hoffman & Swinburne Islands
21-Jun,36085990100,5990100,8121,113273,121394,Staten Island,635701.9676,Hoffman & Swinburne Islands
19-Jul,36085990100,5990100,16750,56101,72851,Staten Island,635701.9676,Hoffman & Swinburne Islands
21-Jul,36085990100,5990100,9689,74948,84637,Staten Island,635701.9676,Hoffman & Swinburne Islands
19-Aug,36085990100,5990100,2164,95874,98038,Staten Island,635701.9676,Hoffman & Swinburne Islands
21-Aug,36085990100,5990100,11811,102328,114139,Staten Island,635701.9676,Hoffman & Swinburne Islands
19-May,36005000100,2000100,4106,66160,70266,Bronx,18163734.87,Rikers Island
21-May,36005000100,2000100,13111,36227,49338,Bronx,18163734.87,Rikers Island
19-Jun,36005000100,2000100,0,112631,112631,Bronx,18163734.87,Rikers Island
21-Jun,36005000100,2000100,9322,65807,75129,Bronx,18163734.87,Rikers Island
19-Jul,36005000100,2000100,262,80045,80307,Bronx,18163734.87,Rikers Island
21-Jul,36005000100,2000100,13317,91693,105010,Bronx,18163734.87,Rikers Island
19-Aug,36005000100,2000100,14755,59379,74134,Bronx,18163734.87,Rikers Island
21-Aug,36005000100,2000100,10312,102756,113068,Bronx,18163734.87,Rikers Island
19-May,36081092900,4092900,12903,131513,144416,Queens,10263731.59,College Point
21-May,36081092900,4092900,16714,40636,57350,Queens,10263731.59,College Point
19-Jun,36081092900,4092900,0,112984,112984,Queens,10263731.59,College Point
21-Jun,36081092900,4092900,6452,116623,123075,Queens,10263731.59,College Point
19-Jul,36081092900,4092900,9244,35722,44966,Queens,10263731.59,College Point
21-Jul,36081092900,4092900,0,40968,40968,Queens,10263731.59,College Point
19-Aug,36081092900,4092900,11495,15700,27195,Queens,10263731.59,College Point
21-Aug,36081092900,4092900,5177,65064,70241,Queens,10263731.59,College Point
19-May,36081009900,4009900,7414,102529,109943,Queens,2674946.297,Astoria Park
21-May,36081009900,4009900,15931,90283,106214,Queens,2674946.297,Astoria Park
19-Jun,36081009900,4009900,0,142138,142138,Queens,2674946.297,Astoria Park
21-Jun,36081009900,4009900,12317,75221,87538,Queens,2674946.297,Astoria Park
19-Jul,36081009900,4009900,7928,113542,121470,Queens,2674946.297,Astoria Park
21-Jul,36081009900,4009900,13520,80140,93660,Queens,2674946.297,Astoria Park
19-Aug,36081009900,4009900,8215,97879,106094,Queens,2674946.297,Astoria Park
21-Aug,36081009900,4009900,492,44544,45036,Queens,2674946.297,Astoria Park
19-May,36061024000,1024000,9974,155071,165045,Manhattan,23466537.76,Randall's Island
21-May,36061024000,1024000,11616,66396,78012,Manhattan,23466537.76,Randall's Island
19-Jun,36061024000,1024000,15401,58720,74121,Manhattan,23466537.76,Randall's Island
21-Jun,36061024000,1024000,12937,63624,76561,Manhattan,23466537.76,Randall's Island
19-Jul,36061024000,1024000,6054,94560,100614,Manhattan,23466537.76,Randall's Island
21-Jul,36061024000,1024000,1596,32754,34350,Manhattan,23466537.76,Randall's Island
19-Aug,36061024000,1024000,6952,67423,74375,Manhattan,23466537.76,Randall's Island
21-Aug,36061024000,1024000,8753,56189,64942,Manhattan,23466537.76,Randall's Island
19-May,36005000400,2000400,9168,57861,67029,Bronx,8557952.855,Soundview-Clason Point
21-May,36005000400,2000400,7071,115009,122080,Bronx,8557952.855,Soundview-Clason Point
19-Jun,36005000400,2000400,13175,72166,85341,Bronx,8557952.855,Soundview-Clason Point
21-Jun,36005000400,2000400,6246,38101,44347,Bronx,8557952.855,Soundview-Clason Point
19-Jul,36005000400,2000400,10178,17853,28031,Bronx,8557952.855,Soundview-Clason Point
21-Jul,36005000400,2000400,13860,105397,119257,Bronx,8557952.855,Soundview-Clason Point
19-Aug,36005000400,2000400,9957,108579,118536,Bronx,8557952.855,Soundview-Clason Point
21-Aug,36005000400,2000400,7778,83004,90782,Bronx,8557952.855,Soundview-Clason Point
19-May,36081093900,4093900,6217,78524,84741,Queens,7059359.503,College Point
21-May,36081093900,4093900,92,107196,107288,Queens,7059359.503,College Point
19-Jun,36081093900,4093900,2793,63267,66060,Queens,7059359.503,College Point
21-Jun,36081093900,4093900,5183,136282,141465,Queens,7059359.503,College Point
19-Jul,36081093900,4093900,13209,68964,82173,Queens,7059359.503,College Point
21-Jul,36081093900,4093900,18378,84277,102655,Queens,7059359.503,College Point
19-Aug,36081093900,4093900,11012,35749,46761,Queens,7059359.503,College Point
21-Aug,36081093900,4093900,16238,54177,70415,Queens,7059359.503,College Point
19-May,36005021502,2021502,6716,31342,38058,Bronx,1680526.998,University Heights (South)-Morris Heights
21-May,36005021502,2021502,13604,49350,62954,Bronx,1680526.998,University Heights (South)-Morris Heights
19-Jun,36005021502,2021502,7591,55069,62660,Bronx,1680526.998,University Heights (South)-Morris Heights
21-Jun,36005021502,2021502,9163,106048,115211,Bronx,1680526.998,University Heights (South)-Morris Heights
19-Jul,36005021502,2021502,5643,50977,56620,Bronx,1680526.998,University Heights (South)-Morris Heights
21-Jul,36005021502,2021502,13038,41156,54194,Bronx,1680526.998,University Heights (South)-Morris Heights
19-Aug,36005021502,2021502,823,71,894,Bronx,1680526.998,University Heights (South)-Morris Heights
21-Aug,36005021502,2021502,2816,153421,156237,Bronx,1680526.998,University Heights (South)-Morris Heights
19-May,36005021700,2021700,3777,80976,84753,Bronx,1730154.091,University Heights (South)-Morris Heights
21-May,36005021700,2021700,704,107776,108480,Bronx,1730154.091,University Heights (South)-Morris Heights
19-Jun,36005021700,2021700,0,34051,34051,Bronx,1730154.091,University Heights (South)-Morris Heights
21-Jun,36005021700,2021700,7049,58457,65506,Bronx,1730154.091,University Heights (South)-Morris Heights
19-Jul,36005021700,2021700,16247,71,16318,Bronx,1730154.091,University Heights (South)-Morris Heights
21-Jul,36005021700,2021700,2659,49331,51990,Bronx,1730154.091,University Heights (South)-Morris Heights
19-Aug,36005021700,2021700,17515,27378,44893,Bronx,1730154.091,University Heights (South)-Morris Heights
21-Aug,36005021700,2021700,17015,52129,69144,Bronx,1730154.091,University Heights (South)-Morris Heights
19-May,36047001804,3001804,10611,5605,16216,Brooklyn,3642808.615,Sunset Park (West)
21-May,36047001804,3001804,8948,121417,130365,Brooklyn,3642808.615,Sunset Park (West)
19-Jun,36047001804,3001804,4505,4553,9058,Brooklyn,3642808.615,Sunset Park (West)
21-Jun,36047001804,3001804,16190,89177,105367,Brooklyn,3642808.615,Sunset Park (West)
19-Jul,36047001804,3001804,4286,102972,107258,Brooklyn,3642808.615,Sunset Park (West)
21-Jul,36047001804,3001804,8348,33272,41620,Brooklyn,3642808.615,Sunset Park (West)
19-Aug,36047001804,3001804,0,77801,77801,Brooklyn,3642808.615,Sunset Park (West)
21-Aug,36047001804,3001804,13915,74457,88372,Brooklyn,3642808.615,Sunset Park (West)
19-May,36047002200,3002200,4240,97466,101706,Brooklyn,3648873.831,Sunset Park (West)
21-May,36047002200,3002200,3668,113133,116801,Brooklyn,3648873.831,Sunset Park (West)
19-Jun,36047002200,3002200,5132,114816,119948,Brooklyn,3648873.831,Sunset Park (West)
21-Jun,36047002200,3002200,15130,60241,75371,Brooklyn,3648873.831,Sunset Park (West)
19-Jul,36047002200,3002200,3907,62582,66489,Brooklyn,3648873.831,Sunset Park (West)
21-Jul,36047002200,3002200,9954,41958,51912,Brooklyn,3648873.831,Sunset Park (West)
19-Aug,36047002200,3002200,5091,51074,56165,Brooklyn,3648873.831,Sunset Park (West)
21-Aug,36047002200,3002200,13901,146966,160867,Brooklyn,3648873.831,Sunset Park (West)
19-May,36047000200,3000200,7139,66469,73608,Brooklyn,2952085.221,Sunset Park (West)
21-May,36047000200,3000200,12304,70313,82617,Brooklyn,2952085.221,Sunset Park (West)
19-Jun,36047000200,3000200,15889,61276,77165,Brooklyn,2952085.221,Sunset Park (West)
21-Jun,36047000200,3000200,3581,81743,85324,Brooklyn,2952085.221,Sunset Park (West)
19-Jul,36047000200,3000200,5950,93506,99456,Brooklyn,2952085.221,Sunset Park (West)
21-Jul,36047000200,3000200,5782,125525,131307,Brooklyn,2952085.221,Sunset Park (West)
19-Aug,36047000200,3000200,668,82923,83591,Brooklyn,2952085.221,Sunset Park (West)
21-Aug,36047000200,3000200,11211,56030,67241,Brooklyn,2952085.221,Sunset Park (West)
19-May,36047001802,3001802,15781,95546,111327,Brooklyn,6395102.667,Sunset Park (West)
21-May,36047001802,3001802,3701,43140,46841,Brooklyn,6395102.667,Sunset Park (West)
19-Jun,36047001802,3001802,4751,55896,60647,Brooklyn,6395102.667,Sunset Park (West)
21-Jun,36047001802,3001802,11878,111361,123239,Brooklyn,6395102.667,Sunset Park (West)
19-Jul,36047001802,3001802,7600,131675,139275,Brooklyn,6395102.667,Sunset Park (West)
21-Jul,36047001802,3001802,603,71784,72387,Brooklyn,6395102.667,Sunset Park (West)
19-Aug,36047001802,3001802,11708,44086,55794,Brooklyn,6395102.667,Sunset Park (West)
21-Aug,36047001802,3001802,16496,25078,41574,Brooklyn,6395102.667,Sunset Park (West)
19-May,36081014202,4014202,3876,40595,44471,Queens,6665991.847,Richmond Hill
21-May,36081014202,4014202,12473,71,12544,Queens,6665991.847,Richmond Hill
19-Jun,36081014202,4014202,14085,158469,172554,Queens,6665991.847,Richmond Hill
21-Jun,36081014202,4014202,12197,75210,87407,Queens,6665991.847,Richmond Hill
19-Jul,36081014202,4014202,8310,56297,64607,Queens,6665991.847,Richmond Hill
21-Jul,36081014202,4014202,5643,104494,110137,Queens,6665991.847,Richmond Hill
19-Aug,36081014202,4014202,4141,187524,191665,Queens,6665991.847,Richmond Hill
21-Aug,36081014202,4014202,7345,80527,87872,Queens,6665991.847,Richmond Hill
19-May,36081014400,4014400,12599,90881,103480,Queens,2367746.355,Richmond Hill
21-May,36081014400,4014400,3969,42886,46855,Queens,2367746.355,Richmond Hill
19-Jun,36081014400,4014400,6306,33631,39937,Queens,2367746.355,Richmond Hill
21-Jun,36081014400,4014400,6496,27735,34231,Queens,2367746.355,Richmond Hill
19-Jul,36081014400,4014400,14488,15768,30256,Queens,2367746.355,Richmond Hill
21-Jul,36081014400,4014400,14479,95750,110229,Queens,2367746.355,Richmond Hill
19-Aug,36081014400,4014400,5269,99523,104792,Queens,2367746.355,Richmond Hill
21-Aug,36081014400,4014400,8646,155833,164479,Queens,2367746.355,Richmond Hill
19-May,36081095400,4095400,4032,61881,65913,Queens,8729578.651,Rockaway Beach-Arverne-Edgemere
21-May,36081095400,4095400,13825,34478,48303,Queens,8729578.651,Rockaway Beach-Arverne-Edgemere
19-Jun,36081095400,4095400,8901,23421,32322,Queens,8729578.651,Rockaway Beach-Arverne-Edgemere
21-Jun,36081095400,4095400,8531,56893,65424,Queens,8729578.651,Rockaway Beach-Arverne-Edgemere
19-Jul,36081095400,4095400,10353,137373,147726,Queens,8729578.651,Rockaway Beach-Arverne-Edgemere
21-Jul,36081095400,4095400,13938,30370,44308,Queens,8729578.651,Rockaway Beach-Arverne-Edgemere
19-Aug,36081095400,4095400,16030,115586,131616,Queens,8729578.651,Rockaway Beach-Arverne-Edgemere
21-Aug,36081095400,4095400,6491,93125,99616,Queens,8729578.651,Rockaway Beach-Arverne-Edgemere
19-May,36081096400,4096400,14300,70071,84371,Queens,9237368.958,Rockaway Beach-Arverne-Edgemere
21-May,36081096400,4096400,1565,71,1636,Queens,9237368.958,Rockaway Beach-Arverne-Edgemere
19-Jun,36081096400,4096400,7665,90743,98408,Queens,9237368.958,Rockaway Beach-Arverne-Edgemere
21-Jun,36081096400,4096400,14566,61083,75649,Queens,9237368.958,Rockaway Beach-Arverne-Edgemere
19-Jul,36081096400,4096400,7922,84246,92168,Queens,9237368.958,Rockaway Beach-Arverne-Edgemere
21-Jul,36081096400,4096400,11879,131321,143200,Queens,9237368.958,Rockaway Beach-Arverne-Edgemere
19-Aug,36081096400,4096400,10099,5449,15548,Queens,9237368.958,Rockaway Beach-Arverne-Edgemere
21-Aug,36081096400,4096400,9007,1838,10845,Queens,9237368.958,Rockaway Beach-Arverne-Edgemere
19-May,36061004200,1004200,4884,71446,76330,Manhattan,936398.9399,East Village
21-May,36061004200,1004200,7532,82567,90099,Manhattan,936398.9399,East Village
19-Jun,36061004200,1004200,11543,82136,93679,Manhattan,936398.9399,East Village
21-Jun,36061004200,1004200,9542,71,9613,Manhattan,936398.9399,East Village
19-Jul,36061004200,1004200,3374,59047,62421,Manhattan,936398.9399,East Village
21-Jul,36061004200,1004200,2999,34925,37924,Manhattan,936398.9399,East Village
19-Aug,36061004200,1004200,9023,63795,72818,Manhattan,936398.9399,East Village
21-Aug,36061004200,1004200,9428,141980,151408,Manhattan,936398.9399,East Village
19-May,36061005700,1005700,9270,45968,55238,Manhattan,1153607.135,Greenwich Village
21-May,36061005700,1005700,14581,77788,92369,Manhattan,1153607.135,Greenwich Village
19-Jun,36061005700,1005700,5643,47057,52700,Manhattan,1153607.135,Greenwich Village
21-Jun,36061005700,1005700,9564,73181,82745,Manhattan,1153607.135,Greenwich Village
19-Jul,36061005700,1005700,12454,113109,125563,Manhattan,1153607.135,Greenwich Village
21-Jul,36061005700,1005700,9103,24448,33551,Manhattan,1153607.135,Greenwich Village
19-Aug,36061005700,1005700,9068,95604,104672,Manhattan,1153607.135,Greenwich Village
21-Aug,36061005700,1005700,8479,152320,160799,Manhattan,1153607.135,Greenwich Village
19-May,36081024300,4024300,4098,100556,104654,Queens,5935211.444,Woodside
21-May,36081024300,4024300,7471,71,7542,Queens,5935211.444,Woodside
19-Jun,36081024300,4024300,0,41260,41260,Queens,5935211.444,Woodside
21-Jun,36081024300,4024300,8403,62530,70933,Queens,5935211.444,Woodside
19-Jul,36081024300,4024300,15930,96251,112181,Queens,5935211.444,Woodside
21-Jul,36081024300,4024300,12533,109591,122124,Queens,5935211.444,Woodside
19-Aug,36081024300,4024300,1074,104069,105143,Queens,5935211.444,Woodside
21-Aug,36081024300,4024300,9153,74689,83842,Queens,5935211.444,Woodside
19-May,36081051300,4051300,21180,74139,95319,Queens,2082387.82,Maspeth
21-May,36081051300,4051300,8822,71,8893,Queens,2082387.82,Maspeth
19-Jun,36081051300,4051300,9302,81100,90402,Queens,2082387.82,Maspeth
21-Jun,36081051300,4051300,17349,122870,140219,Queens,2082387.82,Maspeth
19-Jul,36081051300,4051300,8601,89550,98151,Queens,2082387.82,Maspeth
21-Jul,36081051300,4051300,9767,28794,38561,Queens,2082387.82,Maspeth
19-Aug,36081051300,4051300,7178,104900,112078,Queens,2082387.82,Maspeth
21-Aug,36081051300,4051300,8376,103048,111424,Queens,2082387.82,Maspeth
19-May,36081051700,4051700,10250,96688,106938,Queens,2737061.362,Maspeth
21-May,36081051700,4051700,20562,135343,155905,Queens,2737061.362,Maspeth
19-Jun,36081051700,4051700,4280,1745,6025,Queens,2737061.362,Maspeth
21-Jun,36081051700,4051700,1940,87187,89127,Queens,2737061.362,Maspeth
19-Jul,36081051700,4051700,8226,70830,79056,Queens,2737061.362,Maspeth
21-Jul,36081051700,4051700,4734,18897,23631,Queens,2737061.362,Maspeth
19-Aug,36081051700,4051700,1763,116586,118349,Queens,2737061.362,Maspeth
21-Aug,36081051700,4051700,5933,138425,144358,Queens,2737061.362,Maspeth
19-May,36081053100,4053100,9532,55243,64775,Queens,4558842.455,Maspeth
21-May,36081053100,4053100,9292,92677,101969,Queens,4558842.455,Maspeth
19-Jun,36081053100,4053100,0,121684,121684,Queens,4558842.455,Maspeth
21-Jun,36081053100,4053100,9801,138596,148397,Queens,4558842.455,Maspeth
19-Jul,36081053100,4053100,15231,50882,66113,Queens,4558842.455,Maspeth
21-Jul,36081053100,4053100,6848,96723,103571,Queens,4558842.455,Maspeth
19-Aug,36081053100,4053100,7198,45309,52507,Queens,4558842.455,Maspeth
21-Aug,36081053100,4053100,0,182885,182885,Queens,4558842.455,Maspeth
19-May,36081094202,4094202,15693,54412,70105,Queens,7692402.793,Rockaway Beach-Arverne-Edgemere
21-May,36081094202,4094202,6840,23176,30016,Queens,7692402.793,Rockaway Beach-Arverne-Edgemere
19-Jun,36081094202,4094202,1164,45988,47152,Queens,7692402.793,Rockaway Beach-Arverne-Edgemere
21-Jun,36081094202,4094202,14084,73908,87992,Queens,7692402.793,Rockaway Beach-Arverne-Edgemere
19-Jul,36081094202,4094202,1536,38659,40195,Queens,7692402.793,Rockaway Beach-Arverne-Edgemere
21-Jul,36081094202,4094202,8225,77686,85911,Queens,7692402.793,Rockaway Beach-Arverne-Edgemere
19-Aug,36081094202,4094202,1816,81413,83229,Queens,7692402.793,Rockaway Beach-Arverne-Edgemere
21-Aug,36081094202,4094202,6555,107898,114453,Queens,7692402.793,Rockaway Beach-Arverne-Edgemere
19-May,36081094203,4094203,0,60889,60889,Queens,5584548.523,Rockaway Beach-Arverne-Edgemere
21-May,36081094203,4094203,15553,80541,96094,Queens,5584548.523,Rockaway Beach-Arverne-Edgemere
19-Jun,36081094203,4094203,12685,38672,51357,Queens,5584548.523,Rockaway Beach-Arverne-Edgemere
21-Jun,36081094203,4094203,12984,47406,60390,Queens,5584548.523,Rockaway Beach-Arverne-Edgemere
19-Jul,36081094203,4094203,15464,124117,139581,Queens,5584548.523,Rockaway Beach-Arverne-Edgemere
21-Jul,36081094203,4094203,3996,157764,161760,Queens,5584548.523,Rockaway Beach-Arverne-Edgemere
19-Aug,36081094203,4094203,15639,129557,145196,Queens,5584548.523,Rockaway Beach-Arverne-Edgemere
21-Aug,36081094203,4094203,10173,52651,62824,Queens,5584548.523,Rockaway Beach-Arverne-Edgemere
19-May,36047044902,3044902,4714,110772,115486,Brooklyn,18813945.32,East Williamsburg
21-May,36047044902,3044902,2232,56081,58313,Brooklyn,18813945.32,East Williamsburg
19-Jun,36047044902,3044902,13888,23393,37281,Brooklyn,18813945.32,East Williamsburg
21-Jun,36047044902,3044902,4752,66318,71070,Brooklyn,18813945.32,East Williamsburg
19-Jul,36047044902,3044902,6777,87516,94293,Brooklyn,18813945.32,East Williamsburg
21-Jul,36047044902,3044902,8426,42638,51064,Brooklyn,18813945.32,East Williamsburg
19-Aug,36047044902,3044902,1640,51946,53586,Brooklyn,18813945.32,East Williamsburg
21-Aug,36047044902,3044902,10555,34095,44650,Brooklyn,18813945.32,East Williamsburg
19-May,36047048100,3048100,7865,113250,121115,Brooklyn,1629522.26,East Williamsburg
21-May,36047048100,3048100,7177,99477,106654,Brooklyn,1629522.26,East Williamsburg
19-Jun,36047048100,3048100,7303,73392,80695,Brooklyn,1629522.26,East Williamsburg
21-Jun,36047048100,3048100,13620,21235,34855,Brooklyn,1629522.26,East Williamsburg
19-Jul,36047048100,3048100,9828,85081,94909,Brooklyn,1629522.26,East Williamsburg
21-Jul,36047048100,3048100,11736,35210,46946,Brooklyn,1629522.26,East Williamsburg
19-Aug,36047048100,3048100,15816,62610,78426,Brooklyn,1629522.26,East Williamsburg
21-Aug,36047048100,3048100,10282,43263,53545,Brooklyn,1629522.26,East Williamsburg
19-May,36081040901,4040901,2877,76422,79299,Queens,762702.0973,Corona
21-May,36081040901,4040901,12680,44018,56698,Queens,762702.0973,Corona
19-Jun,36081040901,4040901,0,62444,62444,Queens,762702.0973,Corona
21-Jun,36081040901,4040901,8955,20487,29442,Queens,762702.0973,Corona
19-Jul,36081040901,4040901,14279,44302,58581,Queens,762702.0973,Corona
21-Jul,36081040901,4040901,1734,73067,74801,Queens,762702.0973,Corona
19-Aug,36081040901,4040901,3763,37511,41274,Queens,762702.0973,Corona
21-Aug,36081040901,4040901,11565,103074,114639,Queens,762702.0973,Corona
19-May,36081040902,4040902,7473,48335,55808,Queens,878530.49,North Corona
21-May,36081040902,4040902,14146,30597,44743,Queens,878530.49,North Corona
19-Jun,36081040902,4040902,1153,34415,35568,Queens,878530.49,North Corona
21-Jun,36081040902,4040902,5932,109143,115075,Queens,878530.49,North Corona
19-Jul,36081040902,4040902,14441,65119,79560,Queens,878530.49,North Corona
21-Jul,36081040902,4040902,4417,133045,137462,Queens,878530.49,North Corona
19-Aug,36081040902,4040902,7129,20300,27429,Queens,878530.49,North Corona
21-Aug,36081040902,4040902,12589,49084,61673,Queens,878530.49,North Corona
19-May,36047070202,3070202,8616,79862,88478,Brooklyn,54676007.54,Barren Island-Floyd Bennett Field
21-May,36047070202,3070202,11045,108797,119842,Brooklyn,54676007.54,Barren Island-Floyd Bennett Field
19-Jun,36047070202,3070202,7807,150765,158572,Brooklyn,54676007.54,Barren Island-Floyd Bennett Field
21-Jun,36047070202,3070202,0,48394,48394,Brooklyn,54676007.54,Barren Island-Floyd Bennett Field
19-Jul,36047070202,3070202,8947,124188,133135,Brooklyn,54676007.54,Barren Island-Floyd Bennett Field
21-Jul,36047070202,3070202,2291,126095,128386,Brooklyn,54676007.54,Barren Island-Floyd Bennett Field
19-Aug,36047070202,3070202,15327,106096,121423,Brooklyn,54676007.54,Barren Island-Floyd Bennett Field
21-Aug,36047070202,3070202,7741,59811,67552,Brooklyn,54676007.54,Barren Island-Floyd Bennett Field
19-May,36047070602,3070602,18515,75785,94300,Brooklyn,10589588.94,McGuire Fields
21-May,36047070602,3070602,8477,127702,136179,Brooklyn,10589588.94,McGuire Fields
19-Jun,36047070602,3070602,4846,73457,78303,Brooklyn,10589588.94,McGuire Fields
21-Jun,36047070602,3070602,19083,33802,52885,Brooklyn,10589588.94,McGuire Fields
19-Jul,36047070602,3070602,0,129716,129716,Brooklyn,10589588.94,McGuire Fields
21-Jul,36047070602,3070602,8395,57298,65693,Brooklyn,10589588.94,McGuire Fields
19-Aug,36047070602,3070602,13150,118588,131738,Brooklyn,10589588.94,McGuire Fields
21-Aug,36047070602,3070602,2298,48073,50371,Brooklyn,10589588.94,McGuire Fields
19-May,36047001501,3001501,11505,140799,152304,Brooklyn,1776387.814,Downtown Brooklyn-DUMBO-Boerum Hill
21-May,36047001501,3001501,7439,28646,36085,Brooklyn,1776387.814,Downtown Brooklyn-DUMBO-Boerum Hill
19-Jun,36047001501,3001501,10588,101989,112577,Brooklyn,1776387.814,Downtown Brooklyn-DUMBO-Boerum Hill
21-Jun,36047001501,3001501,8413,44303,52716,Brooklyn,1776387.814,Downtown Brooklyn-DUMBO-Boerum Hill
19-Jul,36047001501,3001501,14009,64096,78105,Brooklyn,1776387.814,Downtown Brooklyn-DUMBO-Boerum Hill
21-Jul,36047001501,3001501,3615,17850,21465,Brooklyn,1776387.814,Downtown Brooklyn-DUMBO-Boerum Hill
19-Aug,36047001501,3001501,19313,82492,101805,Brooklyn,1776387.814,Downtown Brooklyn-DUMBO-Boerum Hill
21-Aug,36047001501,3001501,12531,32612,45143,Brooklyn,1776387.814,Downtown Brooklyn-DUMBO-Boerum Hill
19-May,36047002901,3002901,0,167036,167036,Brooklyn,1167568.467,Fort Greene
21-May,36047002901,3002901,12967,60077,73044,Brooklyn,1167568.467,Fort Greene
19-Jun,36047002901,3002901,13844,118348,132192,Brooklyn,1167568.467,Fort Greene
21-Jun,36047002901,3002901,14820,115430,130250,Brooklyn,1167568.467,Fort Greene
19-Jul,36047002901,3002901,11809,21220,33029,Brooklyn,1167568.467,Fort Greene
21-Jul,36047002901,3002901,9043,50510,59553,Brooklyn,1167568.467,Fort Greene
19-Aug,36047002901,3002901,2299,21745,24044,Brooklyn,1167568.467,Fort Greene
21-Aug,36047002901,3002901,11969,19110,31079,Brooklyn,1167568.467,Fort Greene
19-May,36061022500,1022500,16030,71,16101,Manhattan,2807053.003,Hamilton Heights-Sugar Hill
21-May,36061022500,1022500,5471,92439,97910,Manhattan,2807053.003,Hamilton Heights-Sugar Hill
19-Jun,36061022500,1022500,9080,105357,114437,Manhattan,2807053.003,Hamilton Heights-Sugar Hill
21-Jun,36061022500,1022500,6189,136401,142590,Manhattan,2807053.003,Hamilton Heights-Sugar Hill
19-Jul,36061022500,1022500,8856,81502,90358,Manhattan,2807053.003,Hamilton Heights-Sugar Hill
21-Jul,36061022500,1022500,14744,71,14815,Manhattan,2807053.003,Hamilton Heights-Sugar Hill
19-Aug,36061022500,1022500,9695,63466,73161,Manhattan,2807053.003,Hamilton Heights-Sugar Hill
21-Aug,36061022500,1022500,13070,84182,97252,Manhattan,2807053.003,Hamilton Heights-Sugar Hill
19-May,36061022900,1022900,17144,44357,61501,Manhattan,2260098.457,Hamilton Heights-Sugar Hill
21-May,36061022900,1022900,0,47350,47350,Manhattan,2260098.457,Hamilton Heights-Sugar Hill
19-Jun,36061022900,1022900,7590,73937,81527,Manhattan,2260098.457,Hamilton Heights-Sugar Hill
21-Jun,36061022900,1022900,0,17063,17063,Manhattan,2260098.457,Hamilton Heights-Sugar Hill
19-Jul,36061022900,1022900,5042,107690,112732,Manhattan,2260098.457,Hamilton Heights-Sugar Hill
21-Jul,36061022900,1022900,6367,44432,50799,Manhattan,2260098.457,Hamilton Heights-Sugar Hill
19-Aug,36061022900,1022900,10942,95372,106314,Manhattan,2260098.457,Hamilton Heights-Sugar Hill
21-Aug,36061022900,1022900,10141,66635,76776,Manhattan,2260098.457,Hamilton Heights-Sugar Hill
19-May,36047000900,3000900,10078,112195,122273,Brooklyn,1769269.472,Brooklyn Heights
21-May,36047000900,3000900,4442,71,4513,Brooklyn,1769269.472,Brooklyn Heights
19-Jun,36047000900,3000900,7800,87996,95796,Brooklyn,1769269.472,Brooklyn Heights
21-Jun,36047000900,3000900,1476,59588,61064,Brooklyn,1769269.472,Brooklyn Heights
19-Jul,36047000900,3000900,1692,3335,5027,Brooklyn,1769269.472,Brooklyn Heights
21-Jul,36047000900,3000900,7063,48826,55889,Brooklyn,1769269.472,Brooklyn Heights
19-Aug,36047000900,3000900,11245,72685,83930,Brooklyn,1769269.472,Brooklyn Heights
21-Aug,36047000900,3000900,5454,64171,69625,Brooklyn,1769269.472,Brooklyn Heights
19-May,36047001100,3001100,11540,47281,58821,Brooklyn,1811205.742,Downtown Brooklyn-DUMBO-Boerum Hill
21-May,36047001100,3001100,1325,85541,86866,Brooklyn,1811205.742,Downtown Brooklyn-DUMBO-Boerum Hill
19-Jun,36047001100,3001100,7164,93699,100863,Brooklyn,1811205.742,Downtown Brooklyn-DUMBO-Boerum Hill
21-Jun,36047001100,3001100,3295,52399,55694,Brooklyn,1811205.742,Downtown Brooklyn-DUMBO-Boerum Hill
19-Jul,36047001100,3001100,16466,96869,113335,Brooklyn,1811205.742,Downtown Brooklyn-DUMBO-Boerum Hill
21-Jul,36047001100,3001100,2111,42670,44781,Brooklyn,1811205.742,Downtown Brooklyn-DUMBO-Boerum Hill
19-Aug,36047001100,3001100,9932,130053,139985,Brooklyn,1811205.742,Downtown Brooklyn-DUMBO-Boerum Hill
21-Aug,36047001100,3001100,3988,32460,36448,Brooklyn,1811205.742,Downtown Brooklyn-DUMBO-Boerum Hill
19-May,36081099802,4099802,9502,132840,142342,Queens,4665392.92,Far Rockaway-Bayswater
21-May,36081099802,4099802,8190,74004,82194,Queens,4665392.92,Far Rockaway-Bayswater
19-Jun,36081099802,4099802,6875,71,6946,Queens,4665392.92,Far Rockaway-Bayswater
21-Jun,36081099802,4099802,14412,92818,107230,Queens,4665392.92,Far Rockaway-Bayswater
19-Jul,36081099802,4099802,5991,80920,86911,Queens,4665392.92,Far Rockaway-Bayswater
21-Jul,36081099802,4099802,11855,79711,91566,Queens,4665392.92,Far Rockaway-Bayswater
19-Aug,36081099802,4099802,2493,66695,69188,Queens,4665392.92,Far Rockaway-Bayswater
21-Aug,36081099802,4099802,10498,110034,120532,Queens,4665392.92,Far Rockaway-Bayswater
19-May,36081097202,4097202,18265,88240,106505,Queens,6206325.577,Rockaway Beach-Arverne-Edgemere
21-May,36081097202,4097202,7832,53387,61219,Queens,6206325.577,Rockaway Beach-Arverne-Edgemere
19-Jun,36081097202,4097202,12437,48295,60732,Queens,6206325.577,Rockaway Beach-Arverne-Edgemere
21-Jun,36081097202,4097202,9289,28711,38000,Queens,6206325.577,Rockaway Beach-Arverne-Edgemere
19-Jul,36081097202,4097202,8535,65352,73887,Queens,6206325.577,Rockaway Beach-Arverne-Edgemere
21-Jul,36081097202,4097202,7272,65469,72741,Queens,6206325.577,Rockaway Beach-Arverne-Edgemere
19-Aug,36081097202,4097202,0,41914,41914,Queens,6206325.577,Rockaway Beach-Arverne-Edgemere
21-Aug,36081097202,4097202,12320,42933,55253,Queens,6206325.577,Rockaway Beach-Arverne-Edgemere
19-May,36081099200,4099200,13838,66720,80558,Queens,6268483.173,Far Rockaway-Bayswater
21-May,36081099200,4099200,14256,45317,59573,Queens,6268483.173,Far Rockaway-Bayswater
19-Jun,36081099200,4099200,5439,55185,60624,Queens,6268483.173,Far Rockaway-Bayswater
21-Jun,36081099200,4099200,5532,47115,52647,Queens,6268483.173,Far Rockaway-Bayswater
19-Jul,36081099200,4099200,19452,147307,166759,Queens,6268483.173,Far Rockaway-Bayswater
21-Jul,36081099200,4099200,13787,36571,50358,Queens,6268483.173,Far Rockaway-Bayswater
19-Aug,36081099200,4099200,7258,79096,86354,Queens,6268483.173,Far Rockaway-Bayswater
21-Aug,36081099200,4099200,8556,99629,108185,Queens,6268483.173,Far Rockaway-Bayswater
19-May,36081050000,4050000,0,14629,14629,Queens,3612066.476,Hollis
21-May,36081050000,4050000,17273,36427,53700,Queens,3612066.476,Hollis
19-Jun,36081050000,4050000,1424,79874,81298,Queens,3612066.476,Hollis
21-Jun,36081050000,4050000,4150,117915,122065,Queens,3612066.476,Hollis
19-Jul,36081050000,4050000,19170,110559,129729,Queens,3612066.476,Hollis
21-Jul,36081050000,4050000,10785,52470,63255,Queens,3612066.476,Hollis
19-Aug,36081050000,4050000,4881,78339,83220,Queens,3612066.476,Hollis
21-Aug,36081050000,4050000,12582,118165,130747,Queens,3612066.476,Hollis
19-May,36081050201,4050201,1597,21421,23018,Queens,1810554.182,Hollis
21-May,36081050201,4050201,18909,110224,129133,Queens,1810554.182,Hollis
19-Jun,36081050201,4050201,12577,12086,24663,Queens,1810554.182,Hollis
21-Jun,36081050201,4050201,3477,37217,40694,Queens,1810554.182,Hollis
19-Jul,36081050201,4050201,10832,50235,61067,Queens,1810554.182,Hollis
21-Jul,36081050201,4050201,14400,81852,96252,Queens,1810554.182,Hollis
19-Aug,36081050201,4050201,12179,46443,58622,Queens,1810554.182,Hollis
21-Aug,36081050201,4050201,8609,62641,71250,Queens,1810554.182,Hollis
19-May,36085017005,5017005,9213,94812,104025,Staten Island,14951406.62,Annadale-Huguenot-Prince's Bay-Woodrow
21-May,36085017005,5017005,13301,64912,78213,Staten Island,14951406.62,Annadale-Huguenot-Prince's Bay-Woodrow
19-Jun,36085017005,5017005,13138,71,13209,Staten Island,14951406.62,Annadale-Huguenot-Prince's Bay-Woodrow
21-Jun,36085017005,5017005,9138,168534,177672,Staten Island,14951406.62,Annadale-Huguenot-Prince's Bay-Woodrow
19-Jul,36085017005,5017005,10368,75323,85691,Staten Island,14951406.62,Annadale-Huguenot-Prince's Bay-Woodrow
21-Jul,36085017005,5017005,3882,50462,54344,Staten Island,14951406.62,Annadale-Huguenot-Prince's Bay-Woodrow
19-Aug,36085017005,5017005,9509,59955,69464,Staten Island,14951406.62,Annadale-Huguenot-Prince's Bay-Woodrow
21-Aug,36085017005,5017005,8130,99099,107229,Staten Island,14951406.62,Annadale-Huguenot-Prince's Bay-Woodrow
19-May,36085017600,5017600,10076,52321,62397,Staten Island,35698317.7,Annadale-Huguenot-Prince's Bay-Woodrow
21-May,36085017600,5017600,12272,83605,95877,Staten Island,35698317.7,Annadale-Huguenot-Prince's Bay-Woodrow
19-Jun,36085017600,5017600,16327,28329,44656,Staten Island,35698317.7,Annadale-Huguenot-Prince's Bay-Woodrow
21-Jun,36085017600,5017600,10756,30505,41261,Staten Island,35698317.7,Annadale-Huguenot-Prince's Bay-Woodrow
19-Jul,36085017600,5017600,4652,78010,82662,Staten Island,35698317.7,Annadale-Huguenot-Prince's Bay-Woodrow
21-Jul,36085017600,5017600,5165,174714,179879,Staten Island,35698317.7,Annadale-Huguenot-Prince's Bay-Woodrow
19-Aug,36085017600,5017600,7399,35904,43303,Staten Island,35698317.7,Annadale-Huguenot-Prince's Bay-Woodrow
21-Aug,36085017600,5017600,10199,39320,49519,Staten Island,35698317.7,Annadale-Huguenot-Prince's Bay-Woodrow
19-May,36085022802,5022802,8064,15093,23157,Staten Island,68153751.67,Freshkills Park (North)
21-May,36085022802,5022802,8819,78065,86884,Staten Island,68153751.67,Freshkills Park (North)
19-Jun,36085022802,5022802,9729,100395,110124,Staten Island,68153751.67,Freshkills Park (North)
21-Jun,36085022802,5022802,10916,115217,126133,Staten Island,68153751.67,Freshkills Park (North)
19-Jul,36085022802,5022802,10796,74288,85084,Staten Island,68153751.67,Freshkills Park (North)
21-Jul,36085022802,5022802,18068,38015,56083,Staten Island,68153751.67,Freshkills Park (North)
19-Aug,36085022802,5022802,12062,87156,99218,Staten Island,68153751.67,Freshkills Park (North)
21-Aug,36085022802,5022802,0,95136,95136,Staten Island,68153751.67,Freshkills Park (North)
19-May,36085029102,5029102,6254,69536,75790,Staten Island,106236070,New Springville-Willowbrook-Bulls Head-Travis
21-May,36085029102,5029102,19008,122325,141333,Staten Island,106236070,New Springville-Willowbrook-Bulls Head-Travis
19-Jun,36085029102,5029102,13299,88949,102248,Staten Island,106236070,New Springville-Willowbrook-Bulls Head-Travis
21-Jun,36085029102,5029102,7340,67835,75175,Staten Island,106236070,New Springville-Willowbrook-Bulls Head-Travis
19-Jul,36085029102,5029102,8363,73465,81828,Staten Island,106236070,New Springville-Willowbrook-Bulls Head-Travis
21-Jul,36085029102,5029102,6942,100497,107439,Staten Island,106236070,New Springville-Willowbrook-Bulls Head-Travis
19-Aug,36085029102,5029102,0,79195,79195,Staten Island,106236070,New Springville-Willowbrook-Bulls Head-Travis
21-Aug,36085029102,5029102,2052,108184,110236,Staten Island,106236070,New Springville-Willowbrook-Bulls Head-Travis
19-May,36005016100,2016100,0,114989,114989,Bronx,2574284.012,Crotona Park East
21-May,36005016100,2016100,15801,81207,97008,Bronx,2574284.012,Crotona Park East
19-Jun,36005016100,2016100,3119,59648,62767,Bronx,2574284.012,Crotona Park East
21-Jun,36005016100,2016100,7896,63131,71027,Bronx,2574284.012,Crotona Park East
19-Jul,36005016100,2016100,11982,71,12053,Bronx,2574284.012,Crotona Park East
21-Jul,36005016100,2016100,9756,71,9827,Bronx,2574284.012,Crotona Park East
19-Aug,36005016100,2016100,10171,15995,26166,Bronx,2574284.012,Crotona Park East
21-Aug,36005016100,2016100,15366,108237,123603,Bronx,2574284.012,Crotona Park East
19-May,36005016300,2016300,2285,102748,105033,Bronx,6339738.923,Crotona Park
21-May,36005016300,2016300,5783,36537,42320,Bronx,6339738.923,Crotona Park
19-Jun,36005016300,2016300,6257,18719,24976,Bronx,6339738.923,Crotona Park
21-Jun,36005016300,2016300,13897,81744,95641,Bronx,6339738.923,Crotona Park
19-Jul,36005016300,2016300,5975,71,6046,Bronx,6339738.923,Crotona Park
21-Jul,36005016300,2016300,9031,45368,54399,Bronx,6339738.923,Crotona Park
19-Aug,36005016300,2016300,9669,6011,15680,Bronx,6339738.923,Crotona Park
21-Aug,36005016300,2016300,9008,89432,98440,Bronx,6339738.923,Crotona Park
